"","INSEE_COM","Annee","Nb_mutations","NbMaisons","NbApparts","PrixMoyen","Prixm2Moyen","SurfaceMoy"
"1","01001","2021",11,11,0,274126.818181818,2551.27272727273,107
"2","01002","2021",3,3,0,163766.666666667,1290,120.666666666667
"3","01004","2021",249,147,102,195581.831325301,2313.82329317269,86.3895582329317
"4","01005","2021",22,18,4,290837.590909091,2970.04545454545,99.5909090909091
"5","01006","2021",5,4,1,171560,1631.8,104.8
"6","01007","2021",25,22,3,233142.4,2352.4,103.52
"7","01008","2021",12,12,0,214693.333333333,2347.08333333333,89.9166666666667
"8","01009","2021",4,2,2,189000,2001.25,93.75
"9","01010","2021",16,14,2,200618.125,1992.0625,108.3125
"10","01011","2021",4,4,0,202075,1953.5,107
"11","01012","2021",13,13,0,156485.538461538,1476.30769230769,107
"12","01013","2021",1,1,0,115000,1250,92
"13","01014","2021",29,23,6,197483.448275862,1810.44827586207,111.275862068966
"14","01015","2021",5,5,0,248160,2250.4,109.6
"15","01016","2021",6,6,0,173811.666666667,1688.66666666667,100.5
"16","01017","2021",17,12,5,81135.2352941177,1063.58823529412,79.4705882352941
"17","01021","2021",21,16,5,310160,2897.38095238095,116.904761904762
"18","01022","2021",18,16,2,157456.888888889,1799.55555555556,91.9444444444444
"19","01024","2021",42,39,3,247120.785714286,2254.92857142857,111.309523809524
"20","01025","2021",41,41,0,211921.56097561,1933.65853658537,106.951219512195
"21","01026","2021",9,8,1,198096.888888889,1789.77777777778,110.444444444444
"22","01027","2021",28,19,9,274616.428571429,2964.39285714286,88.9285714285714
"23","01028","2021",11,11,0,244000,2358.27272727273,107.545454545455
"24","01029","2021",9,9,0,149860.111111111,1662.11111111111,95.2222222222222
"25","01030","2021",18,5,13,149222.444444444,2102.44444444444,68.0555555555556
"26","01031","2021",46,20,26,128500,1615.45652173913,76.1304347826087
"27","01032","2021",28,18,10,284267.964285714,2885.96428571429,103.035714285714
"28","01033","2021",282,95,187,194794.212765957,2424.24822695035,79.9751773049645
"29","01034","2021",154,91,63,175913.350649351,1847.28571428571,94.7012987012987
"30","01036","2021",16,16,0,178076.625,1482.0625,119.8125
"31","01037","2021",8,8,0,129937.5,1188.375,105.375
"32","01038","2021",11,11,0,220666.363636364,2106.54545454545,110.909090909091
"33","01039","2021",8,8,0,149720.875,1428.25,111
"34","01040","2021",5,5,0,168600,1773.4,96
"35","01041","2021",16,15,1,207315.625,2107.25,99.9375
"36","01042","2021",3,3,0,309000,2154.33333333333,143.666666666667
"37","01043","2021",67,50,17,365228.223880597,3659.83582089552,102.985074626866
"38","01044","2021",9,9,0,305734.222222222,3186.44444444444,101.555555555556
"39","01045","2021",5,4,1,312000,2365.2,152.4
"40","01046","2021",18,18,0,267478.611111111,2060.11111111111,135.055555555556
"41","01047","2021",12,12,0,313300,3136.5,99.3333333333333
"42","01049","2021",51,44,7,344511.215686275,3513.94117647059,99.9411764705882
"43","01050","2021",7,7,0,231495,2053.14285714286,116.857142857143
"44","01051","2021",3,3,0,132333.333333333,1037.66666666667,130.666666666667
"45","01052","2021",6,6,0,548843.333333333,2739.66666666667,185
"46","01053","2021",712,153,559,151251.126404494,1959.78370786517,78.5660112359551
"47","01054","2021",12,12,0,369145.833333333,2968.5,131.416666666667
"48","01056","2021",8,8,0,100875,1165.875,89.25
"49","01057","2021",11,11,0,165174.090909091,1812.45454545455,100
"50","01058","2021",15,13,2,168864.333333333,2077.86666666667,85.5333333333333
"51","01060","2021",12,7,5,110108.333333333,1019.25,109.166666666667
"52","01061","2021",15,13,2,230448,2170.6,108.4
"53","01062","2021",14,13,1,340139,2994.14285714286,112.285714285714
"54","01063","2021",6,4,2,148608,2011.33333333333,75.6666666666667
"55","01064","2021",21,21,0,201506.952380952,1972.33333333333,102.285714285714
"56","01065","2021",16,16,0,260996.375,2554.75,107.25
"57","01066","2021",3,3,0,78333.3333333333,1086.66666666667,60
"58","01067","2021",2,2,0,207500,1999.5,103
"59","01068","2021",16,15,1,127703.125,1423.75,98.375
"60","01069","2021",25,22,3,203129.8,2192.4,91.88
"61","01071","2021",95,49,46,503729.652631579,4660.82105263158,107.884210526316
"62","01072","2021",76,49,27,215314.434210526,2245.86842105263,96.6710526315789
"63","01073","2021",10,10,0,214809,2022.8,101.7
"64","01074","2021",30,19,11,217823.333333333,2217.96666666667,100.633333333333
"65","01075","2021",27,24,3,328131.407407407,2969.11111111111,114
"66","01076","2021",6,6,0,55323.8333333333,540.833333333333,113
"67","01077","2021",3,3,0,195333.333333333,2146.66666666667,101
"68","01078","2021",17,15,2,509707.058823529,4557,117.764705882353
"69","01079","2021",10,10,0,233588.4,2142,109.2
"70","01080","2021",6,6,0,142166.666666667,1216.16666666667,120
"71","01081","2021",11,11,0,256321.818181818,2560.18181818182,104.363636363636
"72","01082","2021",8,7,1,211375.125,2024.875,99.5
"73","01083","2021",13,13,0,286536.923076923,2783.69230769231,103.692307692308
"74","01084","2021",13,13,0,252600,2072.23076923077,122.461538461538
"75","01085","2021",5,5,0,234040,2476.2,93
"76","01087","2021",1,1,0,86000,573,150
"77","01088","2021",14,8,6,240664.285714286,3153.85714285714,77.1428571428571
"78","01089","2021",15,15,0,250340,2170.06666666667,113.666666666667
"79","01090","2021",3,3,0,215000,2161.33333333333,92.3333333333333
"80","01092","2021",27,26,1,265970.37037037,2575.96296296296,104.074074074074
"81","01093","2021",84,43,41,240590.297619048,2411.64285714286,99.5714285714286
"82","01094","2021",16,16,0,141625,1468.5625,99.9375
"83","01095","2021",15,14,1,150556,1550.53333333333,89.3333333333333
"84","01096","2021",15,14,1,208441.333333333,1981.33333333333,104.866666666667
"85","01098","2021",14,12,2,251875.714285714,2244.57142857143,119.714285714286
"86","01099","2021",27,22,5,244369.518518519,2443.92592592593,103.888888888889
"87","01100","2021",1,1,0,166200,1511,110
"88","01102","2021",10,10,0,195922,1626.6,117.9
"89","01103","2021",55,31,24,487755.036363636,4761.65454545455,102.709090909091
"90","01104","2021",10,9,1,182300,2086.8,91.8
"91","01105","2021",27,22,5,374959.555555556,3148.74074074074,122.111111111111
"92","01106","2021",3,3,0,158541.666666667,1631.66666666667,95.3333333333333
"93","01107","2021",2,2,0,154500,1571.5,89
"94","01108","2021",19,18,1,176856.473684211,1565.05263157895,115.684210526316
"95","01109","2021",61,39,22,327491.68852459,3573.88524590164,93.3114754098361
"96","01110","2021",2,2,0,131750,1392,101.5
"97","01111","2021",5,5,0,159900,1464.6,119.8
"98","01112","2021",4,4,0,173262.5,1533.25,113.5
"99","01113","2021",9,9,0,239888.888888889,2000.55555555556,125.777777777778
"100","01114","2021",8,8,0,360879.625,2691,130.5
"101","01115","2021",21,16,5,189000,1794.95238095238,114.809523809524
"102","01116","2021",10,8,2,114450,1555.9,81.6
"103","01117","2021",1,1,0,240000,1600,150
"104","01118","2021",26,22,4,207917.807692308,2394,91.1923076923077
"105","01121","2021",1,1,0,50000,500,100
"106","01123","2021",16,16,0,243637.5,2240.6875,108.875
"107","01124","2021",17,17,0,158972.941176471,1566.52941176471,100.823529411765
"108","01125","2021",10,9,1,107039,1132.3,94
"109","01127","2021",7,7,0,180454.285714286,1808.71428571429,118.857142857143
"110","01128","2021",7,7,0,198571.428571429,1699.57142857143,116.428571428571
"111","01129","2021",5,5,0,227585,2192.6,102
"112","01130","2021",19,19,0,207576.315789474,1799.94736842105,122.105263157895
"113","01133","2021",2,2,0,231425,1679,129
"114","01134","2021",25,25,0,237521.6,2213,108.96
"115","01135","2021",29,20,9,589631.655172414,5268.37931034483,115.965517241379
"116","01136","2021",13,13,0,277605.384615385,1990.46153846154,152.846153846154
"117","01138","2021",51,37,14,160042.333333333,1885.41176470588,88.1764705882353
"118","01139","2021",13,13,0,131462.307692308,1233.46153846154,110.923076923077
"119","01140","2021",11,11,0,206192,1982.54545454545,106.090909090909
"120","01141","2021",10,10,0,248430,1875,139.3
"121","01142","2021",57,40,17,282445.98245614,2871.91228070175,100.19298245614
"122","01143","2021",219,73,146,580465.945205479,5601.37899543379,104.96803652968
"123","01145","2021",21,20,1,238343.857142857,2225.61904761905,121.619047619048
"124","01146","2021",6,6,0,261991.666666667,2442,111.166666666667
"125","01147","2021",3,3,0,100833.333333333,982.333333333333,108.333333333333
"126","01148","2021",18,16,2,188194.444444444,1975.33333333333,95
"127","01149","2021",7,6,1,282142.857142857,2890.57142857143,95.5714285714286
"128","01150","2021",3,3,0,255000,1606,155.333333333333
"129","01151","2021",19,19,0,198605.263157895,1778.05263157895,124.736842105263
"130","01152","2021",17,11,6,192555.882352941,1944.94117647059,110
"131","01153","2021",39,35,4,668049.153846154,4886.82051282051,136.794871794872
"132","01155","2021",4,4,0,92985,933.25,102.25
"133","01156","2021",8,8,0,340167.5,2916.75,119.5
"134","01157","2021",33,26,7,312029.393939394,2753.48484848485,116.848484848485
"135","01158","2021",17,13,4,430128,4292.94117647059,102.705882352941
"136","01159","2021",36,35,1,210858.194444444,2022.55555555556,108.305555555556
"137","01160","2021",172,16,156,311920.715116279,4297.68023255814,73.5116279069767
"138","01162","2021",1,1,0,145000,1543,94
"139","01163","2021",31,31,0,174296.774193548,1847.77419354839,96.9032258064516
"140","01165","2021",24,24,0,294110,2516.25,129.458333333333
"141","01166","2021",41,36,5,306310.536585366,2921.46341463415,105.560975609756
"142","01167","2021",11,11,0,290421.636363636,2143.54545454545,134.454545454545
"143","01169","2021",14,11,3,252602.142857143,2805.78571428571,89.5
"144","01170","2021",13,13,0,244363.076923077,2053.92307692308,118.307692307692
"145","01171","2021",14,13,1,197317.857142857,1992.07142857143,97.4285714285714
"146","01173","2021",225,57,168,343535.115555556,4168.68888888889,81.9777777777778
"147","01174","2021",3,3,0,145816.666666667,1212.33333333333,119
"148","01175","2021",12,12,0,188325,1914.91666666667,103.25
"149","01177","2021",1,1,0,225000,1607,140
"150","01179","2021",22,22,0,230579.545454545,1841.27272727273,126.681818181818
"151","01180","2021",16,12,4,603284.8125,5023.875,118.3125
"152","01181","2021",11,11,0,251400,2310.45454545455,105.181818181818
"153","01183","2021",31,30,1,293344,2654.51612903226,115.548387096774
"154","01184","2021",17,17,0,184765.411764706,2069.35294117647,93.9411764705882
"155","01185","2021",62,48,14,128988.14516129,1345.12903225806,95.5161290322581
"156","01187","2021",19,14,5,142531.578947368,1720.26315789474,93.3157894736842
"157","01188","2021",11,11,0,287186.363636364,2374.90909090909,120.909090909091
"158","01189","2021",10,9,1,244600,2555,101.5
"159","01190","2021",2,2,0,85000,889.5,93.5
"160","01191","2021",4,4,0,150500,1347,124
"161","01192","2021",29,29,0,155008.344827586,1652.34482758621,96.1724137931034
"162","01193","2021",2,2,0,130000,1412.5,104
"163","01194","2021",83,52,31,301637.204819277,3061.74698795181,97.6385542168675
"164","01195","2021",26,17,9,169869.230769231,1730.96153846154,96.0384615384615
"165","01196","2021",20,20,0,199175,1935.75,106.15
"166","01197","2021",8,8,0,212813.625,2962.75,96.125
"167","01198","2021",1,1,0,442250,2617,169
"168","01199","2021",40,25,15,121709.275,1430.95,82.9
"169","01200","2021",3,3,0,127333.333333333,1144,114.666666666667
"170","01202","2021",102,61,41,197633.490196078,2238.19607843137,93.4607843137255
"171","01203","2021",20,17,3,250053.55,2125.85,120.65
"172","01204","2021",10,9,1,187700,1696.8,109.1
"173","01206","2021",2,2,0,176000,1941.5,93
"174","01207","2021",5,5,0,363400,3553.6,125.8
"175","01208","2021",2,2,0,137200,1322.5,103
"176","01209","2021",22,14,8,251523.272727273,2904.18181818182,90.8181818181818
"177","01210","2021",52,5,47,77629.0384615385,2039.76923076923,38.0961538461538
"178","01211","2021",19,19,0,266815.789473684,1960.57894736842,125.210526315789
"179","01212","2021",23,22,1,123921.739130435,1268.5652173913,105.782608695652
"180","01213","2021",17,17,0,252882.352941176,2448.17647058824,106.647058823529
"181","01214","2021",5,5,0,183800,1648.2,114.4
"182","01215","2021",2,2,0,309437.5,1287.5,184
"183","01216","2021",19,18,1,183868.421052632,1919.21052631579,93.9473684210526
"184","01219","2021",1,1,0,145000,1115,130
"185","01224","2021",45,33,12,263147.888888889,2847.66666666667,95
"186","01225","2021",2,1,1,292500,2103,152.5
"187","01227","2021",10,10,0,179103.6,1814.4,101.8
"188","01228","2021",3,2,1,125666.666666667,1351,100.666666666667
"189","01229","2021",16,13,3,211716.8125,1989.4375,112.0625
"190","01230","2021",8,8,0,145250,1509.125,102
"191","01231","2021",17,17,0,205336.588235294,1869.41176470588,112.470588235294
"192","01232","2021",27,26,1,193698.148148148,1675.37037037037,118.148148148148
"193","01233","2021",4,4,0,122000,1319.5,93.75
"194","01234","2021",4,4,0,166300,2033.5,82.25
"195","01235","2021",8,8,0,311000,2343.25,162.875
"196","01236","2021",15,15,0,238385.333333333,2231.33333333333,122.733333333333
"197","01237","2021",9,9,0,264561.666666667,2289.33333333333,123.888888888889
"198","01238","2021",33,31,2,364630.606060606,3390.69696969697,109.969696969697
"199","01239","2021",9,9,0,336277.777777778,2680.22222222222,121.888888888889
"200","01240","2021",13,13,0,159335.923076923,1676.69230769231,97
"201","01241","2021",16,16,0,218034.375,1974.1875,105.625
"202","01242","2021",3,3,0,73000,1161.33333333333,61
"203","01243","2021",33,33,0,347918.787878788,3181.51515151515,115.424242424242
"204","01244","2021",98,63,35,258090.408163265,2798.17346938776,94.5
"205","01245","2021",15,15,0,180613.333333333,2054.4,100.866666666667
"206","01246","2021",31,28,3,208283.387096774,1876.87096774194,109.387096774194
"207","01247","2021",39,10,29,117162.051282051,2719.94871794872,41.8205128205128
"208","01248","2021",17,12,5,399160,3626.17647058824,115.764705882353
"209","01249","2021",133,67,66,312710.037593985,3490.26315789474,88.3308270676692
"210","01250","2021",21,19,2,358086.714285714,3042.38095238095,118.285714285714
"211","01252","2021",11,11,0,248487,2555,94.9090909090909
"212","01254","2021",20,20,0,322695,2489.1,131.35
"213","01255","2021",6,5,1,175340,1969.16666666667,95.3333333333333
"214","01257","2021",2,2,0,356297.5,2090,166
"215","01258","2021",17,17,0,337247.058823529,2835.29411764706,127.411764705882
"216","01259","2021",5,5,0,310872,2277.2,133.6
"217","01260","2021",2,2,0,316850,2883.5,116.5
"218","01261","2021",5,5,0,354300,3308,104.6
"219","01262","2021",141,52,89,214423.09929078,2653.85815602837,82.6241134751773
"220","01263","2021",70,63,7,305708.214285714,2876.68571428571,108.128571428571
"221","01264","2021",8,8,0,194500,1858.125,101.125
"222","01265","2021",27,13,14,134533.333333333,1669.55555555556,82.3333333333333
"223","01266","2021",54,30,24,173391.796296296,1880.92592592593,96.3518518518518
"224","01267","2021",5,5,0,144000,1579.8,95
"225","01268","2021",8,8,0,232241.375,2205,122.875
"226","01269","2021",47,18,29,124328.29787234,1289.42553191489,97.1063829787234
"227","01272","2021",18,14,4,211541.111111111,1943.5,109.222222222222
"228","01273","2021",27,24,3,200496.296296296,2263.77777777778,94.9259259259259
"229","01274","2021",9,9,0,137637.333333333,1662.22222222222,93.3333333333333
"230","01275","2021",30,23,7,471190,4164.9,112.166666666667
"231","01276","2021",17,17,0,386108.117647059,3578.29411764706,110.705882352941
"232","01277","2021",4,4,0,89650,1181,68.25
"233","01279","2021",2,2,0,72500,1546.5,62
"234","01280","2021",4,4,0,120425,1223.75,97
"235","01281","2021",78,32,46,462965.435897436,4722.47435897436,99.6666666666667
"236","01282","2021",2,2,0,163750,1311,125
"237","01283","2021",202,79,123,139913.158415842,1571.83663366337,87.9405940594059
"238","01284","2021",6,6,0,199016.666666667,2098,95.3333333333333
"239","01285","2021",17,16,1,408522.352941176,3708.11764705882,110.529411764706
"240","01286","2021",11,11,0,203986.363636364,2072.54545454545,98.3636363636364
"241","01288","2021",60,33,27,357450.2,3640.45,96.1
"242","01289","2021",83,51,32,206802.78313253,2170.30120481928,95.6024096385542
"243","01290","2021",25,17,8,262444.6,2874.4,92.4
"244","01291","2021",6,6,0,214666.666666667,1967,110.5
"245","01293","2021",3,3,0,196000,1663.66666666667,112.333333333333
"246","01294","2021",17,17,0,238265.882352941,1979.05882352941,121.823529411765
"247","01295","2021",12,10,2,283629.166666667,2550.58333333333,113.166666666667
"248","01296","2021",5,5,0,179600,1615,113.6
"249","01297","2021",8,8,0,283712.5,2720.125,105.875
"250","01298","2021",2,2,0,177500,1439.5,123
"251","01299","2021",5,5,0,295600,2569.8,114
"252","01301","2021",32,29,3,229386.03125,2155.5625,114.09375
"253","01302","2021",2,2,0,102500,1899,69.5
"254","01303","2021",32,30,2,142343.75,1504.25,95.3125
"255","01304","2021",46,33,13,168059.543478261,1876.73913043478,89.5
"256","01305","2021",36,22,14,150289.444444444,1576.11111111111,94.75
"257","01306","2021",27,13,14,120812.740740741,1496.81481481481,82.5185185185185
"258","01307","2021",3,0,3,72666.6666666667,1613,45.3333333333333
"259","01308","2021",14,14,0,479669.285714286,3966.28571428571,133.5
"260","01309","2021",2,2,0,116500,1641,69.5
"261","01310","2021",5,5,0,156100,1487.2,116
"262","01311","2021",2,2,0,75500,2055,60
"263","01313","2021",179,99,80,525649.720670391,5192.24022346369,101.284916201117
"264","01314","2021",36,35,1,216952.361111111,2097.11111111111,107.083333333333
"265","01317","2021",6,6,0,176666.666666667,1990.16666666667,88.1666666666667
"266","01318","2021",7,7,0,314428.571428571,3114,109.285714285714
"267","01319","2021",7,7,0,339628.571428571,2496.85714285714,147.142857142857
"268","01320","2021",38,34,4,202547.894736842,2035.02631578947,102.473684210526
"269","01321","2021",18,17,1,243186.444444444,2246.27777777778,103.166666666667
"270","01322","2021",61,52,9,392615.426229508,3458.44262295082,118.655737704918
"271","01323","2021",10,9,1,152190,1476.5,98.3
"272","01325","2021",12,12,0,276979.166666667,2772.83333333333,96.25
"273","01328","2021",7,7,0,323142.857142857,2621.57142857143,131.142857142857
"274","01329","2021",6,5,1,78166.6666666667,982.333333333333,86.6666666666667
"275","01330","2021",5,5,0,172244,1109,184.8
"276","01331","2021",3,3,0,121666.666666667,1322.66666666667,90.6666666666667
"277","01332","2021",13,13,0,244753.846153846,2193.07692307692,113
"278","01333","2021",41,23,18,268603.170731707,3117.12195121951,89.9268292682927
"279","01334","2021",8,8,0,215437.5,2074.125,105.25
"280","01335","2021",6,6,0,323623.333333333,2932.33333333333,115.166666666667
"281","01336","2021",16,16,0,237916.875,2474.125,99.375
"282","01337","2021",11,11,0,154110,1591.18181818182,98.4545454545455
"283","01338","2021",24,24,0,207651.125,1721.95833333333,130.625
"284","01339","2021",24,23,1,486083.666666667,4564.29166666667,109.583333333333
"285","01342","2021",8,7,1,373682.5,3248.75,125.125
"286","01343","2021",23,23,0,261275.652173913,2090.69565217391,122.826086956522
"287","01344","2021",77,64,13,227224.805194805,2305.98701298701,99.5974025974026
"288","01345","2021",30,23,7,174992.3,1910.03333333333,91.1333333333333
"289","01346","2021",17,12,5,140120.058823529,1445.05882352941,92.5294117647059
"290","01347","2021",28,28,0,446407.678571429,3398.14285714286,133.5
"291","01348","2021",34,28,6,216972.058823529,2081.52941176471,107.382352941176
"292","01349","2021",4,4,0,461652.5,3325.75,139.25
"293","01350","2021",32,28,4,193696.28125,2168.59375,93.96875
"294","01351","2021",18,15,3,191913.333333333,2008.55555555556,99.3333333333333
"295","01352","2021",10,10,0,194256,1629.7,119.8
"296","01353","2021",17,16,1,341768.058823529,3330.47058823529,105.352941176471
"297","01354","2021",261,78,183,395822.01532567,4365.13026819923,91.1532567049808
"298","01355","2021",6,6,0,234583.333333333,2152,114.666666666667
"299","01356","2021",3,3,0,358000,2247.33333333333,158.333333333333
"300","01357","2021",11,7,4,152984.363636364,2033.36363636364,78.5454545454545
"301","01358","2021",6,6,0,174983.333333333,1470.5,114.333333333333
"302","01359","2021",1,1,0,380000,2331,163
"303","01360","2021",37,25,12,436622.702702703,4535.78378378378,104.891891891892
"304","01361","2021",51,43,8,272522.431372549,2830.78431372549,94.921568627451
"305","01362","2021",5,4,1,368200,3495.2,100.4
"306","01363","2021",20,18,2,167201.7,1738.2,97.25
"307","01364","2021",9,9,0,133188.888888889,1582.11111111111,84.5555555555556
"308","01365","2021",23,23,0,193233.47826087,1809.5652173913,106.130434782609
"309","01366","2021",16,15,1,313618.75,3070.5,101.75
"310","01367","2021",10,10,0,146875,1550.7,92.6
"311","01368","2021",9,9,0,270444.444444444,2276,122
"312","01369","2021",8,7,1,273575,2457.125,109.125
"313","01370","2021",43,3,40,109645.11627907,1644.58139534884,68.1627906976744
"314","01371","2021",24,16,8,264885.416666667,3137,84.7916666666667
"315","01372","2021",3,3,0,138000,1433,87.6666666666667
"316","01373","2021",12,10,2,187350,1851.16666666667,110.416666666667
"317","01374","2021",31,31,0,257282.096774194,2093.22580645161,125.032258064516
"318","01375","2021",12,12,0,205333.333333333,2054.75,104
"319","01376","2021",78,29,49,264175.91025641,2950.83333333333,88.0384615384615
"320","01378","2021",29,28,1,349189.310344828,3233.75862068966,111.551724137931
"321","01379","2021",12,12,0,238250,2028.58333333333,123.333333333333
"322","01380","2021",6,6,0,136166.666666667,1811.33333333333,92.3333333333333
"323","01381","2021",8,7,1,289875.375,2627.5,109.625
"324","01382","2021",3,3,0,353966.666666667,3006.33333333333,116.666666666667
"325","01383","2021",26,23,3,215647.115384615,2091.73076923077,104.307692307692
"326","01384","2021",41,30,11,120051.829268293,1347.07317073171,91.4878048780488
"327","01385","2021",5,5,0,258700,2201.4,121.4
"328","01386","2021",10,9,1,244785,2083.4,116.8
"329","01387","2021",5,5,0,235800,1953.8,123.8
"330","01388","2021",13,11,2,154698.461538462,1463.61538461538,110.076923076923
"331","01389","2021",22,19,3,300971.454545455,2660.63636363636,118.318181818182
"332","01390","2021",17,16,1,232203.235294118,3080.76470588235,79.9411764705882
"333","01391","2021",4,4,0,170125,1746.75,108.5
"334","01392","2021",9,9,0,189422.222222222,1840.88888888889,103.555555555556
"335","01393","2021",6,5,1,344175,2550.33333333333,128
"336","01396","2021",8,5,3,122451.25,1427.375,84
"337","01397","2021",15,9,6,437760,4466.4,100.866666666667
"338","01398","2021",20,20,0,378308.75,3149.3,131.85
"339","01399","2021",27,19,8,514484.814814815,4749.03703703704,109.703703703704
"340","01400","2021",1,1,0,89000,742,120
"341","01401","2021",40,25,15,542675.425,4241.4,130.85
"342","01402","2021",15,15,0,154965.2,1582.46666666667,96.0666666666667
"343","01403","2021",22,21,1,165950.727272727,1669.72727272727,99.7272727272727
"344","01404","2021",1,1,0,160000,780,205
"345","01405","2021",8,7,1,214590.125,1899.125,109.875
"346","01406","2021",5,5,0,217360.8,1897.2,110.6
"347","01407","2021",27,14,13,216866.296296296,2231.92592592593,99.4814814814815
"348","01408","2021",6,6,0,130808.333333333,1268.33333333333,100.5
"349","01410","2021",3,2,1,164666.666666667,1371.33333333333,110.666666666667
"350","01411","2021",6,6,0,106250,1423.83333333333,83
"351","01412","2021",10,10,0,350730,2509.9,143.4
"352","01415","2021",3,3,0,277000,1592.33333333333,158.333333333333
"353","01416","2021",19,17,2,101855.263157895,1292.47368421053,77.4210526315789
"354","01418","2021",16,14,2,363297.125,3686.25,123.75
"355","01419","2021",108,62,46,465872.259259259,4370.7962962963,106.092592592593
"356","01420","2021",23,12,11,162847.391304348,1685.26086956522,95.7391304347826
"357","01421","2021",12,12,0,185908.333333333,1700.58333333333,112.5
"358","01422","2021",18,17,1,250754.166666667,2327.72222222222,107.611111111111
"359","01423","2021",16,16,0,376354.375,3449.8125,110.375
"360","01424","2021",15,14,1,433280.666666667,3781.93333333333,115.066666666667
"361","01425","2021",1,1,0,120000,1091,110
"362","01426","2021",37,35,2,187664.675675676,1792.18918918919,107.027027027027
"363","01427","2021",105,51,54,241763.076190476,2727.0380952381,89
"364","01429","2021",10,10,0,241979.7,1969.2,131.6
"365","01430","2021",14,13,1,177694,1748.42857142857,100.428571428571
"366","01431","2021",23,22,1,202141.304347826,2030.78260869565,97.9130434782609
"367","01432","2021",6,6,0,159000,1554.66666666667,107.833333333333
"368","01433","2021",1,1,0,160000,800,200
"369","01434","2021",5,5,0,352853.4,3076.8,117.6
"370","01435","2021",26,19,7,463486.576923077,4328.84615384615,105.961538461538
"371","01436","2021",12,8,4,573943.666666667,4685.5,119.166666666667
"372","01437","2021",4,4,0,178850,1992,99.75
"373","01439","2021",1,1,0,170000,1030,165
"374","01441","2021",9,9,0,182472.222222222,1530.33333333333,120.555555555556
"375","01443","2021",60,44,16,251946.65,2454.63333333333,105.316666666667
"376","01444","2021",20,18,2,171917.5,1896.45,93.55
"377","01445","2021",14,11,3,189827.214285714,1801.07142857143,109.285714285714
"378","01446","2021",20,16,4,274941.95,2454.5,109.65
"379","01447","2021",11,11,0,201986.363636364,1472,141.818181818182
"380","01448","2021",6,3,3,218166.666666667,2502,86.8333333333333
"381","01449","2021",10,10,0,259305,2210.3,129.9
"382","01450","2021",54,48,6,252272,2674.48148148148,95.6851851851852
"383","01451","2021",76,70,6,254713.473684211,2217.06578947368,117.407894736842
"384","01452","2021",23,17,6,152118.347826087,1579.30434782609,95.6086956521739
"385","01453","2021",7,7,0,174785.714285714,1741.14285714286,93.7142857142857
"386","01454","2021",14,13,1,235603.571428571,2378.42857142857,97.7857142857143
"387","01456","2021",2,2,0,280000,2856,88
"388","01457","2021",58,45,13,202880.224137931,2134.20689655172,97.4827586206897
"389","02001","2021",6,6,0,119150,2422.16666666667,91.1666666666667
"390","02002","2021",9,9,0,116438.888888889,1013,113.888888888889
"391","02003","2021",13,13,0,140030.769230769,1565.53846153846,88.8461538461538
"392","02004","2021",1,1,0,60000,600,100
"393","02005","2021",6,6,0,158883.333333333,1345.16666666667,116.5
"394","02006","2021",6,6,0,104604.666666667,973.5,106.666666666667
"395","02008","2021",4,4,0,125625,1445.25,89.25
"396","02009","2021",8,8,0,143163,1551.375,94.375
"397","02010","2021",1,1,0,172000,1284,134
"398","02011","2021",26,26,0,195794.230769231,1756.61538461538,108.692307692308
"399","02012","2021",2,2,0,135950,1790.5,76
"400","02013","2021",4,4,0,111800,1024.75,113.75
"401","02014","2021",8,8,0,128437.5,1293.75,100
"402","02015","2021",2,2,0,126500,1301,100.5
"403","02016","2021",4,4,0,149100,1312.75,114.25
"404","02017","2021",4,4,0,126400,948,134.5
"405","02018","2021",27,27,0,126109.888888889,1430.03703703704,89.6666666666667
"406","02019","2021",4,4,0,138250,1112.25,128
"407","02020","2021",7,7,0,95088.5714285714,806.428571428571,118.857142857143
"408","02021","2021",2,2,0,75000,692.5,100
"409","02022","2021",12,12,0,123597,1184.16666666667,109.333333333333
"410","02023","2021",2,2,0,169750,1727,84
"411","02025","2021",3,3,0,97000,913.333333333333,99.3333333333333
"412","02027","2021",5,5,0,95620,835.2,115.2
"413","02028","2021",28,28,0,152305.714285714,1533.07142857143,101.464285714286
"414","02029","2021",5,5,0,139100,1378.8,99
"415","02030","2021",4,4,0,81925,850.5,94.75
"416","02031","2021",15,15,0,90913.3333333333,823.866666666667,115.333333333333
"417","02032","2021",5,5,0,86400,705.4,118.8
"418","02035","2021",5,5,0,133960,930,154
"419","02036","2021",1,1,0,55000,539,102
"420","02037","2021",8,8,0,144478.75,1555,92.875
"421","02039","2021",1,1,0,36500,456,80
"422","02040","2021",2,2,0,80850,790,103.5
"423","02041","2021",6,6,0,139083.333333333,1536.83333333333,87.5
"424","02042","2021",2,2,0,140500,1435.5,100
"425","02043","2021",1,1,0,88000,1100,80
"426","02046","2021",12,12,0,142629.166666667,1400.08333333333,103
"427","02048","2021",2,2,0,152500,966,139
"428","02049","2021",14,14,0,121389.714285714,1336.28571428571,94.2142857142857
"429","02050","2021",3,3,0,125000,931,165.666666666667
"430","02051","2021",3,3,0,150666.666666667,1382,106.333333333333
"431","02053","2021",27,27,0,117029.62962963,1315.37037037037,95.2592592592593
"432","02054","2021",2,2,0,106250,848.5,119
"433","02056","2021",2,2,0,112500,1079,97.5
"434","02057","2021",15,15,0,97706.6666666667,960.866666666667,108.266666666667
"435","02058","2021",19,19,0,114145.157894737,1289.94736842105,95.9473684210526
"436","02059","2021",26,25,1,84307.3076923077,951.153846153846,87.7307692307692
"437","02060","2021",2,2,0,85000,1318.5,64
"438","02061","2021",5,5,0,104840,1234.6,83.2
"439","02062","2021",1,1,0,110000,2200,50
"440","02063","2021",7,7,0,108571.428571429,1322.57142857143,83.4285714285714
"441","02064","2021",44,42,2,145258.522727273,1530.29545454545,98.1363636363636
"442","02065","2021",11,11,0,94117.2727272727,974.545454545455,95
"443","02066","2021",4,4,0,135713.75,1240.5,90.75
"444","02067","2021",7,7,0,165695,1358.71428571429,133.428571428571
"445","02069","2021",2,2,0,91000,974.5,94
"446","02070","2021",3,3,0,192333.333333333,1250.33333333333,154.666666666667
"447","02071","2021",10,10,0,163770,2102.8,87.1
"448","02073","2021",8,8,0,160093.75,1624.875,97.25
"449","02074","2021",3,3,0,157250,1337,116
"450","02075","2021",1,1,0,238000,2736,87
"451","02076","2021",1,1,0,150000,2083,72
"452","02077","2021",8,8,0,186237.5,1585.375,126.5
"453","02078","2021",2,2,0,64450,1307,48.5
"454","02079","2021",4,4,0,87725,756,130.25
"455","02080","2021",1,1,0,165000,1435,115
"456","02081","2021",5,5,0,134386,1686.8,90
"457","02082","2021",3,3,0,168000,1511.33333333333,127.333333333333
"458","02083","2021",16,16,0,130478.1875,1313.5,99.9375
"459","02084","2021",2,2,0,199640,1503,120
"460","02085","2021",11,11,0,188870.909090909,1439.90909090909,142.909090909091
"461","02086","2021",15,15,0,141131.333333333,1516.46666666667,95.8666666666667
"462","02088","2021",1,1,0,258000,1330,194
"463","02089","2021",13,13,0,150153.846153846,1671.38461538462,93.0769230769231
"464","02090","2021",6,6,0,140316.666666667,1258,117
"465","02091","2021",4,4,0,150900,1594.75,97.25
"466","02093","2021",27,26,1,107614.444444444,1321.59259259259,84.1111111111111
"467","02094","2021",10,10,0,188447,1688.3,116.1
"468","02095","2021",95,94,1,70863.3263157895,783.621052631579,88.8105263157895
"469","02096","2021",3,3,0,78166.6666666667,933,83.3333333333333
"470","02097","2021",4,4,0,150400,891.5,158.5
"471","02098","2021",8,8,0,138000,1915.5,73.375
"472","02099","2021",6,6,0,156550,1525,119.5
"473","02100","2021",1,1,0,97600,1479,66
"474","02101","2021",3,3,0,64859,618.333333333333,102.333333333333
"475","02102","2021",2,2,0,88500,1496.5,57
"476","02103","2021",23,23,0,92566.652173913,1129.5652173913,84
"477","02105","2021",2,2,0,173500,1351,143
"478","02106","2021",17,17,0,126549.411764706,1381.82352941176,96
"479","02107","2021",1,1,0,161000,947,170
"480","02108","2021",2,2,0,80875,1364,57.5
"481","02109","2021",5,5,0,98081,821,130
"482","02110","2021",25,25,0,154544.8,1409.28,115.28
"483","02111","2021",8,8,0,128750,1356.375,95.375
"484","02112","2021",9,9,0,102491.111111111,1090.77777777778,92.8888888888889
"485","02114","2021",14,13,1,173223.214285714,1927.57142857143,89.7142857142857
"486","02115","2021",8,8,0,159062.5,1973.625,98.625
"487","02116","2021",2,2,0,59500,686,86.5
"488","02118","2021",1,1,0,92000,885,104
"489","02119","2021",4,4,0,105750,922.5,115.75
"490","02120","2021",2,2,0,141000,1238,113.5
"491","02121","2021",3,3,0,73300,910.666666666667,78.6666666666667
"492","02122","2021",1,1,0,40000,769,52
"493","02123","2021",4,4,0,199200,1454,144.75
"494","02124","2021",8,8,0,107141.375,1174.125,88
"495","02125","2021",3,3,0,109000,1237.66666666667,92
"496","02126","2021",10,10,0,83803,774.6,109.7
"497","02127","2021",5,5,0,99400,1109.2,86
"498","02128","2021",18,18,0,136415.333333333,1375.88888888889,100.111111111111
"499","02130","2021",5,5,0,73400,815.6,93.6
"500","02131","2021",25,25,0,159851.88,1752.8,90.48
"501","02133","2021",9,9,0,71177.7777777778,800,89.4444444444444
"502","02134","2021",9,9,0,126944.111111111,1357.11111111111,95.1111111111111
"503","02135","2021",17,17,0,110717.647058824,965.823529411765,111.529411764706
"504","02136","2021",1,1,0,40000,678,59
"505","02138","2021",2,2,0,273357.5,1691,174
"506","02139","2021",5,5,0,138700,1030,139.8
"507","02140","2021",8,8,0,112011.875,1230.5,112.875
"508","02141","2021",21,20,1,93424.8571428571,979.904761904762,96.3809523809524
"509","02142","2021",3,3,0,226266.666666667,1502,149.666666666667
"510","02143","2021",1,1,0,65000,707,92
"511","02145","2021",11,11,0,124981.818181818,1235.18181818182,97.7272727272727
"512","02146","2021",2,2,0,208250,1410.5,145
"513","02148","2021",1,1,0,620000,1751,354
"514","02153","2021",12,12,0,148283.333333333,1570.08333333333,96.5833333333333
"515","02154","2021",10,10,0,153752,1443,113
"516","02155","2021",1,1,0,130000,818,159
"517","02156","2021",5,5,0,112490,1103.6,101.8
"518","02157","2021",9,9,0,141777.777777778,1465.22222222222,99.6666666666667
"519","02158","2021",4,4,0,95500,1111.5,85.25
"520","02159","2021",4,4,0,171750,1362.25,127.5
"521","02160","2021",8,8,0,72562.625,766.25,94.75
"522","02162","2021",2,2,0,143500,1542,95.5
"523","02163","2021",27,23,4,136863.518518519,1532.66666666667,90.1851851851852
"524","02164","2021",9,9,0,156411.111111111,1293.66666666667,128.222222222222
"525","02165","2021",23,23,0,89573.9130434783,1036.52173913043,85
"526","02166","2021",6,6,0,191833.333333333,2698.5,76.6666666666667
"527","02167","2021",12,12,0,136880.833333333,1527.75,90
"528","02168","2021",198,130,68,162461.262626263,1858.59595959596,91.1565656565657
"529","02169","2021",1,1,0,25000,463,54
"530","02170","2021",2,2,0,172500,1389.5,113.5
"531","02171","2021",2,2,0,177700,3097,80
"532","02172","2021",4,4,0,139125,1515.5,93.25
"533","02173","2021",161,138,23,109536.391304348,1264.90683229814,86.1490683229814
"534","02174","2021",11,11,0,150090.909090909,1484.63636363636,103.363636363636
"535","02175","2021",1,1,0,157000,1467,107
"536","02176","2021",3,3,0,171333.333333333,1480.33333333333,124
"537","02177","2021",2,2,0,120000,1163,101.5
"538","02178","2021",1,1,0,82000,953,86
"539","02179","2021",15,15,0,138694.666666667,1569.86666666667,93.6
"540","02180","2021",11,11,0,132552.272727273,1285.54545454545,101.363636363636
"541","02181","2021",1,1,0,78000,975,80
"542","02182","2021",2,2,0,72620,738,98.5
"543","02183","2021",2,2,0,81750,604,155
"544","02184","2021",2,2,0,61375,586,107
"545","02185","2021",10,10,0,149650,1630.4,99
"546","02186","2021",20,20,0,167472.5,1763.25,99.3
"547","02187","2021",21,20,1,174638.095238095,1867.61904761905,98.2857142857143
"548","02188","2021",3,3,0,126000,1397.33333333333,108.333333333333
"549","02189","2021",4,4,0,113950,1285.5,92.75
"550","02190","2021",6,6,0,157500,1708.66666666667,103.333333333333
"551","02191","2021",4,4,0,151812.5,1391.75,124.75
"552","02192","2021",7,7,0,143000,1470.14285714286,102.571428571429
"553","02193","2021",1,1,0,113500,946,120
"554","02194","2021",2,2,0,98000,712.5,144
"555","02195","2021",16,16,0,171143.75,1342.875,128.3125
"556","02196","2021",4,4,0,101362.5,1279.25,78.5
"557","02197","2021",5,5,0,152900,1102.4,134.2
"558","02198","2021",4,4,0,126250,1693.5,76
"559","02199","2021",9,9,0,108111.111111111,1256.44444444444,87.2222222222222
"560","02200","2021",3,3,0,81633.3333333333,787.666666666667,95
"561","02201","2021",10,10,0,200567.5,1797.6,121.7
"562","02203","2021",20,20,0,127965,1493.55,88.85
"563","02205","2021",2,2,0,143875,1263,110.5
"564","02206","2021",1,1,0,230000,2170,106
"565","02208","2021",2,2,0,214500,1431.5,173
"566","02209","2021",15,15,0,95866.6666666667,1122.13333333333,88.3333333333333
"567","02210","2021",5,5,0,171500,1447.8,124.4
"568","02211","2021",10,10,0,157921.8,2063.1,77.8
"569","02212","2021",11,11,0,113472.727272727,1249.81818181818,83.8181818181818
"570","02213","2021",6,6,0,100366.666666667,1276.33333333333,81.1666666666667
"571","02214","2021",2,2,0,134500,884,147
"572","02215","2021",9,9,0,208434.555555556,1832.22222222222,124.555555555556
"573","02216","2021",3,3,0,214666.666666667,1588.33333333333,135.333333333333
"574","02217","2021",15,15,0,123268,1426.26666666667,87.7333333333333
"575","02218","2021",9,9,0,126638.888888889,1238.77777777778,102.111111111111
"576","02219","2021",1,1,0,82200,1551,53
"577","02220","2021",5,5,0,176634.4,1143.6,141.2
"578","02221","2021",3,3,0,125166.666666667,1529,87
"579","02223","2021",7,7,0,135285.714285714,1325.71428571429,106.571428571429
"580","02224","2021",7,7,0,184771.428571429,1645.71428571429,118
"581","02225","2021",3,3,0,151666.666666667,1255.33333333333,121
"582","02226","2021",28,28,0,159005.357142857,1524.75,102.25
"583","02227","2021",4,4,0,120250,1380,89.5
"584","02228","2021",6,6,0,155166.666666667,1071,146.166666666667
"585","02229","2021",2,2,0,100410,877,115.5
"586","02231","2021",11,11,0,129245.454545455,1211.63636363636,106.818181818182
"587","02232","2021",6,6,0,192086.666666667,2121.33333333333,97.6666666666667
"588","02233","2021",1,1,0,80000,920,87
"589","02235","2021",4,4,0,97725,1699.5,61.25
"590","02236","2021",5,5,0,155160,1228.4,128
"591","02237","2021",16,16,0,99800,903.6875,114.1875
"592","02238","2021",14,13,1,137082.142857143,1149.85714285714,124.785714285714
"593","02239","2021",21,21,0,124095.285714286,1349.61904761905,95.4285714285714
"594","02240","2021",3,3,0,92660,712,133
"595","02241","2021",3,3,0,223366.666666667,1618.66666666667,134.666666666667
"596","02242","2021",11,11,0,127636.363636364,1933,78.4545454545455
"597","02243","2021",46,35,11,123563.586956522,1659.58695652174,75.4130434782609
"598","02245","2021",23,21,2,162106.956521739,1678.91304347826,99.3913043478261
"599","02246","2021",9,9,0,116000,1163,92.6666666666667
"600","02248","2021",2,2,0,95000,1413.5,67
"601","02249","2021",3,3,0,188522,1149.33333333333,163.666666666667
"602","02250","2021",2,2,0,133225,1257,102.5
"603","02251","2021",1,1,0,30000,545,55
"604","02252","2021",2,2,0,35500,915.5,38
"605","02253","2021",1,1,0,190000,1357,140
"606","02254","2021",5,5,0,162600,1878.6,91.8
"607","02255","2021",5,5,0,134600,1189.4,130
"608","02256","2021",3,3,0,82250,769.666666666667,108.333333333333
"609","02257","2021",6,6,0,186166.666666667,1547.5,122
"610","02258","2021",7,7,0,155464.285714286,1887.14285714286,87.2857142857143
"611","02259","2021",5,5,0,212600,2011.4,109.6
"612","02260","2021",9,9,0,91860.8888888889,1077,95.6666666666667
"613","02261","2021",13,13,0,73272,848.307692307692,88.6923076923077
"614","02262","2021",1,1,0,168000,1680,100
"615","02263","2021",3,3,0,182666.666666667,1313.66666666667,137.666666666667
"616","02264","2021",6,6,0,63000,667.833333333333,97.5
"617","02266","2021",2,2,0,54500,622,84.5
"618","02267","2021",4,4,0,189750,2335,99.75
"619","02268","2021",13,13,0,178750.538461538,2020,95.3846153846154
"620","02269","2021",3,3,0,96333.3333333333,1017,90
"621","02270","2021",2,2,0,123250,1285,83
"622","02271","2021",5,5,0,150646.6,1428.2,116
"623","02272","2021",5,5,0,144200,1565,94.4
"624","02274","2021",4,4,0,87100,1155.25,72.25
"625","02275","2021",4,4,0,62975,825,68.75
"626","02276","2021",3,3,0,115333.333333333,1435.66666666667,86
"627","02277","2021",13,13,0,155550,1449.84615384615,104.846153846154
"628","02279","2021",14,14,0,179706.428571429,1589.71428571429,111.785714285714
"629","02280","2021",7,7,0,190928.571428571,1907,96.4285714285714
"630","02281","2021",5,5,0,128400,1287.8,111.4
"631","02282","2021",6,6,0,108490.833333333,1382.83333333333,80.5
"632","02284","2021",2,2,0,134500,1039.5,126
"633","02286","2021",9,9,0,82855.5555555556,827.222222222222,93.3333333333333
"634","02287","2021",16,16,0,164728.125,1421.625,116
"635","02288","2021",4,4,0,144625,1259.5,128
"636","02289","2021",8,8,0,144950.125,1495.5,96.625
"637","02290","2021",36,34,2,147048.166666667,1704.02777777778,96.7777777777778
"638","02291","2021",4,4,0,135922.5,1154.25,128.25
"639","02292","2021",20,20,0,152250,1833.2,85
"640","02293","2021",2,2,0,110000,1388.5,120
"641","02294","2021",1,1,0,175000,1296,135
"642","02295","2021",8,8,0,92331.25,839,106.375
"643","02296","2021",8,8,0,129562.5,1299.25,102.75
"644","02297","2021",1,1,0,150000,974,154
"645","02298","2021",19,19,0,91263.1578947368,1047.57894736842,89
"646","02299","2021",9,9,0,161238.888888889,1560.77777777778,103.444444444444
"647","02302","2021",6,5,1,138916.666666667,1710.66666666667,88.5
"648","02303","2021",11,11,0,230677.272727273,1786.90909090909,132.363636363636
"649","02304","2021",38,25,13,79454.3421052632,889.368421052632,97.2105263157895
"650","02305","2021",45,37,8,99047.0666666667,1080,91.1555555555556
"651","02306","2021",14,14,0,112421.428571429,909.714285714286,120.642857142857
"652","02307","2021",36,32,4,153887.5,1715.80555555556,91.8333333333333
"653","02308","2021",10,10,0,114375,1028.1,110.5
"654","02309","2021",8,7,1,126312.5,1186.25,105.875
"655","02310","2021",4,4,0,174650,1165.5,143
"656","02312","2021",9,9,0,135500,1601.77777777778,98
"657","02313","2021",6,6,0,149583.333333333,1274.5,117.833333333333
"658","02315","2021",28,27,1,117671.428571429,1270.85714285714,100.607142857143
"659","02316","2021",7,7,0,162112.142857143,1640.71428571429,97.1428571428571
"660","02317","2021",4,4,0,150000,1317.5,112
"661","02318","2021",19,19,0,93971.0526315789,1213.05263157895,77.2631578947368
"662","02319","2021",5,5,0,73562.4,932,76
"663","02320","2021",6,6,0,138900,1261,121.166666666667
"664","02321","2021",8,8,0,107075,967.5,111.375
"665","02322","2021",4,4,0,131250,1249.25,104.25
"666","02323","2021",2,2,0,104000,774.5,133
"667","02324","2021",3,3,0,114166.666666667,1191,106.333333333333
"668","02326","2021",11,11,0,196290,1366,139.181818181818
"669","02327","2021",4,4,0,121607.5,1224.5,90
"670","02328","2021",8,8,0,171500,1743.875,100.375
"671","02329","2021",2,2,0,52500,957,55
"672","02330","2021",3,3,0,246250,2302,107
"673","02331","2021",4,4,0,126250,1455.75,91.25
"674","02332","2021",1,1,0,125000,992,126
"675","02333","2021",3,3,0,107666.666666667,1315.33333333333,87.6666666666667
"676","02334","2021",39,39,0,88342.8461538462,919.128205128205,96.2307692307692
"677","02335","2021",3,3,0,128766.666666667,1929,73
"678","02336","2021",6,6,0,143833.333333333,1518.33333333333,98
"679","02337","2021",4,4,0,182250,1627.5,115.25
"680","02338","2021",4,4,0,117775,1106.75,106.75
"681","02339","2021",17,16,1,136900,1447,94
"682","02340","2021",62,59,3,115270.806451613,1341.41935483871,87.5161290322581
"683","02341","2021",1,1,0,36000,545,66
"684","02342","2021",3,3,0,92666.6666666667,1139,85.3333333333333
"685","02343","2021",1,1,0,248000,996,249
"686","02345","2021",1,1,0,63000,663,95
"687","02346","2021",10,10,0,149455,1450,106.4
"688","02347","2021",7,7,0,143857.142857143,1665,88
"689","02350","2021",1,1,0,110000,786,140
"690","02351","2021",8,8,0,190245,1756.875,113.25
"691","02352","2021",7,7,0,115853.142857143,1324.71428571429,92.5714285714286
"692","02353","2021",4,4,0,106075,1124.75,102.5
"693","02354","2021",1,1,0,70000,438,160
"694","02355","2021",22,22,0,134834.090909091,1337.90909090909,102.090909090909
"695","02356","2021",5,5,0,110285,1422.2,91.2
"696","02357","2021",1,1,0,52000,400,130
"697","02358","2021",3,3,0,72633.3333333333,609.666666666667,129.333333333333
"698","02359","2021",25,16,9,115960,1400.4,79.36
"699","02360","2021",41,40,1,181919.073170732,1842.0243902439,101.780487804878
"700","02361","2021",52,51,1,74729.0384615385,857.673076923077,84.9423076923077
"701","02362","2021",3,3,0,105335.333333333,1056.33333333333,98.6666666666667
"702","02363","2021",9,9,0,90666.6666666667,1063.44444444444,92.4444444444444
"703","02364","2021",8,8,0,171937.5,1699.125,103.625
"704","02366","2021",4,4,0,97000,1126.75,97.5
"705","02367","2021",3,3,0,199000,1715.33333333333,108.333333333333
"706","02368","2021",6,6,0,246674.666666667,2150.33333333333,126.166666666667
"707","02369","2021",1,1,0,70000,1429,49
"708","02370","2021",8,8,0,114150,1078.25,105
"709","02371","2021",21,21,0,140346.428571429,1435.42857142857,97.9523809523809
"710","02372","2021",5,5,0,135425,1334.8,95.2
"711","02374","2021",7,6,1,100017.142857143,1145.42857142857,84
"712","02375","2021",2,2,0,139500,1520.5,96
"713","02376","2021",2,2,0,82500,777,108
"714","02377","2021",2,2,0,42500,494.5,86
"715","02378","2021",1,1,0,130000,1806,72
"716","02379","2021",3,3,0,65282.3333333333,631.666666666667,96
"717","02380","2021",1,1,0,110000,1279,86
"718","02381","2021",112,107,5,76955.3035714286,868.196428571429,87.7589285714286
"719","02382","2021",8,8,0,211843.75,1725.5,117.125
"720","02383","2021",15,13,2,142380,1504.93333333333,95.3333333333333
"721","02385","2021",1,1,0,52000,1040,50
"722","02386","2021",4,4,0,157382.5,1288,104.5
"723","02387","2021",19,19,0,162636.736842105,1476.94736842105,109.736842105263
"724","02388","2021",2,2,0,60000,849.5,62
"725","02389","2021",12,12,0,190758.333333333,1467,122.416666666667
"726","02390","2021",4,4,0,205655,1845,115.5
"727","02391","2021",5,5,0,158403,1420,111.4
"728","02392","2021",5,5,0,115950,1024.8,115.2
"729","02393","2021",2,2,0,90000,1080.5,87
"730","02395","2021",1,1,0,160000,1882,85
"731","02396","2021",2,2,0,70000,1197.5,58.5
"732","02397","2021",14,14,0,103921.428571429,1086.21428571429,99.2857142857143
"733","02398","2021",2,2,0,166500,1666.5,103.5
"734","02399","2021",3,3,0,163500,1798,91.6666666666667
"735","02401","2021",2,2,0,92500,1030,88
"736","02402","2021",1,1,0,65900,879,75
"737","02403","2021",5,5,0,80820,682.6,129.2
"738","02404","2021",2,2,0,150387,1676,87.5
"739","02405","2021",6,6,0,112908.333333333,991.5,110.5
"740","02406","2021",1,1,0,270000,954,283
"741","02407","2021",3,3,0,271666.666666667,1380,202
"742","02408","2021",309,192,117,97714.7475728155,1197.05177993528,84.9449838187702
"743","02409","2021",3,3,0,51763.3333333333,733.333333333333,68.6666666666667
"744","02410","2021",10,10,0,150400,1638.3,97.4
"745","02411","2021",2,2,0,103750,1139.5,89
"746","02412","2021",5,5,0,107613.4,1344.8,85.6
"747","02413","2021",5,5,0,153860,1456.2,110.2
"748","02414","2021",4,4,0,139487.5,964,160.75
"749","02415","2021",4,4,0,216682.5,2414.75,96.25
"750","02416","2021",5,5,0,104000,969.8,111.2
"751","02417","2021",2,2,0,123100,881,147.5
"752","02418","2021",3,3,0,70366.6666666667,861.666666666667,82.6666666666667
"753","02419","2021",5,5,0,150400,1469.4,107.8
"754","02420","2021",6,6,0,159916.666666667,1609.66666666667,98.3333333333333
"755","02421","2021",2,2,0,132500,1196.5,109.5
"756","02422","2021",15,15,0,84580,881.866666666667,94
"757","02423","2021",10,10,0,139959,1445.4,99.2
"758","02424","2021",4,4,0,103357.5,941.25,102.75
"759","02425","2021",2,2,0,105000,942.5,112
"760","02426","2021",12,12,0,132216.75,1099.75,119.583333333333
"761","02427","2021",1,1,0,78000,1000,78
"762","02429","2021",1,1,0,55162,1226,45
"763","02430","2021",19,19,0,84810.5263157895,900,96.2105263157895
"764","02431","2021",1,1,0,50000,781,64
"765","02432","2021",3,3,0,146466.666666667,1676,97.3333333333333
"766","02433","2021",2,2,0,90005,878.5,102
"767","02438","2021",3,3,0,166000,1892,89.3333333333333
"768","02439","2021",15,15,0,142533.6,1349,103.4
"769","02440","2021",2,2,0,114590,838.5,127.5
"770","02441","2021",4,4,0,223500,1784,132.5
"771","02442","2021",3,3,0,144633.333333333,1224,129.333333333333
"772","02443","2021",1,1,0,45000,1125,40
"773","02444","2021",2,2,0,108900,1131,96
"774","02445","2021",3,3,0,215333.333333333,1367.33333333333,150.333333333333
"775","02446","2021",1,1,0,105000,1105,95
"776","02447","2021",5,5,0,107360,1025,102.2
"777","02448","2021",2,2,0,141150,1410,98.5
"778","02449","2021",1,1,0,187000,1520,123
"779","02450","2021",4,4,0,75875,737.25,96.5
"780","02451","2021",3,3,0,102666.666666667,1163.33333333333,98
"781","02452","2021",4,4,0,153850,1206,130
"782","02453","2021",10,10,0,148332,1610,95.3
"783","02454","2021",8,8,0,159525,1293.125,118.875
"784","02455","2021",1,1,0,75600,1643,46
"785","02456","2021",1,1,0,203100,1846,110
"786","02457","2021",8,8,0,89968.75,866,102.375
"787","02458","2021",17,17,0,180049.117647059,1417.41176470588,126.588235294118
"788","02459","2021",2,2,0,161250,1143,138.5
"789","02460","2021",2,2,0,115450,1708.5,67
"790","02461","2021",4,4,0,122762.5,1376.25,91.5
"791","02462","2021",5,5,0,170988,1615.8,116.4
"792","02464","2021",3,3,0,173990,1584.33333333333,111.666666666667
"793","02465","2021",7,7,0,169591.428571429,1879.71428571429,100.428571428571
"794","02466","2021",2,2,0,119500,1122,105.5
"795","02468","2021",23,23,0,87800.652173913,941.913043478261,97.3478260869565
"796","02469","2021",4,4,0,128250,1005.75,136.5
"797","02470","2021",5,5,0,85030,819,106
"798","02471","2021",1,1,0,105000,1117,94
"799","02472","2021",1,1,0,75000,1190,63
"800","02474","2021",8,8,0,123237.5,1413.875,101.25
"801","02476","2021",17,17,0,75745.8823529412,716.823529411765,109.176470588235
"802","02477","2021",12,9,3,141291.666666667,1585.16666666667,86.8333333333333
"803","02478","2021",4,4,0,190625,1528.5,139
"804","02480","2021",3,3,0,134833.333333333,1153,120.666666666667
"805","02481","2021",6,6,0,515416.666666667,2558,147.333333333333
"806","02482","2021",1,1,0,1e+05,962,104
"807","02483","2021",9,9,0,131277.777777778,1002.22222222222,142.777777777778
"808","02484","2021",7,7,0,109928.571428571,1249.85714285714,89.4285714285714
"809","02485","2021",2,2,0,251000,1739.5,154.5
"810","02486","2021",1,1,0,145000,1272,114
"811","02487","2021",2,2,0,105500,1041,103
"812","02489","2021",6,6,0,152683.333333333,1691.16666666667,97.3333333333333
"813","02490","2021",2,2,0,135000,1230,112.5
"814","02491","2021",4,4,0,125100,832,151.75
"815","02492","2021",5,5,0,89816,923.6,103.2
"816","02493","2021",1,1,0,70000,1207,58
"817","02494","2021",2,2,0,42000,447,94.5
"818","02495","2021",12,12,0,124413.333333333,1166.58333333333,104.333333333333
"819","02496","2021",1,1,0,80000,870,92
"820","02497","2021",7,7,0,100285.714285714,1316.57142857143,79.4285714285714
"821","02498","2021",8,8,0,135437.5,1152.875,124.375
"822","02499","2021",1,1,0,186000,1240,150
"823","02500","2021",14,14,0,88836.5714285714,996.857142857143,88.1428571428571
"824","02501","2021",1,1,0,128500,676,190
"825","02502","2021",25,24,1,97378.4,1005.04,106.2
"826","02503","2021",2,2,0,50000,555.5,88
"827","02504","2021",27,27,0,113438.888888889,1174.33333333333,97.6296296296296
"828","02505","2021",3,3,0,166333.333333333,1941.33333333333,96.6666666666667
"829","02506","2021",7,7,0,221714.285714286,1740.14285714286,125.428571428571
"830","02508","2021",2,2,0,247400,1158,224
"831","02511","2021",7,7,0,73669.1428571429,763.714285714286,94
"832","02512","2021",12,12,0,184233.333333333,1793.16666666667,104.333333333333
"833","02513","2021",3,3,0,101000,816.333333333333,122.666666666667
"834","02514","2021",9,9,0,165672.222222222,2365.88888888889,73.1111111111111
"835","02515","2021",1,1,0,387385,1927,201
"836","02517","2021",6,6,0,112666.666666667,1034.66666666667,118
"837","02518","2021",2,2,0,98000,1891.5,53.5
"838","02519","2021",1,1,0,70000,642,109
"839","02520","2021",12,12,0,128145.833333333,1365.16666666667,103.333333333333
"840","02521","2021",24,24,0,188083.541666667,2135.45833333333,92
"841","02523","2021",3,3,0,132333.333333333,2307.66666666667,55.6666666666667
"842","02524","2021",11,11,0,141636.363636364,1546.09090909091,94.9090909090909
"843","02525","2021",12,12,0,186195.166666667,1912.33333333333,97.4166666666667
"844","02527","2021",5,5,0,121500,1143.6,107.2
"845","02528","2021",1,1,0,130000,1912,68
"846","02529","2021",2,2,0,154000,944,159.5
"847","02530","2021",1,1,0,68000,2061,33
"848","02531","2021",1,1,0,65000,1300,50
"849","02532","2021",10,10,0,135913,1309.1,97.7
"850","02533","2021",2,2,0,159498,1087,128
"851","02534","2021",1,1,0,30000,652,46
"852","02535","2021",2,2,0,140950,1160.5,127
"853","02537","2021",6,6,0,120833.333333333,1259.16666666667,97.3333333333333
"854","02538","2021",1,1,0,82500,1269,65
"855","02539","2021",10,10,0,107200,1079.8,108.7
"856","02540","2021",15,15,0,172729.333333333,1897.6,93.0666666666667
"857","02541","2021",15,15,0,163510,1510.26666666667,113.333333333333
"858","02542","2021",1,1,0,273362,1478,185
"859","02543","2021",45,43,2,124299.644444444,1393.46666666667,93.7333333333333
"860","02544","2021",4,4,0,124625,986.5,122.5
"861","02545","2021",1,1,0,77950,1218,64
"862","02546","2021",3,3,0,138000,1405,94.6666666666667
"863","02547","2021",1,1,0,139000,818,170
"864","02548","2021",6,6,0,121833.333333333,861.333333333333,151.166666666667
"865","02549","2021",13,13,0,117615.384615385,1485.53846153846,81.7692307692308
"866","02552","2021",4,4,0,97875,886,107.5
"867","02554","2021",14,13,1,199600,2155.35714285714,94.4285714285714
"868","02555","2021",38,35,3,156518.421052632,1808.36842105263,90.2105263157895
"869","02556","2021",3,3,0,101766.666666667,894.333333333333,119.333333333333
"870","02557","2021",4,4,0,115760,1549.5,77.25
"871","02558","2021",29,29,0,85436.2068965517,922.551724137931,90.7586206896552
"872","02559","2021",7,7,0,124575,1046.57142857143,107.857142857143
"873","02560","2021",1,1,0,45000,643,70
"874","02562","2021",4,4,0,166237.5,1796.75,106.25
"875","02563","2021",5,5,0,78200,801.6,100.2
"876","02564","2021",10,10,0,170395,1690.3,103.7
"877","02565","2021",5,5,0,140660,1510.6,97.4
"878","02566","2021",14,14,0,141738.071428571,1475.35714285714,94.7142857142857
"879","02567","2021",4,4,0,90625,741.75,134
"880","02568","2021",4,4,0,195500,1714.25,118.25
"881","02569","2021",6,6,0,71250,850.166666666667,89
"882","02570","2021",1,1,0,110000,705,156
"883","02571","2021",3,3,0,83000,1182,69.6666666666667
"884","02572","2021",8,8,0,235881.25,2043,117.5
"885","02574","2021",20,20,0,117050,1123.65,102.55
"886","02575","2021",15,14,1,70086.6666666667,845.466666666667,86.6666666666667
"887","02576","2021",5,5,0,184600,1714.2,110.4
"888","02577","2021",2,2,0,142300,1302.5,118
"889","02578","2021",1,1,0,328210,2930,112
"890","02579","2021",2,2,0,137000,1467.5,94
"891","02580","2021",10,10,0,112190,1311.9,96.3
"892","02581","2021",6,6,0,156816.666666667,1429.33333333333,105
"893","02582","2021",1,1,0,70000,1556,45
"894","02585","2021",4,4,0,228307.5,1867.25,125
"895","02586","2021",1,1,0,65000,722,90
"896","02587","2021",2,2,0,207500,1443.5,143.5
"897","02588","2021",1,1,0,145000,1611,90
"898","02589","2021",3,3,0,189000,1851,103.333333333333
"899","02590","2021",2,2,0,185000,1726.5,104
"900","02591","2021",1,1,0,110000,1486,74
"901","02592","2021",7,7,0,70242.8571428571,755.428571428571,93.2857142857143
"902","02593","2021",8,8,0,227537.5,1976.5,121
"903","02594","2021",3,3,0,135833.333333333,1702.33333333333,80
"904","02595","2021",1,1,0,185000,1989,93
"905","02596","2021",14,14,0,138500,1700.07142857143,84.9285714285714
"906","02598","2021",6,6,0,127000,1806.83333333333,78.3333333333333
"907","02599","2021",7,7,0,122652.857142857,1221.42857142857,98.5714285714286
"908","02600","2021",4,4,0,51937.5,615,87
"909","02601","2021",2,2,0,181350,1751.5,102
"910","02602","2021",21,21,0,118528.571428571,1427.80952380952,83.2380952380952
"911","02604","2021",1,1,0,42000,525,80
"912","02605","2021",3,3,0,84500,911.333333333333,100.666666666667
"913","02606","2021",3,3,0,175333.333333333,1253.66666666667,138.333333333333
"914","02607","2021",1,1,0,327875,1832,179
"915","02608","2021",3,3,0,75000,756.666666666667,94.6666666666667
"916","02610","2021",9,8,1,132022.222222222,1553,86.8888888888889
"917","02612","2021",2,2,0,103000,829,122.5
"918","02613","2021",13,13,0,188900,1589.38461538462,121.384615384615
"919","02614","2021",5,5,0,105120,1256.2,83.8
"920","02615","2021",5,5,0,154173.4,1574.2,95.8
"921","02616","2021",7,7,0,177642.857142857,1700.28571428571,106.571428571429
"922","02617","2021",8,8,0,83483.75,861,99
"923","02618","2021",4,4,0,82000,783.5,108.5
"924","02619","2021",5,5,0,127360,1568.6,81.4
"925","02620","2021",5,5,0,150380,1120,134.2
"926","02621","2021",9,9,0,224592.222222222,1694.33333333333,131.666666666667
"927","02623","2021",2,2,0,34500,498.5,66
"928","02624","2021",4,4,0,59250,881.5,78
"929","02625","2021",4,4,0,115475,1055.25,103.25
"930","02626","2021",9,9,0,165733.333333333,1776.66666666667,95.1111111111111
"931","02627","2021",1,1,0,188000,1393,135
"932","02628","2021",3,3,0,130000,1505.66666666667,85.3333333333333
"933","02629","2021",1,1,0,115600,1061,109
"934","02631","2021",6,6,0,110166.666666667,1360.66666666667,81.8333333333333
"935","02634","2021",1,1,0,171000,1425,120
"936","02636","2021",2,2,0,155500,1223,137
"937","02637","2021",6,6,0,144510,1278,125.833333333333
"938","02638","2021",6,6,0,80658.3333333333,779,100.333333333333
"939","02639","2021",6,6,0,132226,1281.66666666667,100.166666666667
"940","02640","2021",3,3,0,92200,585.666666666667,152
"941","02641","2021",1,1,0,62000,620,100
"942","02642","2021",6,6,0,61666.6666666667,573.833333333333,113
"943","02643","2021",7,7,0,172000,1582,113
"944","02644","2021",9,9,0,199762.222222222,1570.33333333333,129.555555555556
"945","02645","2021",4,4,0,126125,1508.75,99.75
"946","02647","2021",4,4,0,110000,1003.5,137.25
"947","02648","2021",26,26,0,96096.1538461538,1033.03846153846,91.1538461538462
"948","02649","2021",9,9,0,174357.777777778,1269.88888888889,142.444444444444
"949","02650","2021",4,4,0,83750,811,125.5
"950","02651","2021",1,1,0,85000,773,110
"951","02652","2021",2,2,0,128750,1278,99.5
"952","02653","2021",11,11,0,153772.727272727,1645.63636363636,104.545454545455
"953","02655","2021",1,1,0,230000,1983,116
"954","02656","2021",13,13,0,140842.307692308,1578.38461538462,91.5384615384615
"955","02657","2021",1,1,0,48000,667,72
"956","02658","2021",3,3,0,144333.333333333,1068.66666666667,144
"957","02659","2021",10,10,0,173395,1790.1,97.5
"958","02660","2021",1,1,0,175000,1400,125
"959","02661","2021",2,2,0,127000,2185.5,56
"960","02662","2021",8,8,0,113593.75,1389,83.75
"961","02663","2021",3,3,0,229666.666666667,2228,97.6666666666667
"962","02664","2021",2,2,0,155500,1218.5,128.5
"963","02665","2021",3,3,0,130966.666666667,1203.33333333333,107.666666666667
"964","02666","2021",8,8,0,73225,881.25,89.875
"965","02667","2021",2,2,0,155000,1597,97
"966","02668","2021",4,4,0,48660,660,72
"967","02670","2021",2,2,0,43650,376,115
"968","02671","2021",4,4,0,89675,947.75,100
"969","02672","2021",3,3,0,268266.666666667,1895,140
"970","02673","2021",6,6,0,168166.666666667,1437.16666666667,128
"971","02674","2021",2,2,0,136200,1276,101
"972","02675","2021",2,2,0,150300,1237.5,120.5
"973","02676","2021",26,26,0,109447.269230769,1135.76923076923,97.7307692307692
"974","02677","2021",3,3,0,131333.333333333,1198.33333333333,105.666666666667
"975","02679","2021",4,4,0,172750,1542.5,108.25
"976","02680","2021",35,35,0,97157.7714285714,1135.68571428571,84.6571428571429
"977","02681","2021",4,4,0,46975,669.75,70
"978","02682","2021",2,2,0,110500,1175.5,94
"979","02684","2021",37,35,2,71875.6756756757,800.135135135135,91.4864864864865
"980","02685","2021",1,1,0,253000,2300,110
"981","02686","2021",6,6,0,130200,1260.33333333333,108.833333333333
"982","02687","2021",9,9,0,303101.111111111,1922.55555555556,159.777777777778
"983","02688","2021",1,1,0,44000,518,85
"984","02689","2021",1,1,0,80000,602,133
"985","02691","2021",720,588,132,107689.320833333,1241.85416666667,87.5277777777778
"986","02693","2021",8,8,0,139562.5,940,147.125
"987","02694","2021",7,7,0,90741.4285714286,878.857142857143,100.428571428571
"988","02697","2021",3,3,0,151666.666666667,1482,102.333333333333
"989","02698","2021",1,1,0,129000,1040,124
"990","02699","2021",5,5,0,131831.4,1287,103.2
"991","02701","2021",17,16,1,153323.529411765,1642.64705882353,97.3529411764706
"992","02702","2021",6,6,0,152066.666666667,1521.5,102.166666666667
"993","02703","2021",10,10,0,88078,799.2,105.8
"994","02704","2021",3,3,0,114533.333333333,1243,98
"995","02705","2021",2,2,0,85000,940,94.5
"996","02706","2021",8,7,1,143562.5,1512,100.875
"997","02707","2021",4,4,0,116750,1699.25,69.75
"998","02708","2021",3,3,0,68666.6666666667,650.666666666667,111.666666666667
"999","02709","2021",6,6,0,105916.666666667,779.166666666667,133.5
"1000","02710","2021",5,5,0,146197.4,1743,84.6
"1001","02711","2021",6,6,0,139716.666666667,1487,97.6666666666667
"1002","02712","2021",1,1,0,130000,1083,120
"1003","02713","2021",3,3,0,111000,1492,98.3333333333333
"1004","02714","2021",5,5,0,153394,1662.4,96
"1005","02715","2021",2,2,0,120500,1978.5,56.5
"1006","02716","2021",9,9,0,145193.333333333,1238,123.111111111111
"1007","02717","2021",3,3,0,171000,1363.33333333333,126.333333333333
"1008","02718","2021",5,5,0,143270,2154.6,80.8
"1009","02719","2021",35,35,0,112299.142857143,1241.31428571429,95.3714285714286
"1010","02720","2021",26,26,0,91519.2307692308,1011.15384615385,91.4615384615385
"1011","02721","2021",8,8,0,93812.5,970.625,111.25
"1012","02722","2021",383,179,204,144449.315926893,1717.18537859008,82.7832898172324
"1013","02723","2021",1,1,0,98050,831,118
"1014","02726","2021",3,3,0,93333.3333333333,1127.66666666667,85.6666666666667
"1015","02728","2021",4,4,0,95832,1027.25,95.25
"1016","02729","2021",1,1,0,242000,1984,122
"1017","02730","2021",4,4,0,217250,1213.25,159.5
"1018","02731","2021",5,5,0,91000,1038.6,89.6
"1019","02734","2021",2,2,0,150500,2087,73.5
"1020","02736","2021",1,1,0,165000,1833,90
"1021","02737","2021",3,3,0,46291.6666666667,569.666666666667,83.3333333333333
"1022","02738","2021",191,188,3,95267.5130890052,1136.72251308901,86.3769633507853
"1023","02739","2021",5,5,0,150000,1433.4,109.2
"1024","02740","2021",3,3,0,147333.333333333,1577,89
"1025","02741","2021",6,6,0,65416.6666666667,762.833333333333,82.8333333333333
"1026","02742","2021",1,1,0,170000,509,334
"1027","02744","2021",2,2,0,168750,1845.5,91.5
"1028","02746","2021",6,6,0,131750,1026,130.833333333333
"1029","02748","2021",19,19,0,128394.736842105,1404.63157894737,91.1052631578947
"1030","02749","2021",1,1,0,190950,1646,116
"1031","02750","2021",11,11,0,113914.090909091,1243.27272727273,97.4545454545455
"1032","02751","2021",2,2,0,112775,1089.5,101
"1033","02752","2021",5,5,0,115610,1356.6,88
"1034","02753","2021",5,5,0,77600,1237.4,68.2
"1035","02754","2021",1,1,0,25000,417,60
"1036","02755","2021",3,3,0,116333.333333333,1324.33333333333,87.6666666666667
"1037","02756","2021",10,10,0,137380,1502,91
"1038","02757","2021",11,11,0,79490.9090909091,819.090909090909,100.363636363636
"1039","02758","2021",34,31,3,119192.852941176,1420.08823529412,86.7941176470588
"1040","02759","2021",4,4,0,67500,622.5,110.25
"1041","02760","2021",2,2,0,140500,1191,129.5
"1042","02761","2021",1,1,0,226000,2112,107
"1043","02762","2021",2,2,0,183650,1658.5,118
"1044","02764","2021",1,1,0,104000,1300,80
"1045","02765","2021",2,2,0,187000,1723.5,107.5
"1046","02766","2021",1,1,0,84000,1077,78
"1047","02767","2021",6,6,0,225886,1758.83333333333,133.666666666667
"1048","02768","2021",7,7,0,125462.857142857,1295.42857142857,97.7142857142857
"1049","02769","2021",9,9,0,103316.666666667,836,120.333333333333
"1050","02770","2021",8,8,0,168960,1760.5,97
"1051","02772","2021",3,3,0,93333.3333333333,905.666666666667,93
"1052","02774","2021",1,1,0,85000,802,106
"1053","02775","2021",11,11,0,130994.545454545,1410.27272727273,96
"1054","02776","2021",5,5,0,93074.6,1000.4,90
"1055","02777","2021",4,4,0,156000,1296.75,121.75
"1056","02778","2021",3,3,0,188000,1250.66666666667,139.333333333333
"1057","02779","2021",6,6,0,97400,1020.66666666667,94.6666666666667
"1058","02780","2021",11,11,0,155254.545454545,1911.90909090909,86.6363636363636
"1059","02781","2021",3,3,0,235153.333333333,1605.33333333333,153
"1060","02782","2021",7,7,0,99714.2857142857,924,102.285714285714
"1061","02783","2021",1,1,0,58000,414,140
"1062","02784","2021",1,1,0,63000,900,70
"1063","02785","2021",13,13,0,120253.846153846,1637.23076923077,72.5384615384615
"1064","02786","2021",2,2,0,73650,1429,59.5
"1065","02787","2021",4,4,0,123225,1306,102.75
"1066","02788","2021",7,7,0,141042.857142857,1261.42857142857,112.714285714286
"1067","02789","2021",17,17,0,69264.7058823529,745.352941176471,97.2352941176471
"1068","02790","2021",3,3,0,87833.3333333333,895.666666666667,97.6666666666667
"1069","02791","2021",4,4,0,96750,1236.25,78.5
"1070","02792","2021",2,2,0,160000,1466.5,102
"1071","02793","2021",1,1,0,190000,1267,150
"1072","02794","2021",2,2,0,397300,1965,185
"1073","02795","2021",23,15,8,135433.043478261,1380,95.6521739130435
"1074","02796","2021",4,4,0,117475,1338.25,82.5
"1075","02797","2021",1,1,0,297450,992,300
"1076","02798","2021",22,21,1,132577.272727273,1378.68181818182,98.7727272727273
"1077","02799","2021",12,12,0,111491.666666667,1086.08333333333,99.8333333333333
"1078","02800","2021",6,6,0,148701.666666667,1540.66666666667,96.5
"1079","02801","2021",4,4,0,89375,785.75,114
"1080","02802","2021",4,4,0,112675,994.5,119.75
"1081","02803","2021",1,1,0,207800,1823,114
"1082","02804","2021",2,2,0,164087.5,1934,85
"1083","02805","2021",28,20,8,149983.571428571,1661.07142857143,87.8214285714286
"1084","02806","2021",4,4,0,91500,1392.5,60.75
"1085","02807","2021",10,10,0,184822,1437.6,130.5
"1086","02808","2021",5,5,0,79700,767.2,101
"1087","02809","2021",2,2,0,210760,1198.5,172
"1088","02810","2021",141,88,53,152431.992907801,1819.41134751773,84.2482269503546
"1089","02812","2021",4,4,0,172672.5,1767.5,99.25
"1090","02813","2021",6,6,0,90950,831.666666666667,107
"1091","02814","2021",1,1,0,1e+05,725,138
"1092","02815","2021",2,2,0,177500,1353,125.5
"1093","02816","2021",10,10,0,136750,1296.1,112.9
"1094","02818","2021",19,18,1,156811.315789474,1725.63157894737,94.1052631578947
"1095","02819","2021",1,1,0,70000,507,138
"1096","02820","2021",17,17,0,124294.117647059,1191.11764705882,106.764705882353
"1097","02821","2021",7,7,0,132200,1249.42857142857,108.428571428571
"1098","02822","2021",7,7,0,200515.714285714,1898,125.285714285714
"1099","02823","2021",1,1,0,30000,349,86
"1100","02824","2021",3,3,0,245650,1445.33333333333,181
"1101","02826","2021",1,1,0,70000,680,103
"1102","02827","2021",8,8,0,75225,680.5,112.625
"1103","02829","2021",2,2,0,120000,1834.5,65.5
"1104","02830","2021",9,9,0,82291.1111111111,1119.11111111111,85.3333333333333
"1105","02831","2021",5,5,0,163958,1746.8,103.2
"1106","02832","2021",5,5,0,128100,1226.6,102.8
"1107","02833","2021",2,2,0,81250,900.5,84
"1108","02834","2021",4,4,0,170687.5,1484.5,116.25
"1109","03001","2021",41,41,0,132284.243902439,1529.75609756098,89.3170731707317
"1110","03002","2021",4,4,0,177500,1746,107.25
"1111","03003","2021",15,15,0,73780,924.066666666667,85.8666666666667
"1112","03004","2021",2,2,0,55140,581,89.5
"1113","03005","2021",4,4,0,93000,1112.75,85.5
"1114","03006","2021",15,15,0,81892,1020.2,81.8
"1115","03007","2021",8,8,0,102550,910.125,103.25
"1116","03008","2021",5,5,0,107145,1438.2,78.2
"1117","03009","2021",2,2,0,77500,864.5,93.5
"1118","03010","2021",5,5,0,98200,1036.6,104
"1119","03011","2021",4,4,0,166142.5,1529,102.75
"1120","03012","2021",2,2,0,142000,1265,93
"1121","03013","2021",51,51,0,182714.901960784,1816.01960784314,103.705882352941
"1122","03014","2021",4,4,0,157855,1746.5,76.5
"1123","03015","2021",1,1,0,105000,1500,70
"1124","03016","2021",2,2,0,241500,1541,157
"1125","03017","2021",3,3,0,55666.6666666667,783,67.6666666666667
"1126","03018","2021",9,9,0,97322.2222222222,1113.44444444444,94
"1127","03019","2021",18,18,0,92797.2222222222,997.222222222222,91.8888888888889
"1128","03020","2021",4,4,0,122375,911.75,136
"1129","03021","2021",3,3,0,124156.666666667,977,129
"1130","03022","2021",19,19,0,103344.052631579,1134.52631578947,103.263157894737
"1131","03023","2021",188,150,38,162127.654255319,1729.06382978723,94.2925531914894
"1132","03024","2021",7,7,0,84095.7142857143,1396.42857142857,74.4285714285714
"1133","03025","2021",25,24,1,108391.6,1190.16,91.2
"1134","03026","2021",11,11,0,140521.818181818,1431.81818181818,99.4545454545455
"1135","03027","2021",13,13,0,91092.3076923077,997.153846153846,92.3076923076923
"1136","03028","2021",8,8,0,103920.625,951.75,100.25
"1137","03029","2021",26,26,0,110338.769230769,1083.80769230769,100.076923076923
"1138","03030","2021",13,13,0,139565.384615385,1386.92307692308,98
"1139","03031","2021",4,3,1,115000,965.75,118.75
"1140","03032","2021",1,1,0,44000,449,98
"1141","03033","2021",2,2,0,158750,1069,138
"1142","03034","2021",9,9,0,101537.777777778,1087,91.7777777777778
"1143","03035","2021",2,2,0,89941.5,696.5,127.5
"1144","03036","2021",24,23,1,96429.7916666667,988.75,93.9583333333333
"1145","03037","2021",6,6,0,66950,896.666666666667,67.3333333333333
"1146","03038","2021",9,9,0,115544.444444444,1235.33333333333,92.5555555555556
"1147","03039","2021",6,6,0,126716.666666667,1302.66666666667,93.1666666666667
"1148","03040","2021",12,12,0,181291.666666667,1575.58333333333,113.833333333333
"1149","03041","2021",3,3,0,104600,808.333333333333,130.333333333333
"1150","03042","2021",8,8,0,93400,831,107.375
"1151","03043","2021",15,15,0,142773.333333333,1564.2,98.5333333333333
"1152","03044","2021",26,24,2,161567.692307692,1632.69230769231,101.692307692308
"1153","03045","2021",8,8,0,145137.5,1309.25,122.625
"1154","03046","2021",23,23,0,87762.3913043478,961.217391304348,90.5217391304348
"1155","03047","2021",10,10,0,138383.5,1237.3,107
"1156","03048","2021",24,23,1,87295.8333333333,968.25,92.75
"1157","03049","2021",8,8,0,112621.875,1254.375,94.25
"1158","03050","2021",2,2,0,44200,729.5,71
"1159","03051","2021",5,5,0,97400,2344.8,57.2
"1160","03052","2021",20,20,0,106010,1071.5,94.45
"1161","03053","2021",25,25,0,91450.68,1046.36,91.6
"1162","03054","2021",4,4,0,166961.25,1779.25,77.5
"1163","03055","2021",16,16,0,133156.25,1092.5625,124.5
"1164","03056","2021",8,8,0,110121.25,1094.75,98.625
"1165","03057","2021",4,3,1,135500,1366.5,89.5
"1166","03058","2021",2,2,0,30175,708,42.5
"1167","03059","2021",6,6,0,160866.666666667,1681.33333333333,109.833333333333
"1168","03060","2021",18,18,0,178485.555555556,1708.55555555556,105.666666666667
"1169","03061","2021",3,3,0,175123.333333333,2143.33333333333,71.6666666666667
"1170","03062","2021",6,6,0,154132.666666667,1915.16666666667,102.666666666667
"1171","03063","2021",8,8,0,115173.125,1004,112.875
"1172","03064","2021",3,3,0,51166.6666666667,614.333333333333,79.3333333333333
"1173","03065","2021",3,2,1,105583.333333333,2093.33333333333,72.6666666666667
"1174","03066","2021",5,5,0,95200,979,102.8
"1175","03067","2021",1,1,0,75000,1875,40
"1176","03068","2021",4,4,0,110457.5,1102,102
"1177","03069","2021",2,2,0,89750,806,118
"1178","03070","2021",2,2,0,99000,1630.5,72.5
"1179","03071","2021",5,5,0,100962,921.4,119.8
"1180","03072","2021",6,6,0,66583.3333333333,693.5,97.5
"1181","03073","2021",3,3,0,86466.6666666667,986.333333333333,115
"1182","03074","2021",8,8,0,109750.125,949.75,102.875
"1183","03075","2021",8,8,0,43000,554.375,74
"1184","03076","2021",2,2,0,205000,1875.5,93.5
"1185","03077","2021",6,6,0,67126.6666666667,699.5,96.8333333333333
"1186","03078","2021",1,1,0,139400,1394,100
"1187","03079","2021",6,6,0,165191.666666667,1299,113.333333333333
"1188","03080","2021",15,15,0,153500.666666667,1422.4,111.733333333333
"1189","03081","2021",9,9,0,106163.333333333,1039.88888888889,124.666666666667
"1190","03082","2021",76,69,7,84214.6052631579,935.828947368421,91.9868421052632
"1191","03083","2021",5,5,0,144100,1501,115.2
"1192","03084","2021",35,34,1,89479.4285714286,960.342857142857,95.7714285714286
"1193","03085","2021",6,6,0,245766.666666667,1994,119
"1194","03087","2021",11,11,0,96693.7272727273,1030.18181818182,98
"1195","03088","2021",4,4,0,56200,847,62.5
"1196","03089","2021",6,6,0,47500,734.333333333333,80.6666666666667
"1197","03090","2021",5,5,0,121540,1334,90.2
"1198","03091","2021",7,7,0,91551.8571428571,959.285714285714,98.7142857142857
"1199","03092","2021",8,7,1,93137.5,783.25,124.375
"1200","03093","2021",17,17,0,190491.176470588,1585.41176470588,118.411764705882
"1201","03094","2021",53,47,6,173896.679245283,1548.90566037736,111.22641509434
"1202","03095","2021",252,150,102,111648.51984127,1303.02380952381,83.0515873015873
"1203","03096","2021",2,2,0,49500,695.5,71.5
"1204","03097","2021",8,8,0,64081.25,814.75,93.125
"1205","03098","2021",61,56,5,93677.8196721312,1127.52459016393,83.9344262295082
"1206","03099","2021",10,10,0,154961,1070.5,107.9
"1207","03100","2021",24,23,1,128510.625,1157.25,107.416666666667
"1208","03101","2021",121,117,4,119765.280991736,1242.8347107438,96.8099173553719
"1209","03102","2021",48,48,0,92099.375,997.104166666667,93.8541666666667
"1210","03103","2021",15,13,2,69064.6666666667,725.733333333333,95.6
"1211","03104","2021",17,17,0,88585.2941176471,842.647058823529,108.235294117647
"1212","03105","2021",6,6,0,83216.6666666667,831.166666666667,90.6666666666667
"1213","03106","2021",18,17,1,116577.222222222,1132.66666666667,105.666666666667
"1214","03107","2021",15,14,1,96566.6666666667,1293.13333333333,79.9333333333333
"1215","03108","2021",9,9,0,60963.3333333333,856.111111111111,77.3333333333333
"1216","03109","2021",12,12,0,149898.333333333,1288.75,126.5
"1217","03110","2021",16,16,0,162026.875,1547.5,103.3125
"1218","03111","2021",16,15,1,102891.625,1143.625,86.25
"1219","03112","2021",20,20,0,103846,1008.65,106.85
"1220","03113","2021",8,8,0,68268.75,676.375,107.625
"1221","03114","2021",1,1,0,90000,849,106
"1222","03115","2021",2,2,0,159900,979,164
"1223","03117","2021",9,9,0,109668.888888889,986.111111111111,122.555555555556
"1224","03118","2021",86,82,4,113083,1248.60465116279,94.8837209302326
"1225","03119","2021",6,6,0,95051.6666666667,955.833333333333,105.833333333333
"1226","03120","2021",11,11,0,94363.6363636364,826.363636363636,108.727272727273
"1227","03121","2021",7,7,0,152485.714285714,1440,109
"1228","03122","2021",2,2,0,135200,1385,90
"1229","03124","2021",7,7,0,138561.428571429,1192.85714285714,125.714285714286
"1230","03125","2021",6,6,0,71808.3333333333,721.333333333333,97.6666666666667
"1231","03126","2021",16,16,0,138737.375,1421.75,97.875
"1232","03127","2021",21,21,0,95028.5714285714,948.095238095238,103.857142857143
"1233","03128","2021",29,27,2,96406.3103448276,1001.48275862069,92.0344827586207
"1234","03129","2021",6,6,0,61638.1666666667,635.333333333333,106.166666666667
"1235","03130","2021",5,5,0,80800,1061.6,77.2
"1236","03131","2021",8,7,1,85515.625,1036,79.625
"1237","03132","2021",16,16,0,76925,778,96.3125
"1238","03133","2021",8,8,0,106387.5,1267.5,91
"1239","03134","2021",5,5,0,75300,946,90.8
"1240","03135","2021",8,8,0,114431.25,1159.125,91.375
"1241","03136","2021",3,3,0,119333.333333333,1301.33333333333,94.3333333333333
"1242","03137","2021",5,5,0,96480,951.6,99.2
"1243","03138","2021",44,39,5,94060.3863636364,997.636363636364,95.6136363636364
"1244","03139","2021",9,9,0,58277.7777777778,811.777777777778,71.6666666666667
"1245","03140","2021",13,13,0,111630.384615385,1146.53846153846,101.076923076923
"1246","03141","2021",4,4,0,79462.5,1226.75,77
"1247","03142","2021",5,5,0,102300,1125.4,86.2
"1248","03145","2021",7,7,0,95057.1428571429,1021,83.8571428571429
"1249","03146","2021",4,4,0,129775,1371.75,107.25
"1250","03147","2021",5,5,0,74140,1051.4,86.4
"1251","03148","2021",5,5,0,134760,1072.6,130.6
"1252","03149","2021",3,3,0,255166.666666667,4901.66666666667,85
"1253","03150","2021",5,5,0,69440,721.2,90.4
"1254","03151","2021",4,4,0,103270,886,124.5
"1255","03152","2021",8,8,0,63612.5,679.375,85.25
"1256","03154","2021",4,4,0,54651.25,654,81.75
"1257","03155","2021",32,32,0,88514.21875,953.28125,93.1875
"1258","03156","2021",27,27,0,129706.666666667,1303.40740740741,99.6666666666667
"1259","03157","2021",14,14,0,138468.857142857,1345.78571428571,100.571428571429
"1260","03158","2021",11,11,0,117718.181818182,1036.63636363636,118.090909090909
"1261","03159","2021",4,4,0,51862.5,665.5,78.5
"1262","03160","2021",6,6,0,240844.5,1354.33333333333,174.5
"1263","03161","2021",15,14,1,117651.666666667,978.533333333333,121.066666666667
"1264","03162","2021",5,5,0,180950.8,1178,153.2
"1265","03163","2021",8,8,0,149433.75,1410.75,110.875
"1266","03164","2021",7,7,0,155444.857142857,1307.28571428571,119.285714285714
"1267","03165","2021",23,22,1,102446.956521739,1093.34782608696,95.6521739130435
"1268","03166","2021",4,4,0,197765.5,1746.75,116.5
"1269","03167","2021",4,4,0,82325,1125.25,89.5
"1270","03168","2021",17,17,0,115452.941176471,962.941176470588,121.647058823529
"1271","03169","2021",4,4,0,121500,1170.75,98.25
"1272","03170","2021",1,1,0,76950,574,134
"1273","03171","2021",3,3,0,90750,1066,67.3333333333333
"1274","03172","2021",1,1,0,45000,441,102
"1275","03173","2021",12,12,0,94883.3333333333,1071,87.9166666666667
"1276","03174","2021",14,14,0,122982.142857143,1297.92857142857,95.2142857142857
"1277","03175","2021",10,10,0,105524,957.7,106.9
"1278","03176","2021",7,7,0,133440,1256,105.571428571429
"1279","03177","2021",3,3,0,92333.3333333333,882.333333333333,104.666666666667
"1280","03178","2021",13,13,0,81056.6923076923,824.846153846154,97.6153846153846
"1281","03179","2021",3,3,0,165126.666666667,1183.66666666667,138.666666666667
"1282","03180","2021",6,6,0,116333.333333333,1245.66666666667,99.5
"1283","03181","2021",15,15,0,70356,831.466666666667,83.4666666666667
"1284","03182","2021",2,2,0,164650,1572,115.5
"1285","03183","2021",5,5,0,64140,716.6,100.6
"1286","03184","2021",4,4,0,145925,1365.25,112.75
"1287","03185","2021",616,312,304,73435.6363636364,975.51461038961,74.9577922077922
"1288","03186","2021",21,19,2,75247.6190476191,761,99.1428571428571
"1289","03187","2021",5,5,0,125610,1107.4,111.6
"1290","03188","2021",3,3,0,95186.6666666667,991.666666666667,100
"1291","03189","2021",9,9,0,88233.3333333333,944.333333333333,101.777777777778
"1292","03190","2021",296,118,178,118091.236486486,1433.42567567568,82.9054054054054
"1293","03191","2021",3,3,0,103990,854.666666666667,124
"1294","03192","2021",4,4,0,105891.25,963.75,109.5
"1295","03193","2021",4,4,0,93125,1090.25,89.75
"1296","03194","2021",5,5,0,106270,1001.8,102.6
"1297","03195","2021",51,40,11,112103.31372549,1076.11764705882,104.823529411765
"1298","03196","2021",7,7,0,83352.1428571429,837.571428571429,101.142857142857
"1299","03197","2021",16,16,0,114461.25,1220.4375,90.9375
"1300","03200","2021",14,14,0,159675,1454.07142857143,108.857142857143
"1301","03201","2021",2,2,0,90260,713.5,130
"1302","03202","2021",9,9,0,63711.4444444444,759.777777777778,81.8888888888889
"1303","03203","2021",9,9,0,81461.1111111111,794.222222222222,93.8888888888889
"1304","03204","2021",8,8,0,135368.75,1335,100.5
"1305","03205","2021",4,4,0,100267.5,1085.5,90.75
"1306","03206","2021",2,2,0,46000,519,90
"1307","03207","2021",8,8,0,107806,1068,100.5
"1308","03208","2021",6,6,0,78786.6666666667,896.333333333333,90.8333333333333
"1309","03209","2021",1,1,0,317000,5283,60
"1310","03210","2021",4,4,0,61500,546.25,109.25
"1311","03211","2021",24,24,0,127882.333333333,1372,92.3333333333333
"1312","03212","2021",12,12,0,99585,1116.25,83.4166666666667
"1313","03213","2021",1,1,0,26000,361,72
"1314","03214","2021",3,3,0,173333.333333333,1288.66666666667,148
"1315","03215","2021",7,7,0,109282.857142857,848.142857142857,126.571428571429
"1316","03216","2021",4,4,0,77500,614.75,127.75
"1317","03217","2021",11,11,0,157531.363636364,1233.18181818182,131.454545454545
"1318","03218","2021",4,4,0,137200,1260.75,104.25
"1319","03219","2021",3,3,0,83233.3333333333,1097.33333333333,78
"1320","03220","2021",11,11,0,116993.454545455,1189.18181818182,96.4545454545455
"1321","03221","2021",16,15,1,85509.375,1013.75,84.4375
"1322","03222","2021",2,2,0,76000,950,90
"1323","03223","2021",8,8,0,97937.5,918.5,103.25
"1324","03224","2021",7,7,0,81087.1428571429,908.857142857143,86.2857142857143
"1325","03225","2021",6,6,0,97266.6666666667,887.166666666667,118.333333333333
"1326","03226","2021",5,5,0,114626,864,125.8
"1327","03227","2021",4,4,0,108637.5,1279.5,81.25
"1328","03228","2021",1,1,0,70000,1029,68
"1329","03229","2021",8,8,0,96103.75,1135.875,92.375
"1330","03230","2021",5,5,0,207020,1324.4,169
"1331","03231","2021",7,7,0,68678.5714285714,781,88.5714285714286
"1332","03232","2021",2,2,0,140080,1284.5,121.5
"1333","03233","2021",7,7,0,121471.428571429,1005.28571428571,115.142857142857
"1334","03234","2021",7,7,0,79892.8571428571,944.428571428571,84.5714285714286
"1335","03235","2021",13,13,0,88881.9230769231,760.307692307692,114.384615384615
"1336","03236","2021",57,49,8,108039.263157895,1277.40350877193,86.5087719298246
"1337","03237","2021",12,12,0,160019.166666667,1366.83333333333,110.166666666667
"1338","03238","2021",5,5,0,76800,610.2,111.8
"1339","03239","2021",3,3,0,117013.333333333,1316.33333333333,105
"1340","03240","2021",10,10,0,70959.6,855.6,81
"1341","03241","2021",5,5,0,189782.6,1701.2,98.2
"1342","03242","2021",3,3,0,125000,1065,110.666666666667
"1343","03243","2021",1,1,0,80000,777,103
"1344","03244","2021",8,8,0,38500,587.75,66.75
"1345","03245","2021",2,2,0,64000,552.5,132
"1346","03246","2021",5,5,0,56800,739.4,83.2
"1347","03247","2021",17,17,0,100394.117647059,1083.17647058824,96.6470588235294
"1348","03248","2021",8,8,0,69875,1209.375,62
"1349","03249","2021",5,5,0,75200,1019.6,86.6
"1350","03250","2021",6,6,0,98623.3333333333,1112.83333333333,86.3333333333333
"1351","03251","2021",10,10,0,78045,791.1,106
"1352","03252","2021",10,10,0,157650,1158.9,128.5
"1353","03253","2021",3,3,0,45000,724,71
"1354","03254","2021",71,57,14,108066.549295775,1236.71830985915,88.5070422535211
"1355","03255","2021",2,2,0,44000,705.5,65.5
"1356","03256","2021",7,7,0,103485.714285714,997.857142857143,108.428571428571
"1357","03257","2021",11,10,1,102240.090909091,1087.09090909091,91.0909090909091
"1358","03258","2021",24,24,0,181737.916666667,1633.41666666667,109.041666666667
"1359","03259","2021",5,5,0,76800,863.4,87
"1360","03260","2021",5,5,0,109870,932.4,109.8
"1361","03261","2021",2,2,0,134170,1243,97.5
"1362","03262","2021",24,23,1,125210.166666667,1342.75,92
"1363","03263","2021",2,2,0,27500,457.5,64
"1364","03264","2021",35,35,0,116843.714285714,1355.17142857143,86.4571428571429
"1365","03265","2021",8,8,0,91443.875,935,98.125
"1366","03266","2021",9,9,0,125490,1131.55555555556,101.111111111111
"1367","03267","2021",8,8,0,154183.75,1582.75,101.5
"1368","03268","2021",6,6,0,103175,1202,84
"1369","03269","2021",1,1,0,60000,923,65
"1370","03270","2021",2,2,0,81500,854,95.5
"1371","03271","2021",14,14,0,265149.785714286,1779.14285714286,149.071428571429
"1372","03272","2021",6,6,0,118763.333333333,1283.33333333333,83.8333333333333
"1373","03273","2021",5,5,0,176824,1790.4,96.8
"1374","03274","2021",4,4,0,78162.5,791.75,96.5
"1375","03275","2021",22,21,1,118909.227272727,1322.72727272727,93.0909090909091
"1376","03276","2021",4,4,0,98100,968.25,98
"1377","03277","2021",5,5,0,102400,1132.8,94
"1378","03278","2021",1,1,0,98000,1463,67
"1379","03279","2021",7,7,0,98571.4285714286,971.857142857143,99.7142857142857
"1380","03280","2021",6,6,0,66083.3333333333,869.166666666667,77.6666666666667
"1381","03281","2021",9,9,0,88338.8888888889,1061,83.2222222222222
"1382","03282","2021",10,10,0,123370,1124.4,87.8
"1383","03283","2021",18,18,0,103108.333333333,1181.16666666667,81.3888888888889
"1384","03284","2021",6,6,0,70325,693.333333333333,113.166666666667
"1385","03285","2021",4,4,0,70250,1088,68
"1386","03286","2021",11,11,0,213965,1701.90909090909,132.272727272727
"1387","03287","2021",16,16,0,103164.875,1186.8125,94.9375
"1388","03288","2021",8,8,0,69875,796.25,96.125
"1389","03289","2021",5,5,0,92160,1151.4,83.6
"1390","03290","2021",12,12,0,155400,1605.83333333333,96.9166666666667
"1391","03291","2021",7,7,0,112800,913.428571428571,126
"1392","03292","2021",15,15,0,90175.7333333333,938,97
"1393","03293","2021",8,8,0,70562.5,867.25,76.875
"1394","03294","2021",1,1,0,73590,759,97
"1395","03295","2021",3,3,0,40833.3333333333,650,65.6666666666667
"1396","03296","2021",5,5,0,52400,769.4,74.2
"1397","03297","2021",23,22,1,95034.347826087,1085.4347826087,90.1739130434783
"1398","03298","2021",64,51,13,89618.4375,1094.71875,80.546875
"1399","03299","2021",1,1,0,80000,615,130
"1400","03300","2021",11,11,0,88270.9090909091,997.636363636364,91.7272727272727
"1401","03301","2021",9,8,1,126016.666666667,1357.11111111111,99.5555555555556
"1402","03304","2021",36,36,0,197285.111111111,1662.66666666667,120.166666666667
"1403","03305","2021",6,6,0,87525,946.833333333333,87.6666666666667
"1404","03306","2021",24,24,0,166460.625,1542.95833333333,106.416666666667
"1405","03307","2021",6,6,0,165625,1330.16666666667,123.833333333333
"1406","03308","2021",1,1,0,33000,508,65
"1407","03309","2021",7,7,0,82885.7142857143,639.571428571429,118.285714285714
"1408","03310","2021",840,182,658,122456.719047619,1720.72261904762,70.3345238095238
"1409","03311","2021",3,3,0,123500,1141.33333333333,116.333333333333
"1410","03313","2021",6,6,0,101533.333333333,1026,98.1666666666667
"1411","03314","2021",13,13,0,94258.8461538462,979,94.9230769230769
"1412","03315","2021",14,14,0,89689.2857142857,1009.28571428571,90.8571428571429
"1413","03316","2021",16,16,0,137800.625,1490,105.1875
"1414","03317","2021",9,9,0,85588.8888888889,999.888888888889,89
"1415","03319","2021",15,15,0,108859.2,984.466666666667,104.4
"1416","03320","2021",11,11,0,100825.909090909,977.454545454545,104.636363636364
"1417","03321","2021",235,172,63,130903.680851064,1624.2170212766,82.463829787234
"1418","04001","2021",5,4,1,217320,2378.2,86.8
"1419","04004","2021",14,13,1,161249.5,1715.14285714286,94.5714285714286
"1420","04006","2021",238,17,221,76093,2244.45798319328,32.3403361344538
"1421","04008","2021",22,13,9,121117,1556.5,74.5454545454545
"1422","04012","2021",3,3,0,682811.333333333,3959,191.666666666667
"1423","04013","2021",4,4,0,209053.75,1988.25,106.5
"1424","04016","2021",2,2,0,138554,1928.5,72.5
"1425","04017","2021",3,1,2,73500,1408.33333333333,63
"1426","04018","2021",7,7,0,344328.571428571,3442,93.4285714285714
"1427","04019","2021",95,24,71,114125.010526316,2299,53.2526315789474
"1428","04022","2021",15,15,0,94278,1490.8,67.1333333333333
"1429","04023","2021",3,3,0,103300,1410.33333333333,84
"1430","04024","2021",1,1,0,189508,1840,103
"1431","04025","2021",11,9,2,118059.090909091,1771.27272727273,71.6363636363636
"1432","04026","2021",1,1,0,85000,895,95
"1433","04027","2021",2,2,0,381475,3038.5,125.5
"1434","04028","2021",4,2,2,115102.5,1205.5,84.5
"1435","04031","2021",8,8,0,186893.75,2508,78.5
"1436","04032","2021",3,3,0,102666.666666667,2203.33333333333,46.6666666666667
"1437","04033","2021",8,7,1,186517.5,2029.75,95
"1438","04034","2021",7,7,0,225482.857142857,2210.71428571429,109.714285714286
"1439","04035","2021",6,6,0,135170,1741.83333333333,81
"1440","04036","2021",6,6,0,216875,1965.83333333333,115.166666666667
"1441","04037","2021",3,3,0,106000,1227.33333333333,74
"1442","04039","2021",24,16,8,122672.083333333,1741.66666666667,69.4166666666667
"1443","04040","2021",1,1,0,160000,1798,89
"1444","04041","2021",3,3,0,246373.333333333,3355.66666666667,82
"1445","04042","2021",3,3,0,105000,1581.33333333333,71
"1446","04043","2021",1,1,0,329000,2384,138
"1447","04045","2021",31,31,0,209981.935483871,2584.41935483871,79.8064516129032
"1448","04046","2021",2,2,0,121000,2157,68
"1449","04047","2021",2,2,0,194360,1763.5,110
"1450","04049","2021",68,35,33,168082.632352941,2006.76470588235,87.1470588235294
"1451","04050","2021",1,1,0,130000,1300,100
"1452","04051","2021",1,1,0,270000,4091,66
"1453","04053","2021",6,6,0,201765,2197.66666666667,90.8333333333333
"1454","04054","2021",1,1,0,108000,7200,15
"1455","04055","2021",1,1,0,175000,1562,112
"1456","04058","2021",5,5,0,334644.4,4221,84.2
"1457","04059","2021",3,3,0,227733.333333333,2307.66666666667,98.6666666666667
"1458","04061","2021",13,8,5,120885.384615385,1694.07692307692,68.0769230769231
"1459","04062","2021",6,5,1,125193.333333333,2413.66666666667,57.1666666666667
"1460","04063","2021",18,18,0,281563.944444444,2590.38888888889,104.944444444444
"1461","04065","2021",13,12,1,184702.538461538,2086.53846153846,86.7692307692308
"1462","04066","2021",4,4,0,343983.5,2427,140.75
"1463","04067","2021",1,1,0,290000,2071,140
"1464","04068","2021",12,11,1,252723.333333333,2288.33333333333,103.916666666667
"1465","04069","2021",1,1,0,174000,1955,89
"1466","04070","2021",214,69,145,132781.112149533,1756.39252336449,72.8317757009346
"1467","04072","2021",3,3,0,165000,1871,68.6666666666667
"1468","04073","2021",51,5,46,104214.019607843,2193.64705882353,42.0392156862745
"1469","04074","2021",3,3,0,129783.333333333,1520.66666666667,89
"1470","04075","2021",4,4,0,297000,2741.5,108.25
"1471","04076","2021",17,9,8,138276.470588235,2051.17647058824,69.3529411764706
"1472","04077","2021",3,2,1,113333.333333333,1112.33333333333,105.333333333333
"1473","04079","2021",12,11,1,193240,1990.91666666667,93.25
"1474","04081","2021",15,13,2,277919.933333333,3705.33333333333,77.2666666666667
"1475","04084","2021",8,8,0,211562.5,1936,125.125
"1476","04086","2021",2,2,0,276000,2723,98.5
"1477","04087","2021",3,3,0,140686.666666667,1717.33333333333,74.3333333333333
"1478","04088","2021",76,40,36,197286.171052632,2506.68421052632,77.7236842105263
"1479","04090","2021",6,6,0,94533.3333333333,1449.5,63.8333333333333
"1480","04092","2021",4,4,0,97250,1336.5,70.75
"1481","04093","2021",1,1,0,141000,892,158
"1482","04094","2021",97,42,55,159320.731958763,2835.23711340206,59.4432989690722
"1483","04095","2021",5,5,0,229030,2311,91.8
"1484","04096","2021",20,9,11,142866.65,1858.95,77.3
"1485","04097","2021",7,6,1,114084.428571429,1718.42857142857,66.1428571428571
"1486","04099","2021",1,1,0,125000,1894,66
"1487","04101","2021",5,5,0,297782.4,2501.2,123.2
"1488","04102","2021",3,2,1,105000,1326,70.6666666666667
"1489","04104","2021",2,2,0,287500,3224.5,92
"1490","04106","2021",4,3,1,305575,3697,93
"1491","04108","2021",18,14,4,133484.444444444,1531,87.1111111111111
"1492","04109","2021",9,9,0,249955.555555556,2946.44444444444,91.2222222222222
"1493","04110","2021",10,10,0,219329.2,2072.8,107.7
"1494","04111","2021",18,15,3,214677.777777778,2321.38888888889,90.4444444444444
"1495","04112","2021",334,123,211,162771.179640719,2096.75748502994,76.0928143712575
"1496","04113","2021",5,5,0,192689.4,2005.2,95.6
"1497","04115","2021",2,2,0,99500,1209.5,80.5
"1498","04116","2021",47,39,8,182089.680851064,2057.72340425532,87.6595744680851
"1499","04118","2021",1,1,0,240000,1500,160
"1500","04120","2021",1,1,0,70000,636,110
"1501","04121","2021",11,7,4,131281.818181818,1732.36363636364,84.5454545454545
"1502","04122","2021",2,2,0,209500,3384,61
"1503","04123","2021",16,15,1,167974.6875,1902.625,86.3125
"1504","04124","2021",7,7,0,148397.142857143,1749.42857142857,81.7142857142857
"1505","04126","2021",34,13,21,126830.294117647,2171.47058823529,54.7941176470588
"1506","04127","2021",1,1,0,132000,1808,73
"1507","04128","2021",1,1,0,975000,4353,224
"1508","04130","2021",2,2,0,169500,1829.5,88
"1509","04132","2021",1,1,0,85000,1932,44
"1510","04133","2021",3,3,0,90533.3333333333,1455,62.3333333333333
"1511","04134","2021",11,11,0,112400,1597.36363636364,71.2727272727273
"1512","04135","2021",10,9,1,299649.2,3583.1,86.7
"1513","04136","2021",7,6,1,98700,1258.85714285714,76.8571428571429
"1514","04138","2021",2,2,0,379000,2404.5,149.5
"1515","04139","2021",9,8,1,175708.333333333,1877.33333333333,93.8888888888889
"1516","04140","2021",3,3,0,188633.333333333,1986.66666666667,94.6666666666667
"1517","04141","2021",2,2,0,275500,3094,89.5
"1518","04142","2021",2,2,0,90000,1798.5,54.5
"1519","04143","2021",66,51,15,207285.409090909,2366.01515151515,87.5606060606061
"1520","04144","2021",5,4,1,146600,3216.6,57.4
"1521","04145","2021",13,13,0,246175.538461538,2410,106.307692307692
"1522","04148","2021",10,9,1,105550,2182.7,55.5
"1523","04149","2021",35,35,0,242474.942857143,2241.31428571429,105.942857142857
"1524","04150","2021",2,2,0,304110,2875,105
"1525","04151","2021",14,14,0,209184.357142857,2402.21428571429,83.2142857142857
"1526","04152","2021",51,47,4,312683.980392157,2772.17647058824,115.21568627451
"1527","04155","2021",2,2,0,151500,2476.5,62
"1528","04156","2021",5,5,0,179476,1512.8,103.8
"1529","04157","2021",8,8,0,118137.5,1612.625,77.125
"1530","04158","2021",9,6,3,187122.666666667,2131.55555555556,85
"1531","04159","2021",1,0,1,292875,2929,100
"1532","04160","2021",30,27,3,236921,2485.43333333333,95.7
"1533","04161","2021",4,2,2,142875,1713.25,83.75
"1534","04162","2021",4,4,0,398510,3352.75,138.5
"1535","04163","2021",7,7,0,140142.857142857,1507.14285714286,92.5714285714286
"1536","04164","2021",1,1,0,289000,3141,92
"1537","04166","2021",29,22,7,148365.517241379,1944.72413793103,72.9655172413793
"1538","04167","2021",3,3,0,229813.333333333,1807.33333333333,157.666666666667
"1539","04169","2021",1,1,0,133000,3167,42
"1540","04170","2021",1,1,0,90000,1500,60
"1541","04171","2021",2,2,0,106500,1004,110
"1542","04172","2021",4,4,0,236630,2224.25,106
"1543","04173","2021",18,12,6,132780.555555556,1980.83333333333,77.8333333333333
"1544","04174","2021",2,2,0,117500,2186,66.5
"1545","04175","2021",1,1,0,138000,1725,80
"1546","04176","2021",5,0,5,110162,2489.4,45
"1547","04178","2021",31,30,1,176824.677419355,2190.51612903226,81.8387096774194
"1548","04179","2021",1,1,0,80500,1677,48
"1549","04180","2021",1,1,0,30000,1250,24
"1550","04181","2021",1,1,0,81700,1409,58
"1551","04182","2021",6,6,0,185745,2097,87.6666666666667
"1552","04184","2021",2,2,0,282500,2618,110
"1553","04186","2021",1,1,0,168000,2545,66
"1554","04188","2021",9,9,0,246668.777777778,3499.77777777778,98.3333333333333
"1555","04189","2021",15,13,2,148608.666666667,2213,62.4666666666667
"1556","04192","2021",14,12,2,253205,2443.07142857143,105.071428571429
"1557","04193","2021",2,1,1,119500,1184.5,107.5
"1558","04194","2021",3,3,0,130166.666666667,1526,81
"1559","04195","2021",9,5,4,111856.666666667,1762.33333333333,57.8888888888889
"1560","04197","2021",39,30,9,193463.846153846,2273.51282051282,83.5384615384615
"1561","04199","2021",3,3,0,135000,1708,83
"1562","04200","2021",5,5,0,265600,2601.6,105.8
"1563","04201","2021",3,3,0,202333.333333333,2174.66666666667,89
"1564","04203","2021",14,6,8,122030.571428571,1900.5,65.7857142857143
"1565","04205","2021",45,21,24,107104.577777778,1579.97777777778,68
"1566","04206","2021",8,6,2,131375,1424.25,86
"1567","04208","2021",16,16,0,341111.75,2618.6875,121.5
"1568","04209","2021",94,47,47,151138.170212766,1780.25531914894,83.0106382978723
"1569","04210","2021",8,6,2,84415,1204.25,74.625
"1570","04211","2021",1,1,0,121000,1862,65
"1571","04214","2021",4,4,0,150750,1763.5,85.75
"1572","04216","2021",3,3,0,209430,1772.33333333333,118.666666666667
"1573","04217","2021",6,5,1,118666.666666667,1171.16666666667,109.666666666667
"1574","04218","2021",3,3,0,73513.3333333333,1283.33333333333,57.6666666666667
"1575","04219","2021",5,5,0,109200,1729,64.6
"1576","04220","2021",7,5,2,141857.142857143,3260.71428571429,50.4285714285714
"1577","04222","2021",3,2,1,134813.333333333,1297,98.6666666666667
"1578","04224","2021",4,3,1,94250,1398.75,65.5
"1579","04226","2021",119,5,114,81431.3697478992,2242.93277310924,33.9747899159664
"1580","04227","2021",5,4,1,185400,1982.6,101.4
"1581","04228","2021",1,1,0,130000,1625,80
"1582","04229","2021",3,3,0,134666.666666667,1448.33333333333,84.3333333333333
"1583","04230","2021",50,43,7,174729.4,2225.76,77.36
"1584","04231","2021",2,2,0,375000,3705,96.5
"1585","04233","2021",3,3,0,211600,1955,116
"1586","04234","2021",1,1,0,239200,2010,119
"1587","04235","2021",2,2,0,120700,1924.5,60
"1588","04236","2021",1,0,1,30000,1000,30
"1589","04237","2021",7,6,1,177428.571428571,2064.85714285714,88.7142857142857
"1590","04240","2021",8,6,2,96595,1512.75,63.25
"1591","04241","2021",3,3,0,285666.666666667,2386.66666666667,116.333333333333
"1592","04242","2021",44,43,1,245539.568181818,2353.18181818182,107.272727272727
"1593","04244","2021",19,18,1,206987.105263158,1976.94736842105,97.9473684210526
"1594","04245","2021",36,32,4,244979.555555556,2757.77777777778,90.9166666666667
"1595","05001","2021",18,2,16,111334.722222222,1940.27777777778,62.8333333333333
"1596","05003","2021",21,4,17,64298.0952380952,1186.71428571429,52.1428571428571
"1597","05004","2021",70,17,53,139990.271428571,2720.21428571429,52.6
"1598","05006","2021",18,13,5,202011.111111111,2168.11111111111,96.7222222222222
"1599","05007","2021",11,5,6,161354.545454545,2566,68.6363636363636
"1600","05008","2021",7,6,1,150642.857142857,2192.71428571429,75.8571428571429
"1601","05009","2021",6,6,0,125758.333333333,1403.33333333333,95
"1602","05010","2021",13,13,0,123261.846153846,1288.23076923077,87.5384615384615
"1603","05011","2021",2,2,0,134000,1098,115.5
"1604","05012","2021",11,3,8,196833.636363636,3038.45454545455,65.9090909090909
"1605","05013","2021",3,3,0,331940,2622,129.666666666667
"1606","05014","2021",3,3,0,103000,1405,72.6666666666667
"1607","05016","2021",3,3,0,156833.333333333,1489,116.666666666667
"1608","05017","2021",18,15,3,217814.166666667,2290.77777777778,94.8333333333333
"1609","05018","2021",2,2,0,307800,3055,101
"1610","05019","2021",3,3,0,64033.3333333333,912.333333333333,85
"1611","05022","2021",4,4,0,91025,1015.25,93.75
"1612","05023","2021",227,25,202,157696.960352423,2454.13215859031,65.2290748898678
"1613","05024","2021",4,4,0,99191.25,1518,66.25
"1614","05025","2021",1,1,0,160960,1341,120
"1615","05026","2021",12,2,10,184207.5,2750.16666666667,67.75
"1616","05027","2021",2,0,2,27750,1469,19.5
"1617","05029","2021",17,12,5,172921.764705882,1810.82352941176,97.3529411764706
"1618","05032","2021",2,2,0,234800,1936,114.5
"1619","05036","2021",14,7,7,203747.857142857,2714.92857142857,74.5714285714286
"1620","05037","2021",2,2,0,322735,2548,123.5
"1621","05038","2021",5,1,4,113790,1381.4,83.2
"1622","05039","2021",9,8,1,128784.444444444,1605.88888888889,78
"1623","05040","2021",38,28,10,223977.421052632,3083.84210526316,86.2631578947368
"1624","05044","2021",7,2,5,136445,2229.85714285714,69.7142857142857
"1625","05045","2021",12,9,3,277491.666666667,2490.83333333333,112.25
"1626","05046","2021",130,25,105,158766.592307692,2715.43076923077,60.4
"1627","05047","2021",6,5,1,109750,1379,89.6666666666667
"1628","05048","2021",3,3,0,158333.333333333,1890,83.3333333333333
"1629","05049","2021",1,1,0,107477,1734,62
"1630","05050","2021",3,3,0,170450,1990.66666666667,85.3333333333333
"1631","05051","2021",1,1,0,2e+05,1562,128
"1632","05052","2021",6,4,2,200370,2234.66666666667,84.8333333333333
"1633","05053","2021",4,4,0,285875,2583,111.25
"1634","05054","2021",7,4,3,173078.571428571,2188.85714285714,69.4285714285714
"1635","05055","2021",4,4,0,94360,1255,66.25
"1636","05056","2021",3,3,0,255023.333333333,2404,113.333333333333
"1637","05057","2021",4,3,1,239341.75,2384.25,93
"1638","05058","2021",3,3,0,187733.333333333,1607.33333333333,119.666666666667
"1639","05059","2021",8,8,0,258887.5,2759.375,93.75
"1640","05061","2021",552,145,407,188927.315217391,2413.84601449275,78.2844202898551
"1641","05062","2021",1,1,0,265444,2231,119
"1642","05063","2021",6,2,4,134615.333333333,2414.66666666667,62.6666666666667
"1643","05064","2021",1,1,0,115000,958,120
"1644","05065","2021",43,10,33,158328.302325581,2270.37209302326,73.6511627906977
"1645","05068","2021",8,8,0,294881.25,2364,122.75
"1646","05070","2021",43,22,21,109751.627906977,1445.60465116279,79.6976744186046
"1647","05071","2021",2,2,0,132750,1489.5,86.5
"1648","05072","2021",9,5,4,130305.555555556,1979.88888888889,70.8888888888889
"1649","05073","2021",5,5,0,222700,2103.6,112.8
"1650","05074","2021",5,5,0,196400,1968,113
"1651","05075","2021",8,8,0,185340.625,2705.125,71.375
"1652","05077","2021",13,3,10,124313.846153846,2732.84615384615,48.3846153846154
"1653","05078","2021",1,1,0,69440,1120,62
"1654","05079","2021",47,13,34,366031.787234043,4991.44680851064,73.9574468085106
"1655","05080","2021",1,1,0,101200,1124,90
"1656","05081","2021",1,1,0,150000,750,200
"1657","05084","2021",4,4,0,239012.5,2275,110.75
"1658","05085","2021",55,5,50,227576,4225.36363636364,52.3636363636364
"1659","05086","2021",6,6,0,104302.833333333,1193,79.1666666666667
"1660","05087","2021",2,2,0,166650,1338,120
"1661","05090","2021",6,5,1,77788.1666666667,1397.83333333333,60.6666666666667
"1662","05092","2021",8,8,0,408139.75,3211.375,120.25
"1663","05093","2021",6,1,5,129959.333333333,3574.83333333333,34.1666666666667
"1664","05095","2021",5,3,2,153664,1504.8,92.8
"1665","05096","2021",120,10,110,88781.1916666667,2123.25,41.4583333333333
"1666","05097","2021",5,4,1,129200,2031.6,59.2
"1667","05098","2021",104,7,97,105052.971153846,2647.22115384615,37.5576923076923
"1668","05100","2021",9,9,0,354403.111111111,2875.66666666667,121.777777777778
"1669","05101","2021",48,15,33,155849.333333333,2514.5625,61.3125
"1670","05102","2021",1,1,0,90000,1084,83
"1671","05103","2021",10,7,3,145608,1726.6,84.5
"1672","05104","2021",4,4,0,143807.5,2351.75,65.75
"1673","05106","2021",9,4,5,224953.333333333,2868.22222222222,66.4444444444444
"1674","05107","2021",2,2,0,228025,2401,93
"1675","05108","2021",4,4,0,423425,5505.5,85.5
"1676","05109","2021",6,2,4,204416.666666667,2494.66666666667,98.1666666666667
"1677","05110","2021",88,4,84,66633.1590909091,2106.625,31.1704545454545
"1678","05111","2021",2,2,0,276700,3023,88
"1679","05113","2021",4,4,0,174875,2101.75,101.25
"1680","05114","2021",23,3,20,111363.608695652,2610.21739130435,40.9565217391304
"1681","05115","2021",7,6,1,155985.714285714,1796.85714285714,80.1428571428571
"1682","05116","2021",4,4,0,179600,1801,101.25
"1683","05117","2021",1,1,0,224220,2020,111
"1684","05118","2021",15,14,1,124833.333333333,1575.66666666667,77
"1685","05119","2021",93,6,87,112384.225806452,3414.90322580645,32.4516129032258
"1686","05121","2021",3,3,0,147433.333333333,2091.66666666667,69.3333333333333
"1687","05122","2021",6,4,2,194091.666666667,2193,85.5
"1688","05123","2021",22,21,1,228895,2144.13636363636,104.181818181818
"1689","05124","2021",2,1,1,147600,1975.5,75
"1690","05126","2021",8,7,1,125532.5,1842,65.875
"1691","05127","2021",3,1,2,297683.333333333,5562.66666666667,97.3333333333333
"1692","05128","2021",6,5,1,300125,3253.83333333333,95.1666666666667
"1693","05129","2021",4,4,0,146037.5,1527.75,86.25
"1694","05130","2021",2,2,0,493752.5,4385.5,113.5
"1695","05131","2021",1,1,0,142500,1425,100
"1696","05132","2021",39,16,23,147747.717948718,2227.84615384615,69.974358974359
"1697","05133","2021",70,11,59,200876.114285714,3325.52857142857,57.4285714285714
"1698","05134","2021",2,2,0,171000,2110.5,82
"1699","05136","2021",12,9,3,140844.166666667,2378.66666666667,61.8333333333333
"1700","05139","2021",188,22,166,97442.7606382979,2420.27127659574,37.8563829787234
"1701","05140","2021",2,2,0,195000,7541.5,52
"1702","05142","2021",14,10,4,156617.857142857,1792.14285714286,89.5714285714286
"1703","05144","2021",4,4,0,168117.5,1839,88.25
"1704","05145","2021",11,6,5,145048.181818182,2131.54545454545,66.3636363636364
"1705","05146","2021",6,5,1,93504.6666666667,919.166666666667,100.666666666667
"1706","05147","2021",1,1,0,291250,2774,105
"1707","05148","2021",7,7,0,207076.428571429,2539.71428571429,86.2857142857143
"1708","05149","2021",36,4,32,76353.4722222222,1995.69444444444,39.2777777777778
"1709","05151","2021",16,14,2,261515.9375,2843.625,101.6875
"1710","05153","2021",29,2,27,87396.5517241379,2062.41379310345,41.0689655172414
"1711","05154","2021",1,1,0,25000,385,65
"1712","05156","2021",5,3,2,318020,3615.4,75.8
"1713","05157","2021",6,3,3,142433.333333333,2541.66666666667,59.1666666666667
"1714","05158","2021",2,2,0,46445,1087.5,41.5
"1715","05159","2021",2,2,0,104000,771,138.5
"1716","05160","2021",2,2,0,132500,1754,70.5
"1717","05161","2021",84,7,77,190352.19047619,3874.77380952381,44.0833333333333
"1718","05162","2021",16,11,5,204236.4375,2363.6875,84.875
"1719","05163","2021",2,1,1,180350,3328,53.5
"1720","05164","2021",25,9,16,201022.84,3011.8,66.92
"1721","05165","2021",4,4,0,99385,1522.25,67.75
"1722","05166","2021",19,11,8,104406.315789474,1462.15789473684,72.5263157894737
"1723","05167","2021",1,1,0,85000,1349,63
"1724","05168","2021",8,6,2,222518.75,2585.125,84.875
"1725","05169","2021",2,0,2,85000,959.5,87.5
"1726","05170","2021",23,14,9,170921.304347826,1989.13043478261,83.9565217391304
"1727","05171","2021",1,1,0,68550,1142,60
"1728","05172","2021",1,1,0,143000,2979,48
"1729","05173","2021",2,2,0,327650,2570,125
"1730","05174","2021",8,3,5,236684.875,2886.25,88.5
"1731","05176","2021",6,3,3,134285,1759,77.5
"1732","05177","2021",105,9,96,142594.485714286,3474.85714285714,37.9333333333333
"1733","05178","2021",5,5,0,130360,1477.6,82
"1734","05179","2021",46,27,19,129472.065217391,1572.10869565217,80.6304347826087
"1735","05180","2021",4,4,0,417943.75,2866.75,164
"1736","05181","2021",6,2,4,102958.333333333,2268,56.3333333333333
"1737","05182","2021",1,0,1,76000,1583,48
"1738","05183","2021",13,9,4,323731.692307692,4129.61538461538,84.8461538461538
"1739","05184","2021",3,3,0,143333.333333333,1847.33333333333,79.3333333333333
"1740","06001","2021",1,1,0,70000,921,76
"1741","06002","2021",2,2,0,223750,2334.5,78
"1742","06003","2021",41,14,27,80063.9024390244,1470.41463414634,53.9024390243902
"1743","06004","2021",2321,227,2094,313992.983627747,4913.88668677294,61.9418354157691
"1744","06005","2021",5,4,1,118500,1669.8,68
"1745","06006","2021",32,25,7,526715,4806.65625,112.46875
"1746","06007","2021",56,40,16,356015.803571429,4387,85.9107142857143
"1747","06008","2021",1,1,0,115000,1917,60
"1748","06009","2021",2,2,0,27500,653,42.5
"1749","06010","2021",58,34,24,377145.689655172,3845.10344827586,93.5689655172414
"1750","06011","2021",116,1,115,467951.534482759,6822.94827586207,66.2413793103448
"1751","06012","2021",266,13,253,356887.007518797,6488.34210526316,54.0375939849624
"1752","06013","2021",21,12,9,150025.238095238,2167.66666666667,65.1904761904762
"1753","06014","2021",23,14,9,229648.043478261,3298.4347826087,76.2173913043478
"1754","06015","2021",28,19,9,304611.785714286,3170.71428571429,98.5
"1755","06016","2021",20,6,14,129408.5,2760.05,48.55
"1756","06017","2021",3,3,0,205960,2940.66666666667,71.6666666666667
"1757","06018","2021",158,106,52,567994.911392405,5274.32278481013,107.582278481013
"1758","06019","2021",18,11,7,298051.777777778,3843.66666666667,88.8888888888889
"1759","06020","2021",20,10,10,143750,2125.25,62.85
"1760","06021","2021",10,7,3,266071,3280,78.9
"1761","06022","2021",14,14,0,208482.142857143,2572.78571428571,83.0714285714286
"1762","06023","2021",36,13,23,114972.222222222,1946.33333333333,56.6666666666667
"1763","06024","2021",5,4,1,97800,1804,52.2
"1764","06025","2021",17,5,12,242769.411764706,2852.05882352941,87.5294117647059
"1765","06026","2021",35,28,7,531690.971428571,4083.08571428571,124.542857142857
"1766","06027","2021",1226,171,1055,269891.002446982,4513.97960848287,60.163132137031
"1767","06028","2021",29,25,4,202815.517241379,2863.44827586207,78.3793103448276
"1768","06029","2021",2859,146,2713,347167.584819867,5266.33123469745,62.5645330535152
"1769","06030","2021",1157,107,1050,261727.396715644,3868.08643042351,64.4606741573034
"1770","06031","2021",10,8,2,359496,3927.7,96.6
"1771","06032","2021",91,5,86,502207.791208791,7809.01098901099,59.7582417582418
"1772","06033","2021",110,42,68,272817.563636364,3126.76363636364,85.3090909090909
"1773","06034","2021",10,10,0,428410,4299.6,109
"1774","06035","2021",13,9,4,563520,4592.84615384615,129.538461538462
"1775","06036","2021",11,3,8,310687.272727273,3721.09090909091,86.5454545454545
"1776","06037","2021",8,8,0,164875,2421.5,69.125
"1777","06038","2021",53,43,10,722361.716981132,5566.79245283019,127.641509433962
"1778","06039","2021",5,4,1,308960,3860,85.2
"1779","06040","2021",2,1,1,109550,1205.5,69
"1780","06041","2021",11,6,5,139513.636363636,2064.90909090909,69.4545454545455
"1781","06042","2021",15,12,3,192500,2271.93333333333,80.6
"1782","06043","2021",17,11,6,193500.470588235,2663,73.1176470588235
"1783","06044","2021",140,83,57,576594.192857143,5326.38571428571,105.278571428571
"1784","06045","2021",4,3,1,113075,1663.25,66
"1785","06046","2021",29,24,5,461212.896551724,4803.58620689655,95.6896551724138
"1786","06047","2021",6,4,2,83666.6666666667,1413.66666666667,56.5
"1787","06048","2021",69,47,22,291781.579710145,3387.23188405797,90.0144927536232
"1788","06049","2021",3,2,1,141833.333333333,2245.66666666667,62
"1789","06050","2021",18,15,3,237081.111111111,2760.83333333333,83.0555555555556
"1790","06051","2021",1,0,1,45000,1098,41
"1791","06053","2021",3,2,1,75500,1182.66666666667,66
"1792","06054","2021",53,25,28,254960.377358491,3437.35849056604,73.811320754717
"1793","06055","2021",4,4,0,167500,3108.5,55.5
"1794","06056","2021",6,3,3,120263.333333333,1670.66666666667,60.5
"1795","06057","2021",35,14,21,221150.228571429,2748.17142857143,80.4
"1796","06058","2021",13,11,2,262867.846153846,3255.07692307692,81.3076923076923
"1797","06059","2021",44,20,24,878923.863636364,7820.90909090909,104
"1798","06060","2021",23,18,5,625429.608695652,4618.21739130435,131.260869565217
"1799","06061","2021",5,1,4,51000,1497.2,39.2
"1800","06062","2021",10,3,7,36462,773.9,50.4
"1801","06063","2021",1,1,0,158000,1837,86
"1802","06064","2021",53,42,11,419864.698113208,4444.07547169811,94.1698113207547
"1803","06065","2021",74,62,12,484133.486486487,4767.58108108108,107.162162162162
"1804","06066","2021",22,17,5,241802.227272727,3440.63636363636,70.6363636363636
"1805","06067","2021",23,8,15,305279.304347826,4429.04347826087,71.1304347826087
"1806","06068","2021",2,2,0,637500,4231.5,155
"1807","06069","2021",1049,283,766,269905.303145853,3280.36701620591,76.556720686368
"1808","06070","2021",46,8,38,85840.5434782609,1718.73913043478,47.9782608695652
"1809","06071","2021",30,5,25,115155,3107.7,39.6
"1810","06072","2021",1,1,0,83000,1976,42
"1811","06073","2021",140,10,130,160722.014285714,4080.37142857143,38.2428571428571
"1812","06074","2021",19,12,7,136739.473684211,2412.10526315789,55.3684210526316
"1813","06075","2021",65,48,17,351029.676923077,3756.26153846154,93.8307692307692
"1814","06076","2021",1,1,0,235000,2136,110
"1815","06077","2021",23,13,10,164295.652173913,2422.21739130435,60.2173913043478
"1816","06078","2021",6,4,2,119908.333333333,1785.5,68.1666666666667
"1817","06079","2021",1022,145,877,317479.687866928,4681.228962818,65.6731898238748
"1818","06080","2021",1,0,1,85000,1545,55
"1819","06081","2021",5,4,1,55060,1009.8,65
"1820","06082","2021",1,0,1,118000,2950,40
"1821","06083","2021",1021,50,971,252437.085210578,4678.14005876592,54.2380019588639
"1822","06084","2021",149,101,48,530437.597315436,4656.06711409396,109.510067114094
"1823","06085","2021",424,234,190,684201.636792453,5524.82075471698,113.080188679245
"1824","06086","2021",13,5,8,109365.384615385,2121.61538461538,55.9230769230769
"1825","06087","2021",1,0,1,45000,577,78
"1826","06088","2021",8597,388,8209,269776.572060021,4508.41944864488,59.3541933232523
"1827","06089","2021",43,42,1,986142.744186047,5727.72093023256,164.651162790698
"1828","06090","2021",108,54,54,329855.361111111,4351.4537037037,76.1944444444444
"1829","06091","2021",37,26,11,343936.972972973,3579.10810810811,88.972972972973
"1830","06092","2021",25,15,10,228961.48,3041.68,75.96
"1831","06093","2021",7,7,0,258644.285714286,3129.57142857143,82.5714285714286
"1832","06094","2021",76,10,66,181052.026315789,3642.57894736842,46.5921052631579
"1833","06095","2021",197,128,69,367406.197969543,3845.09137055838,94.010152284264
"1834","06097","2021",7,7,0,259720.142857143,2379.14285714286,108.714285714286
"1835","06098","2021",3,1,2,166716.666666667,1800.66666666667,85.6666666666667
"1836","06099","2021",28,12,16,131895.178571429,1917.32142857143,66.5
"1837","06100","2021",4,2,2,268750,3008.25,81
"1838","06101","2021",7,6,1,143914.285714286,2321.71428571429,63.1428571428571
"1839","06102","2021",4,2,2,103187.5,1625,55.25
"1840","06103","2021",35,14,21,145414.571428571,2333.74285714286,65.7714285714286
"1841","06104","2021",509,54,455,418722.049115914,6086.81925343811,63.4184675834971
"1842","06105","2021",115,109,6,814223.452173913,5689.48695652174,144.095652173913
"1843","06106","2021",11,10,1,160511.272727273,1991.63636363636,82.4545454545455
"1844","06107","2021",1,0,1,44000,1023,43
"1845","06108","2021",71,56,15,547510.971830986,4739.18309859155,110.154929577465
"1846","06109","2021",18,11,7,278268.222222222,3565.61111111111,73.5
"1847","06110","2021",8,7,1,159437.5,2490.375,64.375
"1848","06111","2021",4,4,0,86250,2132,76.5
"1849","06112","2021",53,44,9,668777.849056604,4974.62264150943,130.943396226415
"1850","06113","2021",8,2,6,340162.5,4258,76.875
"1851","06114","2021",75,12,63,236755.84,3698.01333333333,64.6533333333333
"1852","06115","2021",2,1,1,118100,1831.5,57.5
"1853","06116","2021",15,12,3,115366.666666667,1598.8,79.4666666666667
"1854","06117","2021",13,12,1,342284.230769231,4028.61538461538,98.8461538461538
"1855","06118","2021",76,65,11,399031.776315789,3581.35526315789,114.684210526316
"1856","06119","2021",5,5,0,183696,2952.6,79.8
"1857","06120","2021",134,13,121,241505.910447761,4668.50746268657,47.1791044776119
"1858","06121","2021",39,3,36,687500.769230769,10000.3333333333,68.025641025641
"1859","06122","2021",51,40,11,475127.176470588,4463.1568627451,106.823529411765
"1860","06123","2021",680,55,625,273434.729411765,4405.60735294118,63.175
"1861","06125","2021",4,3,1,82750,1372.5,59.75
"1862","06126","2021",34,14,20,269636.029411765,3547.79411764706,79.9117647058823
"1863","06127","2021",60,25,35,168963.666666667,2640.75,64.5
"1864","06128","2021",82,59,23,769224.341463415,5607.86585365854,136.670731707317
"1865","06129","2021",9,2,7,84277.7777777778,1761.22222222222,53.5555555555556
"1866","06130","2021",75,55,20,250718.666666667,3487.62666666667,76.4
"1867","06131","2021",4,4,0,95950,1663.75,62.75
"1868","06132","2021",11,3,8,84994.5454545455,1785.45454545455,55.9090909090909
"1869","06133","2021",3,1,2,53500,852.333333333333,63.6666666666667
"1870","06134","2021",26,16,10,146310.769230769,1673.03846153846,85.5
"1871","06135","2021",3,1,2,78333.3333333333,1068.66666666667,63.3333333333333
"1872","06136","2021",70,27,43,210821.128571429,3037.12857142857,71.1857142857143
"1873","06137","2021",33,31,2,515868.454545455,4144.54545454545,121.181818181818
"1874","06138","2021",134,30,104,446453.895522388,6116.59701492537,66.5298507462687
"1875","06139","2021",2,0,2,39000,1163.5,33
"1876","06140","2021",77,71,6,460587.844155844,3985.22077922078,119.363636363636
"1877","06141","2021",3,2,1,103350,1804,52.3333333333333
"1878","06142","2021",8,3,5,172225,2619.875,69.75
"1879","06143","2021",8,6,2,193187.5,2305,82.25
"1880","06144","2021",6,3,3,114166.666666667,1628.16666666667,65
"1881","06145","2021",4,3,1,168500,2336.75,67.5
"1882","06146","2021",1,1,0,220000,6111,36
"1883","06147","2021",46,37,9,358515.652173913,4442.41304347826,81.1739130434783
"1884","06148","2021",99,88,11,671838.141414141,5027.44444444444,133.343434343434
"1885","06149","2021",122,49,73,247698.221311475,3346.84426229508,74.6311475409836
"1886","06150","2021",56,36,20,546962.035714286,6203.58928571429,86.0357142857143
"1887","06151","2021",17,13,4,173880.117647059,2435.47058823529,66.2352941176471
"1888","06152","2021",189,100,89,497337.64021164,5136.09523809524,91.9206349206349
"1889","06153","2021",35,12,23,127267.428571429,2109.77142857143,61.2
"1890","06154","2021",17,13,4,203116.294117647,1962.17647058824,102.117647058824
"1891","06155","2021",816,171,645,346292.757352941,4546.6568627451,68.0759803921569
"1892","06156","2021",5,3,2,136900,2094.6,65.2
"1893","06157","2021",420,147,273,373118.747619048,4270.67142857143,84.102380952381
"1894","06158","2021",12,4,8,95635,1655.16666666667,52.8333333333333
"1895","06159","2021",190,30,160,607118.710526316,7342.01052631579,76.7315789473684
"1896","06160","2021",2,2,0,157500,1392.5,112
"1897","06161","2021",560,120,440,350982.555357143,5470.00178571429,62.2410714285714
"1898","06162","2021",18,9,9,67046.6666666667,1153.5,65.2222222222222
"1899","06163","2021",34,10,24,89930.7352941177,1449.47058823529,63.7058823529412
"1900","07002","2021",2,2,0,205000,1995.5,97.5
"1901","07003","2021",1,1,0,2e+05,3448,58
"1902","07004","2021",2,2,0,248304,2364.5,105
"1903","07005","2021",4,4,0,155483.25,1500.75,110
"1904","07006","2021",5,4,1,77822,1072.8,87.2
"1905","07007","2021",4,4,0,153090,1848,90
"1906","07008","2021",4,4,0,190160,2304.25,81.75
"1907","07009","2021",5,2,3,70791,1052.4,65.2
"1908","07010","2021",100,38,62,112774.9,1347.91,79.63
"1909","07011","2021",3,3,0,99000,1678,68
"1910","07012","2021",4,4,0,109250,1879.25,66
"1911","07013","2021",3,3,0,197536.666666667,1997.66666666667,98.6666666666667
"1912","07014","2021",3,3,0,200396.666666667,2362.66666666667,99.6666666666667
"1913","07015","2021",1,1,0,144500,2408,60
"1914","07017","2021",4,4,0,181000,2722,78.75
"1915","07018","2021",4,4,0,102960.5,1643.25,59.75
"1916","07019","2021",97,44,53,132330.690721649,1736.20618556701,78.680412371134
"1917","07020","2021",1,1,0,168700,1454,116
"1918","07022","2021",5,5,0,134220,1433.8,82.2
"1919","07023","2021",3,3,0,261666.666666667,2609.66666666667,103.333333333333
"1920","07024","2021",6,6,0,288538.333333333,2503.16666666667,134.5
"1921","07025","2021",6,5,1,92041.6666666667,1343.83333333333,74.3333333333333
"1922","07026","2021",4,3,1,169750,2260.75,84.5
"1923","07027","2021",7,6,1,160462.142857143,2103.71428571429,82.5714285714286
"1924","07028","2021",2,2,0,417000,2171,195.5
"1925","07029","2021",4,4,0,256252.5,1847.5,119.25
"1926","07030","2021",4,4,0,154194,2331,68.75
"1927","07031","2021",7,7,0,246457.142857143,2090.85714285714,114.714285714286
"1928","07032","2021",1,1,0,41970,600,70
"1929","07033","2021",5,5,0,285875.6,3016.2,98.8
"1930","07034","2021",1,1,0,468000,2925,160
"1931","07035","2021",1,1,0,298000,4257,70
"1932","07036","2021",2,2,0,163675,1423.5,112.5
"1933","07037","2021",1,1,0,110000,2750,40
"1934","07039","2021",1,1,0,150000,2308,65
"1935","07040","2021",2,2,0,77000,1389,57
"1936","07041","2021",3,3,0,210833.333333333,2164.33333333333,98.3333333333333
"1937","07042","2021",46,26,20,127012.760869565,1551.19565217391,77.6304347826087
"1938","07045","2021",6,6,0,152394.5,1775,83.1666666666667
"1939","07047","2021",2,2,0,240000,1971.5,101
"1940","07048","2021",2,2,0,76000,1036,73.5
"1941","07049","2021",2,2,0,144142,2030.5,71
"1942","07050","2021",13,13,0,206823.076923077,2311.23076923077,97.9230769230769
"1943","07051","2021",2,2,0,130500,988,123
"1944","07053","2021",7,7,0,176045,1897,104.857142857143
"1945","07054","2021",3,3,0,85333.3333333333,1310,67.3333333333333
"1946","07055","2021",12,11,1,292725,2678.83333333333,109.833333333333
"1947","07056","2021",3,3,0,233500,3177.33333333333,84.3333333333333
"1948","07058","2021",6,5,1,177491.666666667,2026.5,86.5
"1949","07060","2021",2,2,0,291015,3169.5,94
"1950","07061","2021",6,6,0,183504.166666667,2207.16666666667,81.3333333333333
"1951","07063","2021",5,5,0,107560,1056.4,111.8
"1952","07064","2021",10,7,3,107100,1269.9,82.8
"1953","07065","2021",2,2,0,257500,2710.5,97.5
"1954","07066","2021",20,18,2,182147.5,2019.1,97.05
"1955","07067","2021",2,2,0,316500,2693.5,115.5
"1956","07068","2021",4,4,0,138250,1942.25,75
"1957","07070","2021",12,12,0,235012.166666667,2333.58333333333,99.0833333333333
"1958","07071","2021",8,7,1,115200,1366,83.375
"1959","07072","2021",6,6,0,157755,2813.33333333333,61.8333333333333
"1960","07073","2021",3,3,0,94500,1705.66666666667,57.6666666666667
"1961","07074","2021",2,2,0,122000,2094.5,68
"1962","07075","2021",5,3,2,186390,3375.4,78.2
"1963","07076","2021",9,8,1,181135.555555556,1962.22222222222,88.3333333333333
"1964","07077","2021",3,3,0,99333.3333333333,1331.66666666667,97.3333333333333
"1965","07078","2021",18,17,1,215269.444444444,2129.16666666667,101.888888888889
"1966","07079","2021",6,6,0,175048,1893.33333333333,92.3333333333333
"1967","07080","2021",2,2,0,150850,4553,41
"1968","07081","2021",2,2,0,271950,2290.5,133.5
"1969","07082","2021",1,1,0,41250,825,50
"1970","07083","2021",6,6,0,158916.666666667,1772.83333333333,91.3333333333333
"1971","07084","2021",6,6,0,200645,2522.33333333333,82.6666666666667
"1972","07085","2021",4,4,0,119500,2048.25,60
"1973","07086","2021",4,4,0,159875,1468.75,107.5
"1974","07087","2021",1,1,0,155000,1938,80
"1975","07088","2021",1,1,0,76000,2171,35
"1976","07089","2021",9,9,0,201666.666666667,1795.22222222222,121.222222222222
"1977","07090","2021",6,5,1,151912.666666667,1678.5,88.6666666666667
"1978","07091","2021",1,1,0,76800,1259,61
"1979","07093","2021",1,1,0,304940,3465,88
"1980","07095","2021",1,1,0,175000,1750,100
"1981","07096","2021",2,2,0,369000,2738,143.5
"1982","07097","2021",7,7,0,196362.857142857,2207.28571428571,92.4285714285714
"1983","07098","2021",1,1,0,120000,2000,60
"1984","07099","2021",6,6,0,213541.166666667,2178.83333333333,98
"1985","07100","2021",6,6,0,251416.666666667,2168,117.833333333333
"1986","07101","2021",13,12,1,331810,2880.84615384615,114.923076923077
"1987","07102","2021",77,22,55,182980.506493506,2239.84415584416,80.4545454545455
"1988","07103","2021",4,4,0,100250,1138.25,90.25
"1989","07105","2021",1,1,0,51000,1020,50
"1990","07106","2021",4,3,1,77862.5,907.25,80.75
"1991","07107","2021",10,9,1,162520,1748,91.5
"1992","07109","2021",1,1,0,121462,900,135
"1993","07110","2021",11,10,1,207810,2124.54545454545,98.0909090909091
"1994","07112","2021",3,3,0,114135.666666667,1516.33333333333,74
"1995","07113","2021",3,3,0,118879.333333333,1379.66666666667,86.3333333333333
"1996","07114","2021",1,1,0,170000,4250,40
"1997","07115","2021",9,9,0,270414.444444444,3332.88888888889,97.7777777777778
"1998","07116","2021",19,12,7,116113.157894737,1302.15789473684,90.9473684210526
"1999","07117","2021",14,13,1,185217.857142857,2042.92857142857,94.0714285714286
"2000","07118","2021",2,2,0,177420,2504.5,100.5
"2001","07119","2021",1,1,0,107000,2140,50
"2002","07120","2021",1,1,0,87000,1208,72
"2003","07121","2021",3,3,0,173166.666666667,1428,117
"2004","07122","2021",3,2,1,164456.666666667,1214,127
"2005","07124","2021",1,1,0,110550,1474,75
"2006","07126","2021",4,2,2,263692.5,2352.75,112.75
"2007","07127","2021",6,6,0,159915,2024.16666666667,80.5
"2008","07128","2021",5,1,4,60169,710.8,88.6
"2009","07129","2021",12,11,1,143591.666666667,1309.16666666667,112.75
"2010","07130","2021",4,4,0,98190,1263.75,76.5
"2011","07131","2021",1,1,0,110000,1222,90
"2012","07132","2021",4,4,0,206500,4071.25,90.5
"2013","07133","2021",5,5,0,309888.8,2995,107.2
"2014","07134","2021",4,4,0,166250,2197.25,84.75
"2015","07136","2021",1,1,0,88000,1023,86
"2016","07138","2021",10,9,1,191210,1973.4,101.3
"2017","07139","2021",2,2,0,149650,1581.5,95
"2018","07140","2021",6,6,0,207016.666666667,1948.33333333333,106.666666666667
"2019","07141","2021",1,1,0,260000,2653,98
"2020","07142","2021",2,2,0,126125,1364,85
"2021","07143","2021",4,4,0,151820,1717.75,100
"2022","07144","2021",1,1,0,71000,1543,46
"2023","07145","2021",7,7,0,183450,1849.85714285714,97.5714285714286
"2024","07146","2021",6,5,1,147208.333333333,1656.33333333333,89.6666666666667
"2025","07147","2021",5,5,0,237072,3083.4,76.6
"2026","07148","2021",2,2,0,126000,1587.5,109
"2027","07150","2021",2,2,0,93000,622,132.5
"2028","07152","2021",3,3,0,97016.6666666667,1246,100.666666666667
"2029","07153","2021",4,4,0,90000,1483.25,60
"2030","07154","2021",3,3,0,138086.666666667,1842.66666666667,81
"2031","07155","2021",6,6,0,193699.166666667,2057.33333333333,94.3333333333333
"2032","07156","2021",2,2,0,96500,1538,58.5
"2033","07157","2021",8,6,2,119562.5,1634.875,78.625
"2034","07158","2021",1,1,0,155000,2583,60
"2035","07159","2021",4,4,0,268687.5,2823,94.75
"2036","07160","2021",1,1,0,152000,1007,151
"2037","07161","2021",9,9,0,121196.666666667,1687.77777777778,69.5555555555556
"2038","07162","2021",2,2,0,314350,3213.5,105.5
"2039","07165","2021",7,7,0,152194.285714286,1810,90
"2040","07166","2021",6,6,0,171653.333333333,1712.33333333333,96.8333333333333
"2041","07167","2021",7,5,2,99807.1428571429,1387.71428571429,67
"2042","07168","2021",5,5,0,281610.6,2805.4,99.2
"2043","07169","2021",2,2,0,216100,1671.5,130
"2044","07170","2021",5,5,0,133632,1514.6,90.8
"2045","07171","2021",3,3,0,268920,2718.66666666667,106
"2046","07172","2021",12,12,0,246920.833333333,2163.41666666667,112.75
"2047","07174","2021",4,4,0,163375,1462.25,109.5
"2048","07176","2021",2,2,0,362375,3994.5,92.5
"2049","07177","2021",1,1,0,234350,2020,116
"2050","07178","2021",6,5,1,124441.333333333,1889,64.6666666666667
"2051","07179","2021",2,2,0,150500,1175.5,134
"2052","07181","2021",12,10,2,167381.583333333,2305.75,81.6666666666667
"2053","07182","2021",5,5,0,111960,1624.4,68.4
"2054","07183","2021",7,7,0,278172.142857143,2547.57142857143,134.571428571429
"2055","07184","2021",4,4,0,125500,1874.5,64.75
"2056","07185","2021",2,2,0,225250,1635.5,135
"2057","07186","2021",60,16,44,123012.75,1496.15,79.7
"2058","07187","2021",1,1,0,235000,1691,139
"2059","07188","2021",7,7,0,51237.8571428571,619.285714285714,86.4285714285714
"2060","07189","2021",5,5,0,173783,2194,91
"2061","07191","2021",7,6,1,117842.285714286,1314,84.2857142857143
"2062","07192","2021",2,2,0,42500,643,62.5
"2063","07193","2021",5,4,1,189720,1559.4,117.4
"2064","07194","2021",2,1,1,289675,1768,134.5
"2065","07196","2021",3,3,0,222666.666666667,2084,115
"2066","07197","2021",14,14,0,172342.5,1739.21428571429,102.142857142857
"2067","07198","2021",7,6,1,329224.285714286,2664.57142857143,118.571428571429
"2068","07199","2021",8,8,0,194628.75,2545.25,105
"2069","07200","2021",1,1,0,81000,559,145
"2070","07201","2021",22,18,4,217985,2469.77272727273,87.3636363636364
"2071","07202","2021",3,3,0,218100,1811,130
"2072","07203","2021",2,2,0,162900,1862.5,87.5
"2073","07204","2021",9,7,2,155166.666666667,1525.77777777778,99.4444444444444
"2074","07205","2021",10,10,0,179260,1758.1,100
"2075","07206","2021",1,1,0,105000,875,120
"2076","07207","2021",5,5,0,201200,2210.6,91
"2077","07210","2021",2,2,0,164500,6302.5,63
"2078","07211","2021",2,2,0,256975,5068.5,52.5
"2079","07213","2021",2,2,0,286580,2873,85
"2080","07214","2021",1,1,0,186850,1668,112
"2081","07215","2021",2,2,0,124000,1866.5,72.5
"2082","07216","2021",2,2,0,150680,910,164.5
"2083","07217","2021",7,7,0,159642.857142857,2050,78
"2084","07218","2021",4,4,0,130500,1754.5,74.5
"2085","07220","2021",2,2,0,90000,1440,56.5
"2086","07221","2021",2,2,0,135000,1938.5,86.5
"2087","07222","2021",1,0,1,48000,889,54
"2088","07223","2021",1,1,0,190000,1462,130
"2089","07224","2021",4,3,1,47880,1026.5,47.25
"2090","07225","2021",6,6,0,245808.333333333,2203.16666666667,108.833333333333
"2091","07227","2021",6,6,0,125511.333333333,1459.66666666667,87.3333333333333
"2092","07228","2021",2,2,0,155750,1640.5,89
"2093","07229","2021",5,5,0,215600,2113.4,101.6
"2094","07230","2021",3,3,0,168971.666666667,2040,73.6666666666667
"2095","07231","2021",13,13,0,235292.307692308,2276.76923076923,110.230769230769
"2096","07232","2021",3,3,0,67933.3333333333,550.333333333333,120.333333333333
"2097","07233","2021",3,3,0,160000,1897.33333333333,88.3333333333333
"2098","07235","2021",1,1,0,227000,1428,159
"2099","07236","2021",4,4,0,172500,1980.75,99.25
"2100","07237","2021",3,3,0,86666.6666666667,2103,55
"2101","07238","2021",6,6,0,287833.333333333,2277.66666666667,129.333333333333
"2102","07239","2021",4,4,0,143250,1678.25,83.25
"2103","07240","2021",10,10,0,331732,2760.7,118.2
"2104","07242","2021",2,2,0,313475,2377,145
"2105","07243","2021",2,2,0,101500,1784.5,57.5
"2106","07244","2021",3,2,1,80890,1221.33333333333,65
"2107","07245","2021",15,12,3,194250.466666667,1773.53333333333,108.133333333333
"2108","07247","2021",3,3,0,196666.666666667,1725,110
"2109","07248","2021",2,2,0,101075,1050,91
"2110","07249","2021",2,2,0,178075,2597.5,65
"2111","07250","2021",3,3,0,102666.666666667,1214.66666666667,74.3333333333333
"2112","07251","2021",1,0,1,95500,1910,50
"2113","07253","2021",3,3,0,56000,671.333333333333,80.6666666666667
"2114","07254","2021",4,4,0,265325,2072.25,126
"2115","07255","2021",5,5,0,113866,1369.8,87.4
"2116","07258","2021",1,1,0,136000,1528,89
"2117","07259","2021",10,10,0,200857,2227.6,91.6
"2118","07260","2021",2,2,0,223280,1599,135
"2119","07261","2021",11,10,1,144700,2075.90909090909,77.6363636363636
"2120","07264","2021",9,9,0,238214.444444444,1987,114.777777777778
"2121","07265","2021",6,5,1,229025,2018.5,105
"2122","07266","2021",4,4,0,103932.5,2446.75,51.75
"2123","07267","2021",5,5,0,106201.4,1115.6,91
"2124","07268","2021",11,8,3,209999.818181818,3115.90909090909,66.8181818181818
"2125","07269","2021",4,4,0,110675,1054.5,99.75
"2126","07270","2021",1,1,0,2e+05,769,260
"2127","07272","2021",3,3,0,312630,2828.33333333333,110.333333333333
"2128","07274","2021",2,2,0,122250,1322.5,89.5
"2129","07276","2021",1,1,0,220000,2075,106
"2130","07278","2021",5,5,0,165284,2217,81.6
"2131","07279","2021",15,15,0,218617.733333333,2079.6,104.533333333333
"2132","07280","2021",8,8,0,294887.5,2537.125,112.375
"2133","07281","2021",28,25,3,304517.857142857,2863.5,105
"2134","07284","2021",3,3,0,224666.666666667,2622.66666666667,99.3333333333333
"2135","07285","2021",1,1,0,26500,465,57
"2136","07286","2021",8,8,0,139635,1679.75,87.25
"2137","07287","2021",2,2,0,169000,1463,107.5
"2138","07288","2021",6,6,0,241485,3647.33333333333,76.1666666666667
"2139","07289","2021",6,6,0,203800.833333333,2427.66666666667,97.1666666666667
"2140","07290","2021",5,5,0,85763,1399.6,65
"2141","07291","2021",13,13,0,193560.769230769,2038.92307692308,94.1538461538462
"2142","07292","2021",4,4,0,215500,1812.75,117.75
"2143","07293","2021",6,6,0,257820,2628.5,99
"2144","07294","2021",7,7,0,224000,2136.71428571429,101.857142857143
"2145","07295","2021",5,5,0,156710,1648.2,90.4
"2146","07296","2021",12,12,0,182546.666666667,1630.66666666667,112.916666666667
"2147","07297","2021",1,1,0,262815,1851,142
"2148","07298","2021",5,5,0,164580,1620,107.2
"2149","07299","2021",4,4,0,95182.5,1590.75,100.5
"2150","07300","2021",2,2,0,81500,1121,62
"2151","07301","2021",5,5,0,88600,1350.4,63.2
"2152","07302","2021",1,1,0,240000,2264,106
"2153","07303","2021",2,2,0,144450,2602,62.5
"2154","07304","2021",11,6,5,158890.909090909,2293.18181818182,68.8181818181818
"2155","07305","2021",4,4,0,233750,2670.25,95.75
"2156","07306","2021",5,4,1,217174,2191,101.8
"2157","07307","2021",3,3,0,220666.666666667,2587.33333333333,84.6666666666667
"2158","07308","2021",15,14,1,167978.066666667,1781.86666666667,98.1333333333333
"2159","07309","2021",7,7,0,143714.285714286,1191.71428571429,110.714285714286
"2160","07310","2021",3,3,0,86371.3333333333,1158.66666666667,77.3333333333333
"2161","07312","2021",9,9,0,189400,2114.44444444444,90.2222222222222
"2162","07313","2021",10,9,1,131993.3,1522.2,89.6
"2163","07314","2021",8,8,0,173473.125,1709.25,103.125
"2164","07315","2021",6,6,0,177973.333333333,2120.16666666667,84.5
"2165","07316","2021",9,8,1,215600,2192,97.1111111111111
"2166","07317","2021",1,1,0,50000,588,85
"2167","07318","2021",5,5,0,266485,1658,149.4
"2168","07319","2021",27,14,13,125594.111111111,1822.7037037037,76.3703703703704
"2169","07321","2021",1,1,0,351950,3520,100
"2170","07322","2021",10,10,0,202829.3,2151.4,87.8
"2171","07323","2021",5,5,0,236360,2812.2,85
"2172","07324","2021",79,30,49,155450.873417722,1892.59493670886,82.3670886075949
"2173","07325","2021",13,11,2,234033.076923077,1983.61538461538,121
"2174","07327","2021",3,3,0,415300,3262.66666666667,123
"2175","07328","2021",3,3,0,222973.333333333,1745.33333333333,126.333333333333
"2176","07329","2021",8,8,0,117556.25,1648.75,75.75
"2177","07330","2021",23,20,3,165398.695652174,2145.82608695652,88.1739130434783
"2178","07331","2021",42,15,27,120976.761904762,1565.92857142857,76.8571428571429
"2179","07332","2021",3,3,0,136333.333333333,1167.33333333333,118
"2180","07333","2021",2,2,0,102000,1404,72.5
"2181","07334","2021",22,14,8,221282.272727273,2554.22727272727,87.3181818181818
"2182","07335","2021",5,5,0,175082.8,2257.2,85.8
"2183","07337","2021",8,8,0,191416.25,1859.5,97.875
"2184","07338","2021",6,6,0,78600,1866.16666666667,45.5
"2185","07339","2021",4,4,0,220287.5,2401.75,89.75
"2186","07340","2021",5,5,0,150322,2474.8,76.2
"2187","07341","2021",17,14,3,175864.764705882,1879.76470588235,95.2941176470588
"2188","07342","2021",7,7,0,151371.428571429,1768.57142857143,79.1428571428571
"2189","07343","2021",7,6,1,241170,1867,127.285714285714
"2190","07344","2021",1,1,0,208000,2364,88
"2191","07345","2021",6,6,0,186350,1840.16666666667,119.5
"2192","07346","2021",16,15,1,223482.5,2061.375,105.625
"2193","07347","2021",3,2,1,137733.333333333,1881.33333333333,92.3333333333333
"2194","07348","2021",2,1,1,72500,1309,55
"2195","07349","2021",29,21,8,153732.551724138,1782.20689655172,87.9310344827586
"2196","08001","2021",9,9,0,118944.444444444,1311,91.4444444444444
"2197","08003","2021",27,27,0,172999.259259259,1661.88888888889,109.703703703704
"2198","08004","2021",3,3,0,150500,1261.66666666667,136.333333333333
"2199","08006","2021",3,3,0,98296.6666666667,976.666666666667,115.666666666667
"2200","08008","2021",14,14,0,131367.857142857,1383.07142857143,97.5
"2201","08010","2021",1,1,0,44000,367,120
"2202","08011","2021",1,1,0,60000,857,70
"2203","08013","2021",4,4,0,102000,1060.25,97.5
"2204","08015","2021",2,2,0,130000,1177.5,108
"2205","08016","2021",5,5,0,141676.2,1804.2,79.6
"2206","08017","2021",2,2,0,38150,486,81.5
"2207","08019","2021",1,1,0,60000,706,85
"2208","08020","2021",1,1,0,1e+05,1316,76
"2209","08021","2021",1,1,0,180000,1385,130
"2210","08023","2021",2,2,0,64900,798,84.5
"2211","08024","2021",12,12,0,129654.166666667,1668.91666666667,82.8333333333333
"2212","08025","2021",17,17,0,73445.1176470588,938.941176470588,78.8823529411765
"2213","08026","2021",5,5,0,90400,886.6,102
"2214","08028","2021",14,14,0,135528.571428571,1558.85714285714,90.2857142857143
"2215","08029","2021",1,1,0,60000,741,81
"2216","08030","2021",1,1,0,63500,397,160
"2217","08032","2021",2,2,0,143575,986.5,146.5
"2218","08033","2021",1,1,0,74900,535,140
"2219","08034","2021",6,6,0,147634.5,1494.5,103.666666666667
"2220","08035","2021",1,1,0,30160,628,48
"2221","08036","2021",2,2,0,52000,683.5,68.5
"2222","08037","2021",8,8,0,102362.5,837.75,115.625
"2223","08038","2021",4,4,0,125075,2098,62.75
"2224","08039","2021",3,3,0,96033.3333333333,1388.33333333333,59.3333333333333
"2225","08040","2021",11,11,0,167882.363636364,1891.09090909091,90.6363636363636
"2226","08043","2021",15,12,3,145793.333333333,1464.66666666667,104.133333333333
"2227","08044","2021",1,1,0,95000,1234,77
"2228","08047","2021",2,2,0,192000,1783,109.5
"2229","08048","2021",6,6,0,133673.333333333,1520,88.8333333333333
"2230","08049","2021",2,2,0,70000,681.5,103.5
"2231","08053","2021",33,32,1,142882.666666667,1325.69696969697,111.727272727273
"2232","08055","2021",1,1,0,76000,938,81
"2233","08056","2021",1,1,0,68230,669,102
"2234","08057","2021",4,4,0,93035,961.75,96.5
"2235","08058","2021",5,5,0,237100,1397.8,166.2
"2236","08059","2021",2,2,0,144600,849,170.5
"2237","08060","2021",1,1,0,197500,1619,122
"2238","08061","2021",1,1,0,75000,882,85
"2239","08062","2021",2,2,0,160000,1284,124.5
"2240","08063","2021",4,4,0,109930,1135.75,98
"2241","08064","2021",1,1,0,228000,1689,135
"2242","08067","2021",14,14,0,99067.8571428571,1028.28571428571,94.5714285714286
"2243","08069","2021",2,2,0,115000,1420.5,81
"2244","08070","2021",6,6,0,112366.666666667,1283,87.3333333333333
"2245","08071","2021",1,1,0,69500,500,139
"2246","08073","2021",3,3,0,61600,669.666666666667,90
"2247","08074","2021",1,1,0,75000,670,112
"2248","08075","2021",3,3,0,45933.3333333333,606.333333333333,68.3333333333333
"2249","08076","2021",10,10,0,105866,1132.2,92.2
"2250","08077","2021",1,1,0,110000,880,125
"2251","08078","2021",9,8,1,119368.555555556,1198.11111111111,104.888888888889
"2252","08080","2021",1,1,0,98000,760,129
"2253","08081","2021",62,60,2,81321.7741935484,944.241935483871,84.7741935483871
"2254","08082","2021",2,2,0,93750,954,98.5
"2255","08083","2021",3,3,0,197666.666666667,1293,143.666666666667
"2256","08084","2021",7,7,0,166507.142857143,1691.42857142857,95.4285714285714
"2257","08085","2021",1,1,0,1e+05,585,171
"2258","08086","2021",3,3,0,69000,874.666666666667,78.3333333333333
"2259","08087","2021",5,4,1,172694,2125.2,81.4
"2260","08088","2021",3,3,0,218333.333333333,1656.66666666667,127.333333333333
"2261","08089","2021",7,7,0,92171.4285714286,901.142857142857,101.142857142857
"2262","08090","2021",28,26,2,124635.357142857,1265.14285714286,104.428571428571
"2263","08092","2021",2,2,0,167700.5,1378,138.5
"2264","08095","2021",1,1,0,123000,1557,79
"2265","08096","2021",3,3,0,206833.333333333,1899.66666666667,108
"2266","08097","2021",7,7,0,73235.7142857143,796.714285714286,93
"2267","08098","2021",1,1,0,118000,659,179
"2268","08101","2021",3,3,0,110833.333333333,1235.66666666667,87.6666666666667
"2269","08103","2021",4,4,0,91625,944.5,103.25
"2270","08105","2021",615,288,327,114296.811382114,1405.99674796748,82.1983739837398
"2271","08107","2021",12,11,1,129154.166666667,1195.91666666667,112.75
"2272","08110","2021",4,4,0,70875,808.25,84.75
"2273","08111","2021",5,5,0,165780,1700.6,99.2
"2274","08115","2021",7,7,0,120285.714285714,1378.14285714286,90.1428571428571
"2275","08119","2021",6,6,0,181383.333333333,1681.66666666667,111
"2276","08122","2021",13,12,1,123338.461538462,1258.76923076923,96.1538461538462
"2277","08124","2021",2,2,0,120181,790,151.5
"2278","08125","2021",5,5,0,197140,1540.8,126.8
"2279","08126","2021",4,4,0,90166.75,1205.5,72.25
"2280","08130","2021",1,1,0,28000,700,40
"2281","08132","2021",2,2,0,160800,1482.5,108.5
"2282","08133","2021",6,6,0,105016.666666667,1349.16666666667,73.6666666666667
"2283","08134","2021",1,1,0,165000,775,213
"2284","08135","2021",2,2,0,45650,864,70
"2285","08136","2021",3,3,0,109000,1344.33333333333,84.6666666666667
"2286","08137","2021",2,2,0,143750,1378,98
"2287","08138","2021",3,3,0,103000,1025.66666666667,100.666666666667
"2288","08139","2021",11,11,0,76227.2727272727,833.090909090909,91.1818181818182
"2289","08140","2021",14,14,0,137977.142857143,1482.14285714286,98.7142857142857
"2290","08141","2021",2,2,0,109750,1473.5,68.5
"2291","08142","2021",23,19,4,139391.652173913,1452.34782608696,98.5652173913043
"2292","08145","2021",15,15,0,121497.066666667,1189.8,103.6
"2293","08147","2021",2,2,0,146500,1151.5,127
"2294","08148","2021",3,3,0,161133,1337.33333333333,115.333333333333
"2295","08149","2021",2,2,0,65500,578.5,112.5
"2296","08150","2021",1,1,0,211000,1835,115
"2297","08151","2021",3,3,0,185883.333333333,1008.33333333333,175
"2298","08153","2021",3,3,0,199300,1261.33333333333,136
"2299","08156","2021",8,8,0,124687.5,1012.75,116.75
"2300","08158","2021",4,4,0,168350,1798.75,94.5
"2301","08159","2021",1,1,0,229000,916,250
"2302","08160","2021",3,3,0,183073.333333333,1499.33333333333,121.333333333333
"2303","08161","2021",1,1,0,88370,680,130
"2304","08162","2021",6,6,0,150133.333333333,1650.66666666667,98.3333333333333
"2305","08164","2021",4,4,0,133710.5,1460.5,98.5
"2306","08166","2021",4,4,0,116250,1007,118.5
"2307","08168","2021",2,2,0,142250,1100.5,128.5
"2308","08169","2021",1,1,0,239000,2747,87
"2309","08171","2021",1,1,0,132000,825,160
"2310","08172","2021",3,3,0,82000,1157.33333333333,71.3333333333333
"2311","08173","2021",15,14,1,130581.333333333,1179.46666666667,114.133333333333
"2312","08174","2021",33,32,1,120969.696969697,1187.54545454545,104.787878787879
"2313","08175","2021",5,5,0,96060,1165.6,85.4
"2314","08179","2021",9,9,0,100943.888888889,1142.22222222222,95.1111111111111
"2315","08180","2021",21,20,1,162651.666666667,1747.2380952381,92.0952380952381
"2316","08182","2021",2,2,0,140492.5,1680,85.5
"2317","08183","2021",15,15,0,132122.666666667,1415.86666666667,92.8
"2318","08184","2021",2,2,0,143000,1406.5,103.5
"2319","08185","2021",33,30,3,80760.5454545455,895.757575757576,90.969696969697
"2320","08186","2021",1,1,0,177000,1264,140
"2321","08187","2021",7,7,0,178114.285714286,1424.28571428571,133.714285714286
"2322","08188","2021",11,11,0,66881.8181818182,687.727272727273,95.3636363636364
"2323","08190","2021",57,50,7,133206.315789474,1407.45614035088,93.719298245614
"2324","08191","2021",18,18,0,135016.666666667,1292.5,105.277777777778
"2325","08192","2021",1,1,0,1e+05,1515,66
"2326","08193","2021",4,4,0,136260,1110,121.75
"2327","08194","2021",4,4,0,193625,1862,101.75
"2328","08195","2021",4,4,0,164472.5,1428.25,120
"2329","08199","2021",9,8,1,132274.444444444,1083.33333333333,125.666666666667
"2330","08200","2021",3,3,0,80533.3333333333,710.666666666667,112.333333333333
"2331","08202","2021",4,4,0,86437.5,980.75,103
"2332","08203","2021",4,4,0,153500,1313.75,163.75
"2333","08204","2021",2,2,0,199747.5,1166.5,170
"2334","08206","2021",1,1,0,94000,783,120
"2335","08207","2021",4,4,0,97875,1380.25,70.5
"2336","08208","2021",1,1,0,60000,333,180
"2337","08209","2021",4,4,0,132000,1182.25,114.75
"2338","08210","2021",1,1,0,95000,495,192
"2339","08211","2021",11,11,0,88531.8181818182,1705.36363636364,97.9090909090909
"2340","08212","2021",9,9,0,136755.555555556,1558.22222222222,102.888888888889
"2341","08214","2021",8,8,0,102072.5,1021.875,110.625
"2342","08216","2021",1,1,0,320000,2119,151
"2343","08217","2021",3,3,0,126333.333333333,1045.66666666667,112.333333333333
"2344","08218","2021",22,22,0,87800.4545454545,925.545454545455,94.2272727272727
"2345","08220","2021",3,3,0,208833.333333333,1509.66666666667,142
"2346","08222","2021",27,27,0,103965.185185185,1091.55555555556,97.6296296296296
"2347","08223","2021",2,2,0,135000,1510,89
"2348","08225","2021",2,2,0,131050,1231.5,108.5
"2349","08226","2021",2,2,0,130000,1340.5,93.5
"2350","08228","2021",1,1,0,168000,1400,120
"2351","08229","2021",1,1,0,179900,1977,91
"2352","08230","2021",13,13,0,198227.615384615,1541.23076923077,133
"2353","08232","2021",5,5,0,111580,1285.4,84
"2354","08234","2021",2,2,0,203000,1682,122
"2355","08235","2021",3,3,0,159300,1367.33333333333,122
"2356","08237","2021",8,8,0,126218.75,1178.625,111
"2357","08238","2021",2,2,0,89000,880,104.5
"2358","08239","2021",10,9,1,174316.4,1646.1,107.6
"2359","08242","2021",4,4,0,59250,851.5,69
"2360","08244","2021",1,1,0,90000,900,100
"2361","08246","2021",1,1,0,40000,500,80
"2362","08247","2021",2,2,0,180000,1642.5,102
"2363","08248","2021",3,3,0,140333.333333333,1148.66666666667,123
"2364","08249","2021",4,4,0,222125,1346.25,163.5
"2365","08250","2021",1,1,0,181000,1708,106
"2366","08251","2021",1,1,0,2e+05,1282,156
"2367","08252","2021",2,2,0,83250,870,86.5
"2368","08254","2021",5,4,1,95300,1124.8,88
"2369","08255","2021",2,2,0,131000,1213.5,108
"2370","08256","2021",2,2,0,32500,415,75
"2371","08257","2021",1,1,0,45000,643,70
"2372","08260","2021",8,8,0,136000,1244.875,110
"2373","08262","2021",4,4,0,108092.5,1249,83.25
"2374","08263","2021",7,7,0,126000,1341.28571428571,99.2857142857143
"2375","08264","2021",6,6,0,158052.666666667,1115.83333333333,150.666666666667
"2376","08269","2021",2,2,0,96250,1339.5,75.5
"2377","08272","2021",1,1,0,30000,405,74
"2378","08273","2021",1,1,0,80000,1667,48
"2379","08274","2021",4,4,0,77200,971.75,78.5
"2380","08275","2021",2,2,0,154500,1975,82.5
"2381","08276","2021",6,6,0,123533.333333333,1181.5,107
"2382","08277","2021",2,2,0,155000,1127.5,139.5
"2383","08279","2021",2,2,0,154000,688,266
"2384","08281","2021",6,6,0,105666.666666667,906.666666666667,99.1666666666667
"2385","08282","2021",13,13,0,113765.384615385,1044.92307692308,106
"2386","08283","2021",3,3,0,122166.666666667,1197,110
"2387","08284","2021",12,11,1,152646.75,1636.91666666667,102.666666666667
"2388","08287","2021",1,1,0,53000,768,69
"2389","08289","2021",10,10,0,103150,1002.6,100.7
"2390","08291","2021",2,2,0,141800,1275,120
"2391","08293","2021",1,1,0,148000,679,218
"2392","08294","2021",2,2,0,104000,591,167
"2393","08296","2021",3,3,0,76566.6666666667,632,121.666666666667
"2394","08297","2021",3,3,0,125766.666666667,1819,65.3333333333333
"2395","08298","2021",28,24,4,152162.857142857,1509.21428571429,103.392857142857
"2396","08301","2021",1,1,0,126000,1135,111
"2397","08302","2021",26,26,0,94846.1538461538,922.538461538462,102.807692307692
"2398","08303","2021",5,5,0,90300,859.4,109.2
"2399","08304","2021",1,1,0,25000,417,60
"2400","08305","2021",3,3,0,142333.333333333,1571.33333333333,93
"2401","08307","2021",1,1,0,125000,887,141
"2402","08311","2021",27,25,2,95292.9259259259,1128.77777777778,89.3333333333333
"2403","08312","2021",2,2,0,151500,1262.5,120
"2404","08313","2021",1,1,0,96500,1122,86
"2405","08314","2021",13,13,0,164738.461538462,1708.53846153846,97.7692307692308
"2406","08316","2021",14,14,0,85678.5714285714,948.857142857143,86.2857142857143
"2407","08317","2021",1,1,0,55000,437,126
"2408","08318","2021",4,4,0,137800,1409.25,101.5
"2409","08319","2021",7,7,0,130285.714285714,820.714285714286,154.142857142857
"2410","08320","2021",8,8,0,130256.25,1313,105.125
"2411","08322","2021",1,1,0,145000,1343,108
"2412","08325","2021",1,1,0,52000,1333,39
"2413","08327","2021",19,18,1,143342.105263158,1458.89473684211,103.578947368421
"2414","08328","2021",80,66,14,93369.775,1111.8625,84.4875
"2415","08330","2021",10,10,0,125750,1251.1,102.9
"2416","08331","2021",4,4,0,138000,1181,118
"2417","08333","2021",1,1,0,43000,614,70
"2418","08336","2021",3,3,0,164866.666666667,819.666666666667,201
"2419","08338","2021",1,1,0,130000,1008,129
"2420","08339","2021",4,4,0,189227.5,1725,113.25
"2421","08340","2021",3,3,0,108000.333333333,1050.33333333333,110.666666666667
"2422","08341","2021",9,9,0,130758.888888889,1257,109.222222222222
"2423","08342","2021",4,4,0,171225,1418.25,121.25
"2424","08343","2021",17,16,1,98248.2352941177,1028.35294117647,90.4117647058823
"2425","08344","2021",3,3,0,92000,929,101.333333333333
"2426","08346","2021",18,18,0,216890,1975.5,106.222222222222
"2427","08347","2021",3,3,0,121666.666666667,913.666666666667,148.666666666667
"2428","08349","2021",9,9,0,91222.2222222222,1124.33333333333,80.2222222222222
"2429","08350","2021",4,4,0,103125,634.25,166.5
"2430","08351","2021",1,1,0,107000,892,120
"2431","08352","2021",1,1,0,120000,1714,70
"2432","08353","2021",9,9,0,133888.777777778,1345.77777777778,96.4444444444444
"2433","08354","2021",16,16,0,75687.5,927,80
"2434","08355","2021",6,6,0,126666.666666667,1473.5,96.3333333333333
"2435","08356","2021",5,5,0,146600,1170.4,133.8
"2436","08357","2021",10,10,0,118025,1092.2,108.4
"2437","08358","2021",2,2,0,192500,1607,132
"2438","08361","2021",20,19,1,150437.5,1515.35,103.8
"2439","08362","2021",92,63,29,128798.336956522,1462.69565217391,92.0652173913043
"2440","08363","2021",74,72,2,75770.1351351351,871.162162162162,86.972972972973
"2441","08364","2021",1,1,0,30000,612,49
"2442","08365","2021",16,16,0,115202.5,950.375,115
"2443","08366","2021",11,11,0,109861.818181818,919.090909090909,111.181818181818
"2444","08367","2021",28,28,0,94072.8571428571,1025.14285714286,92.6071428571429
"2445","08368","2021",5,5,0,160100,1569.2,105.8
"2446","08370","2021",9,9,0,157833.333333333,1325.44444444444,128.666666666667
"2447","08373","2021",4,4,0,72725,634.5,123.5
"2448","08374","2021",1,1,0,55000,1000,55
"2449","08375","2021",2,2,0,142000,1334.5,105
"2450","08376","2021",1,1,0,105000,1193,88
"2451","08377","2021",2,2,0,166750,1149.5,132
"2452","08378","2021",1,1,0,40000,800,50
"2453","08379","2021",5,5,0,112443.8,1123.8,98
"2454","08380","2021",5,5,0,114478,1245.6,89
"2455","08381","2021",8,8,0,117687.5,1340.875,91.125
"2456","08383","2021",1,1,0,52000,510,102
"2457","08384","2021",1,1,0,53160,439,121
"2458","08385","2021",17,16,1,164183.529411765,1483.58823529412,124.058823529412
"2459","08386","2021",5,5,0,129820,1308.4,103.2
"2460","08388","2021",7,7,0,157371.428571429,1615.85714285714,96.5714285714286
"2461","08389","2021",2,2,0,142500,1062.5,114
"2462","08390","2021",4,4,0,143650,1131.5,135
"2463","08391","2021",12,12,0,84991.6666666667,1012.66666666667,86.9166666666667
"2464","08392","2021",2,2,0,123800,1055,122.5
"2465","08395","2021",1,1,0,177500,1707,104
"2466","08396","2021",3,3,0,119000,849.333333333333,139.666666666667
"2467","08399","2021",1,1,0,199000,2031,98
"2468","08400","2021",6,6,0,106733.333333333,1184.66666666667,94.6666666666667
"2469","08402","2021",11,11,0,132356.181818182,1292.90909090909,105.090909090909
"2470","08403","2021",17,17,0,154970.588235294,1579.88235294118,99.8235294117647
"2471","08404","2021",1,1,0,233000,1792,130
"2472","08405","2021",2,2,0,59500,767.5,77
"2473","08406","2021",6,6,0,91000,1201.33333333333,89.6666666666667
"2474","08407","2021",1,1,0,66500,978,68
"2475","08408","2021",2,2,0,141500,1481,95.5
"2476","08409","2021",200,81,119,88895.345,1050.78,80.92
"2477","08410","2021",2,2,0,60000,1007.5,64.5
"2478","08413","2021",5,5,0,83800,670.8,120.4
"2479","08415","2021",3,3,0,155666.666666667,1236.66666666667,125
"2480","08416","2021",4,4,0,179475,1511,122.75
"2481","08417","2021",2,2,0,141000,1231,110
"2482","08418","2021",4,4,0,159897.5,1226,138.75
"2483","08419","2021",24,24,0,102079.166666667,931.291666666667,112.083333333333
"2484","08420","2021",17,17,0,107526.470588235,1053.17647058824,108.352941176471
"2485","08422","2021",1,1,0,120000,1500,80
"2486","08424","2021",2,2,0,70500,666,102.5
"2487","08425","2021",1,1,0,32150,607,53
"2488","08426","2021",1,1,0,120000,1429,84
"2489","08427","2021",1,1,0,60000,2000,30
"2490","08428","2021",1,1,0,45500,474,96
"2491","08429","2021",6,5,1,121666.666666667,1175,107.5
"2492","08431","2021",1,1,0,96000,914,105
"2493","08432","2021",1,1,0,149000,1242,120
"2494","08434","2021",1,1,0,211000,1407,150
"2495","08435","2021",10,10,0,165066,2082.4,87.3
"2496","08436","2021",3,3,0,199666.666666667,1430.66666666667,140.333333333333
"2497","08437","2021",1,1,0,70000,654,107
"2498","08438","2021",2,2,0,145850,1178.5,119.5
"2499","08439","2021",3,3,0,108633.333333333,889,113
"2500","08440","2021",2,2,0,109000,1061,105
"2501","08444","2021",1,1,0,1e+05,1250,80
"2502","08445","2021",5,5,0,169589.8,1397.4,118.6
"2503","08446","2021",1,1,0,120000,800,150
"2504","08448","2021",22,22,0,96770.4545454545,1117.86363636364,100.454545454545
"2505","08449","2021",6,6,0,88875,980.833333333333,85.8333333333333
"2506","08450","2021",1,1,0,315000,1567,201
"2507","08451","2021",6,5,1,140583.333333333,1694.33333333333,91.8333333333333
"2508","08452","2021",2,2,0,103000,988,110
"2509","08453","2021",5,5,0,115640,950.4,123.4
"2510","08454","2021",1,1,0,85000,817,104
"2511","08456","2021",2,2,0,98000,1042.5,95
"2512","08457","2021",16,16,0,167093.75,1610.375,105.625
"2513","08458","2021",4,4,0,119525,970.75,106.75
"2514","08459","2021",2,2,0,109000,864,122.5
"2515","08460","2021",1,1,0,180000,1607,112
"2516","08461","2021",1,1,0,150000,1685,89
"2517","08463","2021",1,1,0,55000,420,131
"2518","08464","2021",1,1,0,25000,490,51
"2519","08465","2021",1,1,0,156500,1304,120
"2520","08466","2021",1,1,0,164520,1201,137
"2521","08468","2021",2,2,0,78500,989,80
"2522","08469","2021",13,13,0,117680.769230769,1095.92307692308,122.076923076923
"2523","08470","2021",3,3,0,63118.3333333333,1124.66666666667,79.6666666666667
"2524","08473","2021",4,4,0,160335,1443,121.25
"2525","08476","2021",11,11,0,138802.727272727,1590.27272727273,92.3636363636364
"2526","08477","2021",1,1,0,160000,920,174
"2527","08478","2021",2,2,0,181750,1130.5,160.5
"2528","08480","2021",34,32,2,161324.852941176,1622,104.088235294118
"2529","08481","2021",1,1,0,40000,400,100
"2530","08483","2021",4,4,0,123200,1004.5,121.25
"2531","08485","2021",1,1,0,120000,698,172
"2532","08486","2021",22,22,0,87896.9545454545,887.590909090909,103.954545454545
"2533","08487","2021",23,23,0,146108.086956522,1405.26086956522,101.782608695652
"2534","08488","2021",17,14,3,126029.411764706,1243.29411764706,105.705882352941
"2535","08490","2021",38,35,3,100907.815789474,1018.23684210526,100.473684210526
"2536","08491","2021",36,35,1,123732.083333333,1315.44444444444,95.4444444444444
"2537","08492","2021",2,2,0,142000,1501,98
"2538","08494","2021",7,7,0,152471.428571429,1508.14285714286,101.428571428571
"2539","08497","2021",23,22,1,169931.739130435,1528.60869565217,110.391304347826
"2540","08498","2021",4,4,0,184250,1592,123.75
"2541","08501","2021",1,1,0,40000,471,85
"2542","08502","2021",2,1,1,197500,2705.5,83
"2543","08503","2021",3,3,0,124000,1545,80.6666666666667
"2544","09001","2021",1,1,0,30000,857,35
"2545","09002","2021",5,5,0,172640,1783.2,97.2
"2546","09003","2021",5,5,0,78278,750,107
"2547","09004","2021",3,3,0,106633.333333333,1290,90
"2548","09005","2021",5,5,0,65176.6,776.2,84.8
"2549","09007","2021",3,3,0,104833.333333333,987.333333333333,117
"2550","09008","2021",4,4,0,67136.25,1046.5,70.25
"2551","09009","2021",4,4,0,92600,1144.5,81.75
"2552","09011","2021",1,1,0,63000,1575,40
"2553","09012","2021",2,2,0,87770,1187.5,91
"2554","09013","2021",2,2,0,290000,1709,160.5
"2555","09014","2021",6,6,0,75283.3333333333,1548.16666666667,55.3333333333333
"2556","09015","2021",12,12,0,146902.5,1376.5,101.083333333333
"2557","09016","2021",3,3,0,55300,1114.33333333333,53
"2558","09017","2021",4,4,0,154901.25,1584.5,109.75
"2559","09019","2021",23,23,0,132600.217391304,1274.4347826087,109.695652173913
"2560","09020","2021",2,2,0,90250,728,104.5
"2561","09021","2021",1,1,0,245000,2112,116
"2562","09022","2021",2,2,0,122750,1401,90
"2563","09023","2021",4,4,0,104375,2139.75,59.5
"2564","09024","2021",1,1,0,163000,2063,79
"2565","09025","2021",2,2,0,120000,1143,102
"2566","09026","2021",2,2,0,95500,1295.5,74
"2567","09027","2021",9,9,0,60233.3333333333,876.222222222222,70.1111111111111
"2568","09029","2021",21,5,16,60610.2857142857,1153.61904761905,50.8095238095238
"2569","09030","2021",21,20,1,124035.714285714,1791.33333333333,75.1904761904762
"2570","09031","2021",2,2,0,63750,1475,40
"2571","09032","2021",106,21,85,127306.924528302,2193.50943396226,63.3018867924528
"2572","09033","2021",3,3,0,98166.6666666667,1066.66666666667,113.666666666667
"2573","09034","2021",3,3,0,117103.333333333,1320.33333333333,94
"2574","09035","2021",3,3,0,41333.3333333333,995.666666666667,42.3333333333333
"2575","09037","2021",2,2,0,107500,966.5,103.5
"2576","09038","2021",9,9,0,154341.222222222,1780.77777777778,91.4444444444444
"2577","09039","2021",5,5,0,70500,851,96
"2578","09040","2021",5,5,0,109775,966.8,102.2
"2579","09041","2021",4,4,0,117100,1114.75,103
"2580","09042","2021",20,18,2,82300,963.8,95.4
"2581","09043","2021",11,11,0,113312.727272727,1110.72727272727,101.181818181818
"2582","09044","2021",1,1,0,170000,1700,100
"2583","09045","2021",2,2,0,194425,2495.5,78.5
"2584","09046","2021",2,2,0,173099,1351,132
"2585","09047","2021",26,24,2,127023.346153846,1261.46153846154,108.961538461538
"2586","09048","2021",1,1,0,135000,9000,15
"2587","09049","2021",4,4,0,182177.5,1492.75,111.5
"2588","09050","2021",6,6,0,219783.333333333,1993.83333333333,114.666666666667
"2589","09052","2021",1,1,0,32000,356,90
"2590","09053","2021",2,2,0,126865,1397.5,91
"2591","09054","2021",3,3,0,66333.3333333333,740.666666666667,91.6666666666667
"2592","09055","2021",7,7,0,75654.2857142857,1587,45
"2593","09056","2021",2,2,0,145000,1929.5,77.5
"2594","09057","2021",21,21,0,101066.047619048,1571.2380952381,67.1904761904762
"2595","09058","2021",6,6,0,152083.333333333,2017.83333333333,88.5
"2596","09059","2021",7,6,1,72676.5714285714,983,85.2857142857143
"2597","09060","2021",13,13,0,139288.076923077,1284,104.153846153846
"2598","09061","2021",8,8,0,117500,1514.875,76.25
"2599","09062","2021",7,7,0,163954.285714286,2152.71428571429,87.4285714285714
"2600","09063","2021",10,10,0,97595,1058.1,97
"2601","09065","2021",15,15,0,120666.666666667,1853,68.9333333333333
"2602","09066","2021",13,13,0,147746.307692308,1421.23076923077,98.7692307692308
"2603","09067","2021",3,3,0,168883.333333333,1609,105.333333333333
"2604","09068","2021",3,3,0,144333.333333333,1317,130
"2605","09069","2021",2,2,0,95000,1878,48
"2606","09070","2021",9,9,0,119445.555555556,1551.11111111111,84.3333333333333
"2607","09071","2021",5,5,0,182770,1537.8,114
"2608","09073","2021",2,2,0,3e+05,4088.5,79
"2609","09074","2021",7,7,0,114428.571428571,1234.85714285714,94.5714285714286
"2610","09075","2021",12,12,0,141418.333333333,1481.08333333333,87.75
"2611","09076","2021",5,5,0,145254,1369.8,96.8
"2612","09077","2021",5,4,1,97110,1510.8,64.8
"2613","09078","2021",3,3,0,51666.6666666667,878,70.6666666666667
"2614","09079","2021",15,15,0,221182.866666667,1714.53333333333,134.6
"2615","09080","2021",2,2,0,89500,780,115
"2616","09081","2021",3,3,0,211333.333333333,1903,114.333333333333
"2617","09082","2021",10,10,0,95230.5,1306.4,72.2
"2618","09084","2021",1,1,0,1e+05,1333,75
"2619","09085","2021",9,9,0,114144.444444444,1194.44444444444,102.555555555556
"2620","09086","2021",5,5,0,87000,1195.2,94.4
"2621","09087","2021",1,1,0,139000,1986,70
"2622","09088","2021",1,1,0,17500,417,42
"2623","09090","2021",2,2,0,365000,5166.5,100
"2624","09091","2021",4,4,0,79611.75,967,86.25
"2625","09092","2021",3,3,0,114933.333333333,1387.66666666667,84
"2626","09093","2021",3,3,0,75300,2191.66666666667,37.6666666666667
"2627","09094","2021",3,3,0,177266.666666667,1734.33333333333,102
"2628","09095","2021",4,4,0,86150,1259.25,71.25
"2629","09096","2021",4,2,2,90825,1282,95.5
"2630","09097","2021",3,3,0,120617.666666667,869.333333333333,141
"2631","09099","2021",3,3,0,238966.666666667,1991,120
"2632","09100","2021",10,7,3,66553.5,1020.6,74.4
"2633","09101","2021",4,4,0,168043.25,1661.75,102.5
"2634","09102","2021",1,1,0,289000,970,298
"2635","09103","2021",15,15,0,166434.133333333,1639.33333333333,102.266666666667
"2636","09104","2021",8,8,0,101221.625,1194.125,86.75
"2637","09105","2021",49,49,0,83708.7142857143,1135.12244897959,68.7551020408163
"2638","09106","2021",4,4,0,176675,1664.75,115.75
"2639","09107","2021",5,5,0,156026,1317.8,118
"2640","09108","2021",3,3,0,102500,1243.33333333333,80
"2641","09109","2021",3,3,0,222086.666666667,924.333333333333,220.333333333333
"2642","09110","2021",2,2,0,52450,671.5,76
"2643","09111","2021",6,6,0,93813.8333333333,994,94
"2644","09113","2021",10,10,0,118475.5,1720.9,69.6
"2645","09114","2021",7,7,0,101445.714285714,1226.42857142857,76.7142857142857
"2646","09115","2021",2,2,0,194500,1446.5,141
"2647","09116","2021",3,3,0,153876.666666667,1112,145.333333333333
"2648","09118","2021",2,2,0,193900,2635.5,67.5
"2649","09119","2021",3,3,0,126333.333333333,1230.66666666667,96.3333333333333
"2650","09120","2021",6,6,0,116346.666666667,1539.66666666667,87.3333333333333
"2651","09121","2021",16,15,1,171104.375,1763.8125,110.6875
"2652","09122","2021",162,98,64,130723.160493827,1528.06790123457,87.0246913580247
"2653","09123","2021",1,1,0,190000,2262,84
"2654","09124","2021",18,17,1,119319.388888889,1412.77777777778,83.9444444444444
"2655","09125","2021",15,15,0,111882.666666667,1029,119.333333333333
"2656","09126","2021",4,4,0,106875,1438.25,73
"2657","09128","2021",6,6,0,170916.666666667,1366.83333333333,132
"2658","09129","2021",6,6,0,250460.833333333,3045.16666666667,102.666666666667
"2659","09130","2021",17,17,0,119697.058823529,1311.88235294118,86.9411764705882
"2660","09131","2021",4,4,0,135000,1062.75,126.5
"2661","09132","2021",7,7,0,147714.285714286,1024.42857142857,123.857142857143
"2662","09134","2021",2,2,0,69500,1325,53.5
"2663","09136","2021",3,3,0,92933.3333333333,1332.66666666667,72.6666666666667
"2664","09139","2021",4,2,2,65000,1016,69
"2665","09140","2021",5,5,0,109760,1686.6,69.4
"2666","09141","2021",2,2,0,117375,2269.5,55
"2667","09142","2021",1,1,0,196000,1922,102
"2668","09145","2021",2,2,0,266650,2290,116
"2669","09147","2021",5,5,0,209000,1851.2,104.6
"2670","09148","2021",4,4,0,84961.25,861.75,106.75
"2671","09149","2021",8,8,0,75994.5,1114.75,72.5
"2672","09150","2021",11,8,3,167931.818181818,1290.72727272727,123.818181818182
"2673","09151","2021",3,3,0,181333.333333333,1524.66666666667,125.666666666667
"2674","09152","2021",4,4,0,54950,795,79
"2675","09153","2021",2,2,0,79553.5,692.5,111.5
"2676","09154","2021",1,1,0,106065,1105,96
"2677","09155","2021",1,1,0,92550,1851,50
"2678","09156","2021",1,1,0,140000,1556,90
"2679","09157","2021",30,29,1,113576.666666667,1131.46666666667,100.6
"2680","09158","2021",7,7,0,194285.714285714,2294,91
"2681","09159","2021",1,1,0,28500,432,66
"2682","09160","2021",101,88,13,90498.6831683168,969,96.1881188118812
"2683","09161","2021",14,14,0,102979.857142857,1208,83.2857142857143
"2684","09163","2021",1,1,0,559000,3494,160
"2685","09164","2021",6,6,0,131418.333333333,1431.33333333333,88.6666666666667
"2686","09165","2021",10,10,0,106040,938.9,119.7
"2687","09167","2021",45,43,2,160189.533333333,1618.17777777778,102.022222222222
"2688","09168","2021",2,2,0,109500,989.5,115
"2689","09169","2021",2,2,0,90000,712.5,126
"2690","09171","2021",1,1,0,111000,1708,65
"2691","09173","2021",1,1,0,170000,1868,91
"2692","09174","2021",4,4,0,211000,1557.25,151
"2693","09175","2021",1,1,0,330000,2215,149
"2694","09177","2021",2,2,0,137500,1884.5,87
"2695","09178","2021",2,2,0,134600,1105,95
"2696","09179","2021",1,1,0,4e+05,2000,200
"2697","09180","2021",1,1,0,95000,594,160
"2698","09181","2021",22,22,0,134997.5,1293,97.1363636363636
"2699","09182","2021",31,31,0,97671.4516129032,1258.06451612903,80.5483870967742
"2700","09185","2021",104,95,9,136516.163461538,1495.83653846154,93.875
"2701","09186","2021",3,3,0,238400,2652.33333333333,91.3333333333333
"2702","09187","2021",4,4,0,96625,816.25,121.25
"2703","09188","2021",18,17,1,125961.111111111,1475.22222222222,90.1666666666667
"2704","09189","2021",5,5,0,78410,1409.8,60.8
"2705","09190","2021",3,3,0,90850,1214.66666666667,90
"2706","09192","2021",2,2,0,72180,1044.5,69.5
"2707","09193","2021",3,3,0,81333.3333333333,1139.66666666667,71.6666666666667
"2708","09194","2021",73,60,13,157485.465753425,1555.09589041096,102.219178082192
"2709","09196","2021",1,1,0,25000,676,37
"2710","09197","2021",2,2,0,37500,674.5,60
"2711","09198","2021",5,5,0,114270,1204.8,88.6
"2712","09199","2021",14,14,0,172335.714285714,1558.14285714286,113.071428571429
"2713","09200","2021",2,2,0,72800,843,98
"2714","09202","2021",4,4,0,158050,1526.5,110.25
"2715","09203","2021",2,2,0,127500,1834,80.5
"2716","09204","2021",1,1,0,42000,525,80
"2717","09205","2021",1,1,0,2e+05,2857,70
"2718","09206","2021",31,18,13,82395.8387096774,1740.67741935484,55.2258064516129
"2719","09207","2021",19,19,0,133770.157894737,1359.57894736842,96.4210526315789
"2720","09208","2021",4,4,0,140637.5,1454.5,101.75
"2721","09209","2021",20,20,0,179435,1738.75,102.7
"2722","09210","2021",11,11,0,171586.363636364,1478.54545454545,109
"2723","09211","2021",2,2,0,112000,1713,66
"2724","09213","2021",5,5,0,139200,1426.4,101.8
"2725","09214","2021",16,16,0,103846.875,1380.1875,78.9375
"2726","09215","2021",4,4,0,77000,1045.5,77.75
"2727","09216","2021",3,3,0,102833.333333333,908.333333333333,115
"2728","09217","2021",4,4,0,120575,1233.75,91.5
"2729","09219","2021",12,12,0,102097.083333333,1362.33333333333,77.9166666666667
"2730","09220","2021",4,4,0,109417.5,1428.25,71
"2731","09221","2021",7,6,1,117000,1161.85714285714,106
"2732","09222","2021",2,2,0,108425,1118.5,92
"2733","09223","2021",9,9,0,118019,1339.66666666667,93.6666666666667
"2734","09224","2021",8,8,0,139387.5,1784.25,87.875
"2735","09225","2021",305,195,110,114453.439344262,1429.0262295082,81.6950819672131
"2736","09227","2021",1,1,0,66216,517,128
"2737","09228","2021",7,7,0,158857.142857143,1360.14285714286,112
"2738","09229","2021",12,12,0,115797.916666667,1061.75,107.916666666667
"2739","09230","2021",4,4,0,83000,1240,73.25
"2740","09231","2021",13,13,0,65445.3846153846,1217.30769230769,60.3076923076923
"2741","09232","2021",4,4,0,56900,654.75,83
"2742","09233","2021",1,1,0,270000,1500,180
"2743","09234","2021",2,2,0,214650,2016,106.5
"2744","09235","2021",14,14,0,152336.642857143,1400.14285714286,108.071428571429
"2745","09236","2021",3,3,0,133000,1480.33333333333,90
"2746","09237","2021",1,1,0,150000,1442,104
"2747","09238","2021",8,8,0,160899.125,1386.75,116.25
"2748","09239","2021",9,9,0,106627.777777778,1210,85.8888888888889
"2749","09240","2021",7,7,0,139618.571428571,1273,102.714285714286
"2750","09241","2021",6,6,0,107333.333333333,1427.33333333333,75.1666666666667
"2751","09243","2021",3,3,0,164000,1529.66666666667,107.333333333333
"2752","09244","2021",13,13,0,153289,1568.61538461538,102.538461538462
"2753","09245","2021",13,13,0,163396.846153846,1702.23076923077,99.8461538461538
"2754","09246","2021",10,10,0,117150,1106,95.5
"2755","09247","2021",10,10,0,78632,1413,64.4
"2756","09249","2021",3,3,0,139000,904.333333333333,130
"2757","09251","2021",4,4,0,167742.5,1565,113.5
"2758","09252","2021",3,3,0,75866.6666666667,767,90.3333333333333
"2759","09253","2021",8,8,0,53425,605.375,97.625
"2760","09254","2021",5,5,0,149000,1097,139.2
"2761","09257","2021",12,11,1,129289.75,1518.33333333333,87.6666666666667
"2762","09258","2021",2,2,0,254500,2431,105.5
"2763","09259","2021",2,2,0,220000,1749.5,113
"2764","09261","2021",109,76,33,105592.266055046,1237.79816513761,85.954128440367
"2765","09262","2021",3,3,0,186000,1387,129.333333333333
"2766","09263","2021",5,5,0,92403,1406.2,67.6
"2767","09264","2021",19,18,1,165470.368421053,1726.68421052632,99.4210526315789
"2768","09265","2021",33,25,8,145797.727272727,1703.09090909091,86.8181818181818
"2769","09267","2021",17,17,0,79163.8235294118,1239.05882352941,68.5294117647059
"2770","09268","2021",29,26,3,146837.24137931,1553.89655172414,98.5172413793103
"2771","09269","2021",1,1,0,110000,2750,40
"2772","09270","2021",4,4,0,187057,971.5,154
"2773","09271","2021",3,3,0,252933.333333333,2435.66666666667,108.333333333333
"2774","09272","2021",27,26,1,99113.0740740741,1165.55555555556,88.5925925925926
"2775","09273","2021",11,11,0,124018.181818182,1357.09090909091,91.5454545454545
"2776","09274","2021",5,5,0,125211.2,1231.2,98.2
"2777","09275","2021",5,5,0,186459,1822.6,107.8
"2778","09276","2021",1,1,0,350000,4375,80
"2779","09277","2021",9,9,0,134782.777777778,1382.66666666667,92.8888888888889
"2780","09279","2021",1,1,0,15000,469,32
"2781","09280","2021",29,29,0,104432.517241379,1257.31034482759,91.1379310344828
"2782","09281","2021",2,2,0,137175,1311.5,105.5
"2783","09282","2021",74,59,15,147541.040540541,1564.27027027027,95.3918918918919
"2784","09283","2021",7,5,2,126714.285714286,2005.85714285714,61.8571428571429
"2785","09284","2021",2,2,0,43000,490,93
"2786","09285","2021",24,23,1,103296.083333333,1253,87.0416666666667
"2787","09287","2021",1,1,0,125000,1736,72
"2788","09289","2021",13,13,0,149802.307692308,1597,90.0769230769231
"2789","09290","2021",8,8,0,59125,940.5,72.5
"2790","09291","2021",6,6,0,105565,1419.83333333333,76.8333333333333
"2791","09292","2021",2,2,0,68000,2079,37
"2792","09293","2021",18,17,1,122590.277777778,1215.5,95.9444444444444
"2793","09294","2021",1,1,0,140000,1867,75
"2794","09295","2021",5,5,0,95619.6,1151.4,90.8
"2795","09296","2021",6,6,0,137666.666666667,1209.83333333333,117.5
"2796","09297","2021",1,1,0,122200,940,130
"2797","09298","2021",3,3,0,156633.333333333,1956.33333333333,97.6666666666667
"2798","09299","2021",17,17,0,101625.647058824,1622,68
"2799","09300","2021",3,3,0,117666.666666667,1755.66666666667,86.6666666666667
"2800","09301","2021",9,9,0,118790,1816,67.6666666666667
"2801","09303","2021",5,5,0,179800,1292.6,128
"2802","09305","2021",11,11,0,122581.818181818,1295.81818181818,93.3636363636364
"2803","09306","2021",31,25,6,129173.935483871,1389.77419354839,94.9677419354839
"2804","09307","2021",2,2,0,61907.5,809.5,67.5
"2805","09308","2021",1,1,0,103500,908,114
"2806","09309","2021",4,4,0,100715,1094,94.5
"2807","09311","2021",2,2,0,41450,534.5,74.5
"2808","09312","2021",47,47,0,176182.978723404,1852.06382978723,95.8085106382979
"2809","09313","2021",5,5,0,129380.4,1051.6,129
"2810","09314","2021",4,3,1,115250,1090.75,97
"2811","09315","2021",2,2,0,139000,1682,81.5
"2812","09316","2021",2,2,0,184175,1199,153
"2813","09318","2021",6,6,0,109083.333333333,1613.5,72.8333333333333
"2814","09319","2021",1,1,0,362000,4114,88
"2815","09320","2021",1,1,0,46000,622,74
"2816","09321","2021",6,3,3,86000,1235,65.8333333333333
"2817","09322","2021",80,47,33,78609.225,1752.8875,49.8375
"2818","09324","2021",54,54,0,162571.907407407,1742.96296296296,95.6111111111111
"2819","09326","2021",2,2,0,236380,2402,100
"2820","09327","2021",4,4,0,95750,1708,59
"2821","09328","2021",7,7,0,169738.285714286,1648.85714285714,108.857142857143
"2822","09329","2021",10,10,0,170042.2,1847,105
"2823","09330","2021",1,1,0,178629,1985,90
"2824","09331","2021",6,6,0,183483.333333333,1666.66666666667,111.666666666667
"2825","09332","2021",32,31,1,173446.4375,1655.1875,111.21875
"2826","09334","2021",26,26,0,75294.7692307692,1105.84615384615,68.0769230769231
"2827","09335","2021",6,6,0,60116.8333333333,986.666666666667,63.6666666666667
"2828","09336","2021",17,17,0,104191.764705882,1072.35294117647,100.411764705882
"2829","09338","2021",5,5,0,182300,1768,109.8
"2830","09339","2021",4,4,0,153543.75,1343.25,110
"2831","09340","2021",5,5,0,98600,1005.8,106.6
"2832","09341","2021",2,2,0,113000,935.5,128
"2833","10002","2021",4,4,0,116625,1086,108
"2834","10003","2021",76,74,2,117888.157894737,1258.07894736842,94.8421052631579
"2835","10004","2021",4,4,0,64225,839.25,73.25
"2836","10006","2021",40,37,3,117653.1,1256.7,94.85
"2837","10008","2021",4,4,0,147410,1540.75,101.25
"2838","10011","2021",1,1,0,95000,569,167
"2839","10012","2021",5,5,0,102394,845.2,121.6
"2840","10014","2021",2,2,0,164500,1984,82
"2841","10015","2021",6,6,0,203078.333333333,1997.33333333333,102.833333333333
"2842","10018","2021",15,15,0,124667.666666667,983.6,124.4
"2843","10019","2021",6,6,0,174115,1497.33333333333,115.333333333333
"2844","10020","2021",5,5,0,119200,1215.6,93.2
"2845","10021","2021",1,1,0,84000,515,163
"2846","10022","2021",2,2,0,147250,1266,127.5
"2847","10023","2021",4,4,0,133500,1259.5,115.5
"2848","10024","2021",4,4,0,158499.75,1150,132
"2849","10025","2021",2,2,0,138000,1233.5,120
"2850","10026","2021",2,2,0,187500,1514,122
"2851","10027","2021",1,1,0,85000,914,93
"2852","10028","2021",2,2,0,98000,668,145
"2853","10029","2021",2,2,0,85500,793.5,109
"2854","10030","2021",16,15,1,227796.875,2333.6875,99.875
"2855","10031","2021",10,10,0,106520,1342.9,87.9
"2856","10032","2021",2,2,0,117250,1129.5,90
"2857","10033","2021",49,43,6,100691.326530612,966.938775510204,104.877551020408
"2858","10034","2021",44,31,13,106186.704545455,1060.34090909091,98.7045454545455
"2859","10035","2021",12,12,0,86775,946.5,96.6666666666667
"2860","10037","2021",12,12,0,163625,1657.33333333333,99.75
"2861","10038","2021",4,4,0,115250,1086,114.25
"2862","10039","2021",1,1,0,135000,1467,92
"2863","10040","2021",5,5,0,59500,524,113.4
"2864","10042","2021",10,10,0,128262.5,1465,93.4
"2865","10043","2021",2,2,0,114500,1431,80
"2866","10045","2021",2,2,0,84300,787,85
"2867","10048","2021",3,3,0,64333.3333333333,622.666666666667,95
"2868","10049","2021",8,8,0,235485,1827.375,133.125
"2869","10050","2021",4,4,0,89875,883.5,114.25
"2870","10051","2021",14,14,0,192371.428571429,1707.21428571429,119.214285714286
"2871","10052","2021",2,2,0,123000,1130,106.5
"2872","10053","2021",4,4,0,266100,2455.5,109.5
"2873","10054","2021",1,1,0,130000,1368,95
"2874","10055","2021",10,9,1,88600,937.5,97.4
"2875","10056","2021",1,1,0,71500,786,91
"2876","10057","2021",1,1,0,125200,1473,85
"2877","10058","2021",1,1,0,145000,1450,100
"2878","10059","2021",2,2,0,92550,1025,92.5
"2879","10060","2021",39,34,5,208336.282051282,2111.28205128205,100.282051282051
"2880","10061","2021",10,10,0,88300,1194.4,74.1
"2881","10062","2021",4,4,0,146925,1380,109
"2882","10063","2021",3,3,0,136451,1711.33333333333,79
"2883","10064","2021",1,1,0,185000,2056,90
"2884","10065","2021",3,3,0,91023.3333333333,719.333333333333,129
"2885","10066","2021",8,8,0,149668.75,1272.5,127
"2886","10067","2021",14,11,3,179939.285714286,2285.42857142857,82.7857142857143
"2887","10068","2021",3,3,0,71626.6666666667,820.333333333333,89.6666666666667
"2888","10070","2021",5,5,0,153300,1451.4,117.4
"2889","10073","2021",2,2,0,260500,2089.5,115
"2890","10074","2021",5,5,0,143530,1282.2,113
"2891","10076","2021",1,1,0,96000,600,160
"2892","10077","2021",2,2,0,2e+05,1503,132
"2893","10080","2021",9,8,1,108172.222222222,1084.44444444444,102.666666666667
"2894","10081","2021",116,55,61,111319.439655172,1514.87931034483,70.1034482758621
"2895","10082","2021",5,5,0,81000,862.4,94.2
"2896","10083","2021",5,5,0,167245.2,1967.8,90.4
"2897","10084","2021",14,14,0,186357.142857143,1577.07142857143,124.214285714286
"2898","10086","2021",2,2,0,152000,1039.5,147.5
"2899","10087","2021",2,2,0,137500,1159,123.5
"2900","10089","2021",6,6,0,132500,1261.83333333333,109.5
"2901","10090","2021",2,2,0,177500,1821.5,97
"2902","10091","2021",4,4,0,92725,956.5,98.5
"2903","10092","2021",2,2,0,116000,1546,73
"2904","10093","2021",1,1,0,189000,1588,119
"2905","10094","2021",10,10,0,107671.7,979.2,109.3
"2906","10095","2021",5,5,0,108840,1163.8,91.4
"2907","10096","2021",4,4,0,165475,936.75,160.75
"2908","10097","2021",1,1,0,42000,560,75
"2909","10098","2021",7,7,0,88214.2857142857,852,101.714285714286
"2910","10099","2021",11,11,0,126754.545454545,1098.45454545455,119.272727272727
"2911","10100","2021",14,14,0,173475,1545.78571428571,117.285714285714
"2912","10101","2021",2,2,0,131100,1495,88
"2913","10102","2021",3,3,0,89500,832.333333333333,104.333333333333
"2914","10103","2021",2,2,0,217500,1813,120
"2915","10104","2021",4,4,0,169000,1756.25,96.25
"2916","10106","2021",1,1,0,365000,2267,161
"2917","10107","2021",2,2,0,122450,1115,111
"2918","10108","2021",1,1,0,1e+05,1429,70
"2919","10109","2021",2,2,0,133000,1101.5,116
"2920","10110","2021",5,5,0,196640,2040.2,97.2
"2921","10111","2021",1,1,0,190000,1900,100
"2922","10112","2021",5,5,0,84300,815.2,93.6
"2923","10113","2021",5,5,0,152000,1044.2,133.8
"2924","10114","2021",15,15,0,100328.666666667,1066.26666666667,96.2666666666667
"2925","10115","2021",21,20,1,240313.285714286,2068.38095238095,119.857142857143
"2926","10116","2021",3,3,0,125333.333333333,1212.33333333333,127.333333333333
"2927","10117","2021",3,3,0,61500,772,81
"2928","10119","2021",2,2,0,72281,679,106.5
"2929","10120","2021",2,2,0,127500,1259,104.5
"2930","10121","2021",3,3,0,99833.3333333333,841.666666666667,152.333333333333
"2931","10122","2021",4,4,0,118500,1051.5,115
"2932","10123","2021",21,15,6,87826.1904761905,1365.95238095238,72.2380952380952
"2933","10124","2021",2,2,0,166000,1244,135
"2934","10125","2021",4,4,0,224750,1674,130.5
"2935","10126","2021",1,1,0,272000,1277,213
"2936","10128","2021",1,1,0,60500,756,80
"2937","10129","2021",5,5,0,187000,1579,133.6
"2938","10131","2021",5,5,0,123200,1306.4,94.2
"2939","10133","2021",6,6,0,171833.333333333,1044.83333333333,137.833333333333
"2940","10135","2021",3,3,0,84420,998.666666666667,84.6666666666667
"2941","10138","2021",3,3,0,144333.333333333,1093.66666666667,116.666666666667
"2942","10139","2021",2,2,0,69000,557,122.5
"2943","10140","2021",18,18,0,73122.2222222222,884.611111111111,81.6111111111111
"2944","10141","2021",18,18,0,120013.944444444,929.555555555556,117.777777777778
"2945","10142","2021",27,27,0,119603.703703704,1150.22222222222,103.111111111111
"2946","10143","2021",5,5,0,90800,850,108.8
"2947","10144","2021",4,4,0,130725,1442,92.75
"2948","10146","2021",4,4,0,136970,1493.5,106
"2949","10148","2021",7,7,0,137642.857142857,1157.28571428571,130.285714285714
"2950","10149","2021",1,1,0,271000,1362,199
"2951","10150","2021",4,4,0,124250,1253.5,90
"2952","10151","2021",16,14,2,145253.125,1512.5625,92.8125
"2953","10153","2021",8,8,0,155562.5,1868.875,84
"2954","10154","2021",2,2,0,452500,5067.5,121.5
"2955","10155","2021",3,3,0,139100,1724.33333333333,76
"2956","10156","2021",7,6,1,151857,1581.28571428571,97.8571428571429
"2957","10157","2021",3,3,0,125666.666666667,1252.33333333333,119.333333333333
"2958","10158","2021",4,4,0,175000,1966.5,89.25
"2959","10159","2021",2,2,0,131250,913,142.5
"2960","10162","2021",2,2,0,137500,1417.5,97
"2961","10164","2021",5,5,0,127200,1291.8,100.2
"2962","10165","2021",9,9,0,185007.111111111,1691,116.555555555556
"2963","10166","2021",12,12,0,140833.333333333,1369,107.166666666667
"2964","10167","2021",2,2,0,75000,1149.5,89.5
"2965","10169","2021",2,2,0,132000,1251.5,108
"2966","10170","2021",12,12,0,113779.166666667,1028.58333333333,114.416666666667
"2967","10171","2021",4,4,0,100825,1042.25,97
"2968","10172","2021",4,4,0,145250,1204,119.5
"2969","10173","2021",6,6,0,207033.333333333,1921,103.666666666667
"2970","10174","2021",2,2,0,79500,1030.5,77
"2971","10175","2021",3,3,0,122433.333333333,1138.66666666667,116.666666666667
"2972","10176","2021",3,3,0,109033.333333333,784.666666666667,139.333333333333
"2973","10177","2021",5,5,0,207109.2,1758.4,118.8
"2974","10178","2021",2,2,0,101500,1202,108.5
"2975","10179","2021",9,9,0,185845.888888889,1181.77777777778,152.555555555556
"2976","10180","2021",1,1,0,53500,345,155
"2977","10181","2021",9,9,0,115844.111111111,1130,104.888888888889
"2978","10182","2021",4,4,0,55250,680.5,85
"2979","10185","2021",1,1,0,148000,1096,135
"2980","10186","2021",7,6,1,264814.285714286,1801.14285714286,154.142857142857
"2981","10187","2021",5,5,0,68799.8,1467.8,81
"2982","10188","2021",6,6,0,115150,1273.16666666667,85
"2983","10189","2021",2,2,0,47500,1117.5,57.5
"2984","10190","2021",5,5,0,229720,1972.2,124.4
"2985","10191","2021",11,11,0,180045.454545455,1853.45454545455,97.0909090909091
"2986","10192","2021",2,2,0,156000,1222,112
"2987","10193","2021",5,5,0,122600,1140,120
"2988","10194","2021",1,1,0,90000,947,95
"2989","10195","2021",4,4,0,114000,1116.5,102
"2990","10196","2021",3,3,0,49666.6666666667,791,60.3333333333333
"2991","10197","2021",1,1,0,147900,1479,100
"2992","10198","2021",3,3,0,127700,1942.66666666667,67.6666666666667
"2993","10199","2021",8,8,0,103805.625,1022.125,103.625
"2994","10201","2021",2,2,0,167900,1087.5,169.5
"2995","10202","2021",3,3,0,123000,1362.33333333333,91.3333333333333
"2996","10203","2021",6,6,0,106066.666666667,1237.16666666667,94.3333333333333
"2997","10204","2021",3,3,0,115666.666666667,1601.66666666667,72.6666666666667
"2998","10205","2021",1,1,0,110000,1571,70
"2999","10206","2021",3,3,0,155000,1248.33333333333,121.666666666667
"3000","10207","2021",2,2,0,73750,595,117
"3001","10208","2021",2,2,0,103000,1270,85.5
"3002","10209","2021",26,25,1,214064.230769231,1886.57692307692,114.884615384615
"3003","10210","2021",2,2,0,168000,1882.5,90
"3004","10211","2021",18,17,1,234916.666666667,1924.11111111111,126.333333333333
"3005","10212","2021",2,2,0,116000,1023,103.5
"3006","10213","2021",4,4,0,137750,1397.25,90
"3007","10215","2021",2,2,0,131500,1239.5,106
"3008","10216","2021",11,11,0,106090.909090909,874.727272727273,118.545454545455
"3009","10218","2021",5,5,0,75200,801.6,90.6
"3010","10220","2021",31,30,1,128340.322580645,1324.06451612903,96.6129032258064
"3011","10221","2021",5,5,0,183317.6,1114.2,158.2
"3012","10222","2021",14,14,0,137117.857142857,1376.57142857143,114
"3013","10223","2021",9,9,0,93333.3333333333,1070.22222222222,90.8888888888889
"3014","10224","2021",21,21,0,139619.047619048,1271.04761904762,112.619047619048
"3015","10225","2021",2,2,0,144750,1557,94.5
"3016","10226","2021",2,2,0,107500,951.5,110.5
"3017","10227","2021",5,5,0,94400,951.6,101.6
"3018","10228","2021",6,6,0,90166.6666666667,1075.66666666667,84.8333333333333
"3019","10229","2021",4,4,0,177250,1742.25,102.5
"3020","10230","2021",9,9,0,156444.444444444,1678.66666666667,94
"3021","10231","2021",8,8,0,160375,1700.5,95.375
"3022","10232","2021",3,3,0,157000,1552.33333333333,109.666666666667
"3023","10233","2021",29,29,0,126290.689655172,1310.1724137931,102.379310344828
"3024","10234","2021",5,5,0,159320,1388.8,115.4
"3025","10235","2021",1,1,0,68000,716,95
"3026","10236","2021",1,1,0,154000,1158,133
"3027","10237","2021",5,5,0,119750,1321.2,84.4
"3028","10238","2021",12,11,1,166083.333333333,2348.75,90.0833333333333
"3029","10239","2021",4,4,0,219837.5,1578.25,141.75
"3030","10240","2021",4,4,0,249250,1663.25,154.25
"3031","10241","2021",1,1,0,120000,1463,82
"3032","10242","2021",1,1,0,55000,611,90
"3033","10243","2021",2,2,0,49000,591.5,91
"3034","10245","2021",7,7,0,201539.285714286,1844.14285714286,107.428571428571
"3035","10246","2021",4,4,0,218487.5,1616,140.75
"3036","10247","2021",5,5,0,104100,1338.4,102.2
"3037","10248","2021",2,2,0,160325,2151.5,68
"3038","10249","2021",6,6,0,144933.333333333,1491.66666666667,97.6666666666667
"3039","10250","2021",2,2,0,94750,1119.5,85
"3040","10251","2021",1,1,0,35000,700,50
"3041","10253","2021",1,1,0,1e+05,1587,63
"3042","10254","2021",9,9,0,115055.555555556,1040.11111111111,118.222222222222
"3043","10255","2021",7,7,0,203357.142857143,1466.14285714286,147.714285714286
"3044","10256","2021",4,4,0,196202.5,1614.5,120
"3045","10258","2021",1,1,0,120000,1333,90
"3046","10259","2021",3,3,0,167566.666666667,1590.33333333333,103
"3047","10260","2021",4,3,1,188500,2062.75,91.75
"3048","10261","2021",9,9,0,83722.2222222222,897.555555555556,95.6666666666667
"3049","10262","2021",2,2,0,105000,2324,50.5
"3050","10263","2021",5,5,0,134280,1246.6,105.6
"3051","10265","2021",25,24,1,162840,1935.8,85.68
"3052","10266","2021",1,1,0,72500,493,147
"3053","10267","2021",2,2,0,207500,1358,152
"3054","10268","2021",74,61,13,151049.054054054,1722.55405405405,86.9189189189189
"3055","10269","2021",1,1,0,212000,1128,188
"3056","10270","2021",3,3,0,120666.666666667,1088.66666666667,113.666666666667
"3057","10271","2021",10,10,0,102286.6,1210.2,84.8
"3058","10272","2021",2,2,0,110000,1286,80.5
"3059","10274","2021",5,5,0,121316.8,1294.8,94
"3060","10275","2021",7,7,0,121857.142857143,1354.57142857143,90.5714285714286
"3061","10276","2021",8,8,0,121742.5,1369.875,89.875
"3062","10278","2021",5,5,0,193210,1513.8,107.6
"3063","10280","2021",14,13,1,118237.142857143,1329.78571428571,88.9285714285714
"3064","10281","2021",2,2,0,152000,1897.5,80.5
"3065","10282","2021",15,15,0,219056.666666667,2037.46666666667,107.2
"3066","10283","2021",2,2,0,92500,865.5,96.5
"3067","10284","2021",1,1,0,277000,2037,136
"3068","10286","2021",4,4,0,174250,1464,126.5
"3069","10287","2021",15,15,0,120826.666666667,1225.6,99.8666666666667
"3070","10288","2021",6,5,1,71666.6666666667,2042,69.5
"3071","10289","2021",18,18,0,94066.6666666667,973.277777777778,97
"3072","10290","2021",6,6,0,108275,1056.66666666667,114.5
"3073","10291","2021",2,2,0,88760,539.5,147.5
"3074","10293","2021",3,3,0,140833.333333333,988.333333333333,142.333333333333
"3075","10294","2021",1,1,0,40000,367,109
"3076","10295","2021",7,7,0,104065.714285714,1046.42857142857,97.4285714285714
"3077","10296","2021",2,1,1,164000,4759,61
"3078","10297","2021",62,53,9,194264.112903226,1926.32258064516,100.5
"3079","10299","2021",5,5,0,117900,1037.8,106.8
"3080","10300","2021",2,2,0,104000,1342,78
"3081","10301","2021",1,1,0,90000,1139,79
"3082","10302","2021",3,3,0,144633.333333333,1146.66666666667,133.666666666667
"3083","10303","2021",2,2,0,168000,1167,144
"3084","10304","2021",3,3,0,127600,1127,124.666666666667
"3085","10305","2021",3,3,0,170000,1250.66666666667,137
"3086","10306","2021",3,3,0,98613.3333333333,1185.66666666667,82.6666666666667
"3087","10307","2021",5,5,0,188400,1854.4,103.6
"3088","10308","2021",6,6,0,141616.666666667,1626,90.5
"3089","10309","2021",1,1,0,165000,825,200
"3090","10310","2021",4,4,0,94750,627.5,136.5
"3091","10312","2021",5,5,0,76600,882.8,82.8
"3092","10313","2021",3,3,0,132500,1267,106.666666666667
"3093","10314","2021",1,1,0,120000,992,121
"3094","10315","2021",2,2,0,112895,866.5,114
"3095","10316","2021",1,1,0,31000,456,68
"3096","10317","2021",15,14,1,92631.8666666667,923.6,108.866666666667
"3097","10318","2021",4,4,0,158450,1401,116.25
"3098","10319","2021",12,12,0,80208.3333333333,735.666666666667,110.833333333333
"3099","10320","2021",3,3,0,257754,1975.66666666667,135
"3100","10321","2021",43,43,0,213531.441860465,2106.60465116279,102.953488372093
"3101","10323","2021",249,219,30,103692.156626506,1259.82329317269,85.2048192771084
"3102","10324","2021",5,5,0,149480.6,1547.4,103.2
"3103","10325","2021",61,51,10,200550.68852459,2091.85245901639,97.7868852459016
"3104","10326","2021",2,2,0,93492.5,987,91
"3105","10327","2021",2,2,0,155450,1112,142.5
"3106","10328","2021",6,6,0,168416.666666667,1472.83333333333,113.5
"3107","10329","2021",5,5,0,225100,1952.8,117.8
"3108","10330","2021",3,3,0,112800,974.666666666667,115
"3109","10331","2021",7,7,0,136714.285714286,1475.57142857143,94.2857142857143
"3110","10332","2021",2,2,0,171250,1582.5,104
"3111","10333","2021",256,113,143,147800.78125,1829.29296875,80.00390625
"3112","10334","2021",9,9,0,154177.777777778,1557.66666666667,97.6666666666667
"3113","10335","2021",6,6,0,132225,1248.16666666667,112.5
"3114","10336","2021",3,3,0,217566.666666667,1706.66666666667,125.333333333333
"3115","10337","2021",1,1,0,17000,1308,13
"3116","10338","2021",6,6,0,209989.5,1627.66666666667,133.666666666667
"3117","10339","2021",3,3,0,128333.333333333,1080,115.666666666667
"3118","10340","2021",25,25,0,244844,2102.48,118.28
"3119","10341","2021",6,5,1,113500,929.5,119.5
"3120","10342","2021",5,5,0,96664,912.2,119.8
"3121","10343","2021",99,58,41,159917.383838384,1863.18181818182,85.9494949494949
"3122","10344","2021",7,7,0,216478.571428571,1829,112
"3123","10345","2021",5,5,0,99600,1338.6,76.4
"3124","10347","2021",4,4,0,150500,1289,115.25
"3125","10348","2021",3,3,0,96500,1204,78.6666666666667
"3126","10349","2021",35,34,1,191538.857142857,1777.94285714286,110.057142857143
"3127","10350","2021",12,12,0,117895.833333333,1102.58333333333,119.333333333333
"3128","10351","2021",5,5,0,190200,1104,175.6
"3129","10352","2021",18,18,0,208287.777777778,1917.66666666667,107.666666666667
"3130","10353","2021",27,27,0,140339.62962963,1488.77777777778,93.3703703703704
"3131","10355","2021",1,1,0,210000,1680,125
"3132","10356","2021",5,5,0,109400,1170.6,109.4
"3133","10357","2021",44,37,7,167510.227272727,1939.5,86.9318181818182
"3134","10358","2021",14,13,1,171268.571428571,1831.5,95.2857142857143
"3135","10359","2021",6,6,0,129166.666666667,1351.83333333333,94.8333333333333
"3136","10360","2021",7,7,0,255023.857142857,2006.14285714286,131
"3137","10361","2021",1,1,0,50000,833,60
"3138","10362","2021",260,108,152,129222.707692308,1904.84615384615,69.1076923076923
"3139","10363","2021",5,5,0,290440,1940.8,141.4
"3140","10365","2021",1,1,0,94000,1288,73
"3141","10367","2021",9,9,0,144000,1300.22222222222,109
"3142","10368","2021",16,16,0,162420.3125,1611.75,102.6875
"3143","10369","2021",2,2,0,119250,996,137
"3144","10370","2021",12,12,0,177083.333333333,1509.91666666667,119.916666666667
"3145","10371","2021",4,4,0,221250,1509.75,151.25
"3146","10372","2021",3,3,0,102000,633.333333333333,156
"3147","10373","2021",6,6,0,230741.666666667,1620,150.166666666667
"3148","10374","2021",3,3,0,1e+05,900,112.666666666667
"3149","10376","2021",2,1,1,92000,973,93.5
"3150","10377","2021",2,2,0,50000,464.5,109.5
"3151","10378","2021",2,2,0,65545,542,127
"3152","10379","2021",6,6,0,129333.333333333,1194.5,104.833333333333
"3153","10380","2021",2,2,0,98500,1295,76.5
"3154","10381","2021",12,12,0,270605.416666667,2030.75,137
"3155","10382","2021",23,23,0,106230.391304348,1193.52173913043,90.8695652173913
"3156","10383","2021",4,4,0,138000,1041.25,128.5
"3157","10384","2021",1,1,0,55000,1000,55
"3158","10386","2021",5,5,0,178009.6,1967,95.8
"3159","10387","2021",1378,248,1130,114486.338896952,1741.36865021771,67.4020319303338
"3160","10388","2021",2,2,0,235000,1157,165
"3161","10389","2021",1,1,0,26000,406,64
"3162","10390","2021",3,3,0,1e+05,1178.66666666667,77.6666666666667
"3163","10391","2021",3,3,0,139333.333333333,1674,86.6666666666667
"3164","10392","2021",8,8,0,161000,1370,115.5
"3165","10393","2021",5,5,0,96700,1009.6,94.6
"3166","10394","2021",4,4,0,89875,1277.25,73.75
"3167","10395","2021",4,4,0,82500,832.5,95.75
"3168","10396","2021",15,15,0,150326.666666667,1534,98.2
"3169","10397","2021",1,1,0,275000,1978,139
"3170","10398","2021",1,1,0,60000,522,115
"3171","10399","2021",9,9,0,161244.444444444,1815.44444444444,89.1111111111111
"3172","10400","2021",2,2,0,56150,662.5,77
"3173","10401","2021",31,29,2,112550,1209.87096774194,93.5161290322581
"3174","10402","2021",5,5,0,224500,1781.8,128.4
"3175","10404","2021",1,1,0,25000,521,48
"3176","10406","2021",28,27,1,219654.25,1950.64285714286,115.678571428571
"3177","10409","2021",11,11,0,221011.818181818,1851.54545454545,133.636363636364
"3178","10410","2021",1,1,0,80000,748,107
"3179","10412","2021",5,5,0,208500,2320.6,90.6
"3180","10414","2021",2,2,0,227500,1602.5,141
"3181","10416","2021",4,4,0,198975,1609.25,131
"3182","10417","2021",4,4,0,144742.5,1641.75,85.25
"3183","10418","2021",7,7,0,108301.428571429,1089,96.4285714285714
"3184","10419","2021",9,9,0,143444.444444444,1398.88888888889,99.8888888888889
"3185","10420","2021",33,33,0,130679.090909091,1406.66666666667,94.7575757575758
"3186","10421","2021",4,4,0,119500,1032.75,117.25
"3187","10422","2021",4,4,0,71750,614.75,114
"3188","10423","2021",7,7,0,153027.142857143,1422.42857142857,111.428571428571
"3189","10424","2021",3,3,0,86900,1107.66666666667,78.3333333333333
"3190","10425","2021",7,7,0,134528.571428571,1320.57142857143,108.428571428571
"3191","10426","2021",11,11,0,59000,715.454545454545,88.0909090909091
"3192","10427","2021",4,4,0,107400,957.75,110.5
"3193","10428","2021",2,2,0,126500,915.5,149.5
"3194","10429","2021",3,3,0,155333.333333333,1403.66666666667,106.333333333333
"3195","10430","2021",3,3,0,145666.666666667,1052,153.333333333333
"3196","10431","2021",3,3,0,82333.3333333333,711.333333333333,115
"3197","10432","2021",2,2,0,125000,1082.5,124.5
"3198","10433","2021",3,3,0,111666.666666667,1204.33333333333,94.3333333333333
"3199","10434","2021",1,1,0,149000,1505,99
"3200","10435","2021",2,2,0,202500,1456,142.5
"3201","10436","2021",3,3,0,162333.333333333,1604.66666666667,98.6666666666667
"3202","10437","2021",9,9,0,159677.777777778,1925.33333333333,101.666666666667
"3203","10439","2021",1,1,0,168000,1244,135
"3204","10440","2021",2,2,0,124000,1198.5,104.5
"3205","10441","2021",3,3,0,105333.333333333,1120.33333333333,91.3333333333333
"3206","10442","2021",7,7,0,165957.142857143,1476.28571428571,119.571428571429
"3207","10444","2021",2,2,0,50250,753,72.5
"3208","10445","2021",1,0,1,157000,1744,90
"3209","11001","2021",10,10,0,120682.5,1160,94.8
"3210","11002","2021",3,3,0,198383.333333333,1318.33333333333,154
"3211","11003","2021",4,4,0,106661.25,1072,97
"3212","11004","2021",7,6,1,135395,1373.28571428571,100.285714285714
"3213","11005","2021",20,20,0,197016.2,1804.7,109.4
"3214","11006","2021",1,1,0,119800,1498,80
"3215","11007","2021",4,4,0,116425,2180.25,49
"3216","11008","2021",9,8,1,163633.333333333,1229.66666666667,136.888888888889
"3217","11009","2021",16,15,1,126750,1056.5,118
"3218","11010","2021",12,12,0,194299.416666667,1872.66666666667,108.5
"3219","11011","2021",10,10,0,242850,1821.8,136.1
"3220","11012","2021",40,40,0,204981.125,1967.475,105.3
"3221","11013","2021",11,10,1,169972.727272727,1762.09090909091,94.7272727272727
"3222","11014","2021",24,24,0,221764.875,2236.33333333333,94.1666666666667
"3223","11015","2021",8,8,0,119363,1116.125,104.875
"3224","11016","2021",4,4,0,213525,1205.5,142.75
"3225","11018","2021",15,15,0,155544.666666667,1448.93333333333,105.6
"3226","11019","2021",3,3,0,73666.6666666667,943.666666666667,74.3333333333333
"3227","11020","2021",1,1,0,77000,846,91
"3228","11021","2021",13,13,0,99156.1538461538,1192.69230769231,88
"3229","11022","2021",31,29,2,110443.64516129,1365.54838709677,87.9032258064516
"3230","11023","2021",16,15,1,177222.25,1606.5,114
"3231","11024","2021",18,17,1,277993.055555556,2943,97.5555555555556
"3232","11025","2021",4,4,0,130375,1415.25,94.25
"3233","11026","2021",3,3,0,201898.333333333,2056,99.3333333333333
"3234","11027","2021",10,10,0,100575,1044.9,91.2
"3235","11028","2021",19,18,1,123517.263157895,1345.84210526316,104.263157894737
"3236","11030","2021",2,2,0,296150,2368,114.5
"3237","11031","2021",1,1,0,4e+05,1843,217
"3238","11032","2021",7,7,0,142981.428571429,1226.57142857143,94.8571428571429
"3239","11033","2021",26,25,1,138327.423076923,1416.76923076923,98.6153846153846
"3240","11034","2021",16,16,0,147635.3125,1541.5,97.375
"3241","11035","2021",8,8,0,142375,1350.375,103.5
"3242","11036","2021",9,9,0,88316.6666666667,1064.66666666667,79.6666666666667
"3243","11037","2021",26,12,14,76667.3846153846,1051.23076923077,66.9615384615385
"3244","11038","2021",6,6,0,73891.6666666667,1079.16666666667,67.5
"3245","11040","2021",29,28,1,197183.068965517,1962.10344827586,104.51724137931
"3246","11041","2021",29,29,0,178752.413793103,1762.1724137931,102.034482758621
"3247","11042","2021",4,4,0,169550,1098.25,150
"3248","11043","2021",3,3,0,173283.333333333,1199.66666666667,121.333333333333
"3249","11044","2021",5,5,0,88968,1538.4,55.6
"3250","11045","2021",4,4,0,70312.5,863.5,74.5
"3251","11046","2021",1,1,0,128620,1608,80
"3252","11047","2021",2,2,0,116482.5,1170.5,98
"3253","11048","2021",10,10,0,133375,1439.9,93
"3254","11049","2021",44,44,0,135723.204545455,1359.45454545455,99.4090909090909
"3255","11052","2021",13,13,0,191920,1740.15384615385,113
"3256","11053","2021",8,8,0,217425,1946.125,121.375
"3257","11054","2021",3,3,0,224533.333333333,2110.66666666667,106.666666666667
"3258","11055","2021",10,10,0,132520,1445.7,89.6
"3259","11056","2021",5,5,0,85563,780.6,116.4
"3260","11058","2021",6,6,0,231590,1310.16666666667,168.166666666667
"3261","11059","2021",4,4,0,88312.5,1191,85
"3262","11061","2021",6,6,0,192818.166666667,1792.66666666667,106.833333333333
"3263","11062","2021",1,1,0,88533,2393,37
"3264","11063","2021",16,15,1,137450.125,2045.9375,92.1875
"3265","11064","2021",7,7,0,191381.714285714,1595.42857142857,117.428571428571
"3266","11065","2021",3,3,0,117000,1014,119
"3267","11066","2021",13,13,0,108097,1293.61538461538,91.6153846153846
"3268","11067","2021",37,37,0,186027.918918919,1907.10810810811,95.8918918918919
"3269","11068","2021",30,30,0,108107.4,1180.4,90.3666666666667
"3270","11069","2021",937,531,406,120912.212379936,1373.80469583778,85.0181430096051
"3271","11070","2021",8,8,0,184445,1729.875,105.875
"3272","11071","2021",4,4,0,138569.5,1413.5,92
"3273","11072","2021",6,6,0,145333.333333333,1277.16666666667,114.5
"3274","11074","2021",6,6,0,130067.333333333,1153.33333333333,114.666666666667
"3275","11075","2021",5,5,0,72199,849.8,86.4
"3276","11076","2021",164,123,41,126538.853658537,1476.7256097561,87.6829268292683
"3277","11077","2021",6,6,0,117241.666666667,1269.16666666667,98.3333333333333
"3278","11078","2021",7,7,0,195416,2395.71428571429,85.8571428571429
"3279","11079","2021",2,2,0,103500,1510,67
"3280","11080","2021",3,3,0,145000,1946.66666666667,68
"3281","11081","2021",32,30,2,164539.59375,1419.78125,111.5
"3282","11084","2021",10,10,0,186537,1658,108.4
"3283","11085","2021",21,21,0,167424.619047619,1608.80952380952,102.857142857143
"3284","11086","2021",23,23,0,228982.304347826,2309,101.304347826087
"3285","11087","2021",2,2,0,195000,1119,165
"3286","11088","2021",28,28,0,173660,1678.39285714286,104.75
"3287","11089","2021",15,13,2,115002.666666667,1145.2,98.0666666666667
"3288","11090","2021",8,8,0,150763.75,1666.625,90.875
"3289","11091","2021",19,18,1,90672.1052631579,910.684210526316,101.105263157895
"3290","11092","2021",8,8,0,90187.5,1057.875,77.75
"3291","11093","2021",3,3,0,44166.6666666667,630,67
"3292","11095","2021",4,4,0,244735,1829.25,139
"3293","11096","2021",3,3,0,62560,693,79.3333333333333
"3294","11098","2021",12,12,0,161500,1607.08333333333,99.0833333333333
"3295","11099","2021",42,42,0,132927.142857143,1458.78571428571,95.9285714285714
"3296","11101","2021",1,1,0,120000,1667,72
"3297","11102","2021",8,8,0,152557.5,1472.625,109.125
"3298","11103","2021",28,25,3,99649.3571428571,1051.03571428571,102.75
"3299","11104","2021",2,2,0,71960,989,75
"3300","11105","2021",7,7,0,226974.285714286,2312,98.8571428571429
"3301","11106","2021",114,102,12,147911.131578947,1788.13157894737,87.140350877193
"3302","11107","2021",1,1,0,120000,1791,67
"3303","11109","2021",1,1,0,48000,857,56
"3304","11110","2021",2,2,0,87460,1000.5,81.5
"3305","11111","2021",19,19,0,164068.842105263,1554.42105263158,103.631578947368
"3306","11112","2021",2,2,0,55000,966.5,62.5
"3307","11113","2021",4,4,0,43750,876.5,58.75
"3308","11115","2021",13,13,0,144846.153846154,1575.07692307692,106.769230769231
"3309","11116","2021",78,75,3,166629.076923077,1756.26923076923,95.6282051282051
"3310","11117","2021",8,8,0,69131.25,866.375,84.25
"3311","11118","2021",3,3,0,107198,953,111.666666666667
"3312","11119","2021",4,4,0,136550,1566.75,86.75
"3313","11120","2021",8,8,0,155532.5,1351.5,113.625
"3314","11121","2021",1,1,0,57000,518,110
"3315","11122","2021",25,25,0,127897.2,1430.8,93.2
"3316","11123","2021",1,1,0,182270,2604,70
"3317","11124","2021",16,15,1,185764.5,1450.5,130.0625
"3318","11125","2021",10,10,0,154040,1552.8,117.2
"3319","11126","2021",11,11,0,121722.818181818,1317.18181818182,99.5454545454545
"3320","11127","2021",4,4,0,49500,749.5,65
"3321","11128","2021",3,3,0,192500,1428.33333333333,133.666666666667
"3322","11129","2021",57,54,3,96321.3333333333,1129.12280701754,84.859649122807
"3323","11130","2021",6,6,0,102683.333333333,1064.66666666667,97.1666666666667
"3324","11131","2021",10,10,0,103219,1098.8,103.4
"3325","11132","2021",25,24,1,171921.6,1676.32,99.56
"3326","11133","2021",2,2,0,351555,1903,150.5
"3327","11135","2021",3,3,0,41500,690.333333333333,61
"3328","11136","2021",10,10,0,154500,1183.4,142.8
"3329","11137","2021",2,2,0,49450,1210,43.5
"3330","11138","2021",11,11,0,147620,1440.72727272727,99.8181818181818
"3331","11139","2021",1,1,0,28000,341,82
"3332","11140","2021",27,25,2,138698.962962963,1597.74074074074,87.5555555555556
"3333","11141","2021",3,3,0,236806,1423.33333333333,166.333333333333
"3334","11142","2021",3,3,0,187996.666666667,1622.66666666667,114
"3335","11143","2021",2,2,0,232500,3263.5,99.5
"3336","11144","2021",50,37,13,150032.98,1942.84,79
"3337","11145","2021",423,223,200,122609.364066194,3059.16784869976,43.1867612293144
"3338","11146","2021",5,5,0,148000,1375.6,85.6
"3339","11148","2021",8,8,0,154299.5,969,144.375
"3340","11150","2021",11,11,0,127679.090909091,1630.72727272727,86.8181818181818
"3341","11151","2021",8,8,0,131583.125,1346,93.375
"3342","11152","2021",8,8,0,204798.125,1918.125,108.375
"3343","11153","2021",2,2,0,106290,1391,80.5
"3344","11154","2021",3,3,0,69833.3333333333,843.666666666667,83
"3345","11155","2021",1,1,0,106000,2304,46
"3346","11156","2021",1,1,0,175000,1296,135
"3347","11157","2021",4,4,0,158500,2212.25,91.25
"3348","11158","2021",1,1,0,124500,1617,77
"3349","11159","2021",3,3,0,166733.333333333,1008,163.333333333333
"3350","11161","2021",4,4,0,165200,1915.75,92.5
"3351","11162","2021",1,1,0,135640,1292,105
"3352","11163","2021",1,1,0,70000,673,104
"3353","11164","2021",43,41,2,214386.511627907,1982.25581395349,103.604651162791
"3354","11165","2021",7,7,0,169520,1563.71428571429,121.142857142857
"3355","11167","2021",2,2,0,73500,716,108
"3356","11168","2021",2,2,0,96750,1334,69.5
"3357","11169","2021",1,1,0,213500,1722,124
"3358","11170","2021",548,195,353,131726.937956204,3267.06569343066,41.3065693430657
"3359","11172","2021",22,18,4,152348.863636364,1869.63636363636,91.4545454545455
"3360","11173","2021",5,5,0,142256,1099.6,123.4
"3361","11175","2021",10,10,0,181032.5,1417.4,117.3
"3362","11177","2021",1,1,0,27500,509,54
"3363","11178","2021",30,30,0,198303.1,1777.13333333333,104.733333333333
"3364","11179","2021",3,3,0,43333.3333333333,565,78.6666666666667
"3365","11180","2021",2,2,0,44950,922.5,63.5
"3366","11181","2021",14,14,0,128757.285714286,1180.85714285714,102.857142857143
"3367","11182","2021",6,6,0,109384.166666667,1110,97
"3368","11183","2021",3,3,0,106666.666666667,1001,107
"3369","11184","2021",2,2,0,97490,3007.5,48.5
"3370","11185","2021",11,11,0,222577.727272727,2042.36363636364,111.090909090909
"3371","11186","2021",2,2,0,82500,1153,75
"3372","11187","2021",4,4,0,84625,1078.5,73.25
"3373","11188","2021",39,39,0,236647.358974359,1998.4358974359,115.128205128205
"3374","11189","2021",8,8,0,83931.25,1194.125,69.375
"3375","11190","2021",36,35,1,127157.361111111,1339.36111111111,98.9166666666667
"3376","11191","2021",4,4,0,95037.5,1378,70.75
"3377","11192","2021",14,14,0,118918.571428571,1209,98.5
"3378","11193","2021",3,3,0,153333.333333333,1639.66666666667,99
"3379","11194","2021",4,4,0,82350,950.75,96.75
"3380","11195","2021",6,6,0,151110.833333333,1409.16666666667,121.333333333333
"3381","11196","2021",5,5,0,146843.2,1519.6,104
"3382","11197","2021",9,9,0,156642.222222222,1406,107.333333333333
"3383","11198","2021",18,18,0,106712.777777778,1260.16666666667,92
"3384","11199","2021",24,24,0,164223.125,1602.875,103.166666666667
"3385","11200","2021",2,2,0,44375,552,90
"3386","11201","2021",11,11,0,133567.818181818,1310.81818181818,106.181818181818
"3387","11202","2021",692,250,442,114704.797687861,3092.6112716763,36.8598265895954
"3388","11203","2021",188,155,33,150055.457446809,1731.75,87.0585106382979
"3389","11205","2021",1,1,0,178000,1604,111
"3390","11206","2021",163,144,19,134958.202453988,1461.12883435583,91.840490797546
"3391","11207","2021",3,3,0,64866.6666666667,1073,61.3333333333333
"3392","11208","2021",3,3,0,175766.666666667,1551.33333333333,106
"3393","11209","2021",5,5,0,95680,915.2,98.8
"3394","11210","2021",27,27,0,141764.592592593,1455.14814814815,97.4074074074074
"3395","11211","2021",9,9,0,139117.777777778,1760,78.8888888888889
"3396","11212","2021",6,6,0,237626.666666667,1715.83333333333,148.666666666667
"3397","11213","2021",2,2,0,125300,982.5,111
"3398","11214","2021",3,3,0,189253.333333333,1884.33333333333,100.666666666667
"3399","11215","2021",5,5,0,97051,1105,93
"3400","11216","2021",7,7,0,178141.428571429,1598,113.714285714286
"3401","11217","2021",13,13,0,203165.153846154,1991.46153846154,99.5384615384615
"3402","11219","2021",2,2,0,56475,1048.5,54.5
"3403","11220","2021",17,16,1,94279.7058823529,1096.76470588235,85.2941176470588
"3404","11221","2021",4,4,0,167677.5,1638,101.75
"3405","11222","2021",3,3,0,64433.3333333333,705.333333333333,88.3333333333333
"3406","11223","2021",1,1,0,149000,2365,63
"3407","11224","2021",2,2,0,144249.5,1154,113.5
"3408","11225","2021",9,9,0,215291.111111111,1451.22222222222,146.555555555556
"3409","11226","2021",1,1,0,130000,2321,56
"3410","11227","2021",1,1,0,230000,2300,100
"3411","11228","2021",2,2,0,49100,575,86
"3412","11230","2021",3,3,0,53326.6666666667,684,78
"3413","11231","2021",1,1,0,235000,4796,49
"3414","11232","2021",1,1,0,105320,752,140
"3415","11233","2021",13,12,1,185890.307692308,1811.76923076923,100
"3416","11234","2021",1,1,0,308000,2200,140
"3417","11235","2021",1,1,0,73000,1217,60
"3418","11236","2021",2,2,0,101400,1269.5,78
"3419","11238","2021",1,1,0,40000,667,60
"3420","11239","2021",1,1,0,810000,6328,128
"3421","11240","2021",13,13,0,140180.307692308,1478.92307692308,101
"3422","11241","2021",8,8,0,157673.375,1716,104.75
"3423","11242","2021",4,4,0,231855,1316.75,144.75
"3424","11243","2021",9,9,0,193736.111111111,1799.55555555556,109.666666666667
"3425","11244","2021",1,1,0,30000,638,47
"3426","11246","2021",1,1,0,186480,1828,102
"3427","11248","2021",1,1,0,85000,654,130
"3428","11249","2021",1,1,0,209000,1493,140
"3429","11250","2021",2,2,0,87500,1620.5,54.5
"3430","11251","2021",18,18,0,122926.833333333,1261.11111111111,103.777777777778
"3431","11252","2021",7,7,0,192886.714285714,1631.71428571429,128.428571428571
"3432","11253","2021",10,10,0,166070,1688.3,111.6
"3433","11254","2021",30,30,0,151551.566666667,1453.06666666667,104.966666666667
"3434","11255","2021",26,25,1,215605,1935.92307692308,110.076923076923
"3435","11256","2021",19,19,0,182670,1726.10526315789,102.631578947368
"3436","11257","2021",3,3,0,238025,1770,133.333333333333
"3437","11258","2021",41,40,1,219259.268292683,2127.70731707317,102.707317073171
"3438","11259","2021",24,24,0,139641.25,1525.16666666667,94.7083333333333
"3439","11260","2021",5,5,0,145540,1675.2,82.6
"3440","11261","2021",16,16,0,158283.125,1363.8125,121
"3441","11262","2021",1319,528,791,156155.887035633,2272.26459438969,69.1956027293404
"3442","11263","2021",13,13,0,99531.1538461538,1210.46153846154,86.3846153846154
"3443","11264","2021",21,20,1,208461,2029.38095238095,117.857142857143
"3444","11266","2021",267,126,141,112218.36329588,2381.69288389513,50.8614232209738
"3445","11267","2021",27,27,0,156865.185185185,1565.07407407407,98.7407407407407
"3446","11269","2021",47,46,1,122634.70212766,1405.76595744681,87.2765957446808
"3447","11270","2021",10,10,0,67012.5,1060.1,79.4
"3448","11271","2021",2,2,0,208950,1671,128.5
"3449","11272","2021",51,51,0,249347.784313725,2174.47058823529,114.43137254902
"3450","11273","2021",18,18,0,188653.5,1747.88888888889,101.666666666667
"3451","11274","2021",2,2,0,280000,1996,137
"3452","11275","2021",4,4,0,190237.5,1135.25,147.25
"3453","11276","2021",21,21,0,78734.0476190476,946.095238095238,82.4761904761905
"3454","11278","2021",2,2,0,132000,765.5,166.5
"3455","11279","2021",41,41,0,176895.56097561,1587.36585365854,115.487804878049
"3456","11280","2021",21,21,0,186463.80952381,1470.19047619048,130.285714285714
"3457","11281","2021",19,18,1,152827.368421053,1251.63157894737,119.263157894737
"3458","11282","2021",2,2,0,49500,569.5,88.5
"3459","11283","2021",1,1,0,113000,1507,75
"3460","11284","2021",4,4,0,117300,1108.75,108.5
"3461","11285","2021",31,28,3,241109.032258065,2494.77419354839,103.161290322581
"3462","11286","2021",26,26,0,125270,1227.07692307692,102.653846153846
"3463","11287","2021",1,1,0,118000,1405,84
"3464","11288","2021",23,22,1,146284.652173913,1516.4347826087,92.9565217391304
"3465","11289","2021",23,23,0,165155.652173913,1612.82608695652,103.434782608696
"3466","11290","2021",4,4,0,145411.25,2023.75,76.75
"3467","11292","2021",2,2,0,144330,1272.5,103
"3468","11293","2021",12,12,0,210741.666666667,1909.16666666667,105.166666666667
"3469","11295","2021",24,24,0,182536.666666667,1687.20833333333,104.75
"3470","11296","2021",13,13,0,191220.923076923,1806.84615384615,105.846153846154
"3471","11297","2021",11,11,0,87655.7272727273,1453.63636363636,61
"3472","11299","2021",14,14,0,235671.428571429,1599.5,136.714285714286
"3473","11300","2021",3,3,0,176533.333333333,1541,116
"3474","11301","2021",31,30,1,132698.774193548,1626.1935483871,87.5161290322581
"3475","11302","2021",13,13,0,86404.1538461538,1165.23076923077,79.7692307692308
"3476","11303","2021",14,14,0,141743.571428571,1138.14285714286,126.357142857143
"3477","11304","2021",71,64,7,126473.38028169,1327.08450704225,93.9154929577465
"3478","11305","2021",3,3,0,84750,1277,62.6666666666667
"3479","11306","2021",2,2,0,94500,954,96
"3480","11307","2021",6,6,0,165346.666666667,1265.66666666667,125.5
"3481","11308","2021",10,10,0,114067.6,1131.4,96.3
"3482","11309","2021",2,2,0,131250,1688.5,81.5
"3483","11310","2021",6,4,2,159391.666666667,2071.66666666667,86
"3484","11311","2021",6,6,0,173713.833333333,1504.16666666667,121
"3485","11313","2021",3,3,0,149000,1277.33333333333,123
"3486","11314","2021",2,2,0,96750,1062,94
"3487","11315","2021",42,42,0,146952.095238095,1492.57142857143,103.404761904762
"3488","11316","2021",3,3,0,116000,930.666666666667,118.333333333333
"3489","11317","2021",7,7,0,90208.5714285714,775.285714285714,131.714285714286
"3490","11318","2021",6,6,0,135383.333333333,1352.83333333333,98.8333333333333
"3491","11319","2021",2,2,0,99250,1604.5,61
"3492","11320","2021",12,12,0,99715.8333333333,1198,84.3333333333333
"3493","11321","2021",5,5,0,72981.8,901.2,95.6
"3494","11322","2021",24,23,1,217935.75,2088.91666666667,108.083333333333
"3495","11323","2021",6,6,0,131991.666666667,1302.66666666667,95.8333333333333
"3496","11324","2021",11,11,0,148174.090909091,1464.54545454545,95.4545454545455
"3497","11325","2021",6,6,0,143223.333333333,1463.66666666667,96.3333333333333
"3498","11326","2021",6,6,0,98666.6666666667,1778.5,82.1666666666667
"3499","11327","2021",11,11,0,148943,1547.63636363636,91.0909090909091
"3500","11328","2021",6,6,0,176121.833333333,1522.33333333333,132.166666666667
"3501","11330","2021",10,10,0,168934.4,1859.6,88.9
"3502","11331","2021",1,1,0,94500,705,134
"3503","11332","2021",35,35,0,199380.885714286,1852.45714285714,109.428571428571
"3504","11334","2021",4,4,0,269500,2520,111
"3505","11335","2021",2,2,0,52432.5,742.5,73
"3506","11336","2021",5,5,0,115100,1092,114
"3507","11337","2021",10,10,0,104864,1128.1,92.7
"3508","11339","2021",8,8,0,141504.25,1422.125,90.125
"3509","11340","2021",6,6,0,138686.666666667,1479.16666666667,92.3333333333333
"3510","11341","2021",3,3,0,113000,1026.33333333333,114.333333333333
"3511","11342","2021",4,4,0,130875,1368.25,97
"3512","11343","2021",1,1,0,125000,1923,65
"3513","11344","2021",15,15,0,106186,1279.46666666667,93
"3514","11345","2021",10,10,0,180080,1878.9,96.4
"3515","11346","2021",3,3,0,61316.6666666667,614,106.333333333333
"3516","11348","2021",2,2,0,117625,1143.5,103
"3517","11351","2021",22,21,1,155464.5,1519.18181818182,102.136363636364
"3518","11352","2021",2,2,0,111785,1436.5,76.5
"3519","11353","2021",44,44,0,190427.613636364,1942.79545454545,98.7954545454545
"3520","11354","2021",1,1,0,80000,1143,70
"3521","11355","2021",2,2,0,167010,1088.5,153
"3522","11356","2021",17,17,0,162494,1556.35294117647,100.823529411765
"3523","11357","2021",4,4,0,148220,1539.75,97.25
"3524","11358","2021",1,1,0,171250,1112,154
"3525","11359","2021",7,7,0,271942.857142857,2639.57142857143,105.142857142857
"3526","11360","2021",35,35,0,205483.514285714,1997.25714285714,101.257142857143
"3527","11361","2021",4,4,0,176012.5,1275.25,137.75
"3528","11362","2021",1,1,0,329480,2099,157
"3529","11363","2021",3,3,0,349023.333333333,1553.33333333333,199
"3530","11364","2021",1,1,0,320000,2832,113
"3531","11365","2021",1,1,0,267000,1543,173
"3532","11366","2021",17,17,0,226157.647058824,1927.52941176471,118.882352941176
"3533","11367","2021",11,11,0,187820.636363636,1491.45454545455,111.454545454545
"3534","11368","2021",3,3,0,152166.666666667,1221,126.666666666667
"3535","11369","2021",64,63,1,229120.296875,2084.03125,112.234375
"3536","11370","2021",69,68,1,223278.376811594,2179.17391304348,104.115942028986
"3537","11371","2021",9,9,0,130444.444444444,1380.33333333333,102.888888888889
"3538","11372","2021",3,3,0,70000,1037.33333333333,69
"3539","11373","2021",8,8,0,81312.5,1020.625,88.25
"3540","11376","2021",1,1,0,45000,450,100
"3541","11377","2021",4,4,0,107800,1343.5,80.25
"3542","11378","2021",2,2,0,241625,1598.5,116.5
"3543","11379","2021",106,91,15,169838.471698113,1950.44339622642,87
"3544","11381","2021",1,1,0,56930,703,81
"3545","11382","2021",3,3,0,188366.666666667,1929.33333333333,98.3333333333333
"3546","11383","2021",6,6,0,158421,1592.83333333333,104.166666666667
"3547","11384","2021",3,3,0,58533.3333333333,722.333333333333,84.6666666666667
"3548","11385","2021",1,1,0,141050,1369,103
"3549","11386","2021",6,6,0,83166.6666666667,979.833333333333,90.8333333333333
"3550","11387","2021",1,1,0,180000,1176,153
"3551","11388","2021",1,1,0,2e+05,1626,123
"3552","11390","2021",19,19,0,108095.263157895,1220.68421052632,94.8947368421053
"3553","11392","2021",8,8,0,111378.75,1051,99.5
"3554","11393","2021",17,16,1,102366.294117647,1059.88235294118,100.705882352941
"3555","11394","2021",3,3,0,69000,823.666666666667,83.3333333333333
"3556","11395","2021",3,3,0,71666.6666666667,878,81
"3557","11396","2021",13,13,0,154971.538461538,1625.30769230769,96.5384615384615
"3558","11397","2021",83,69,14,117881.674698795,1271.40963855422,91.0120481927711
"3559","11398","2021",7,7,0,323070,2469.42857142857,109.285714285714
"3560","11399","2021",2,2,0,111000,1358.5,109.5
"3561","11400","2021",2,2,0,121500,916,139
"3562","11401","2021",14,14,0,116761.428571429,1181.14285714286,95.5714285714286
"3563","11404","2021",19,19,0,171959.526315789,1482.36842105263,109.157894736842
"3564","11405","2021",16,16,0,164019.75,1611.9375,98.5
"3565","11407","2021",2,2,0,148000,1282.5,101
"3566","11408","2021",6,6,0,76333.3333333333,1076.66666666667,83
"3567","11409","2021",7,7,0,92427.7142857143,1094.85714285714,82.4285714285714
"3568","11410","2021",20,20,0,124258.85,1375.65,94.85
"3569","11411","2021",2,2,0,37500,432,88
"3570","11412","2021",3,3,0,131116.666666667,1277,98.3333333333333
"3571","11413","2021",15,15,0,124649.333333333,1183.06666666667,101.466666666667
"3572","11414","2021",4,4,0,125560,1449.5,106.5
"3573","11415","2021",1,1,0,465000,3419,136
"3574","11416","2021",4,4,0,186312.5,1617.75,103.75
"3575","11417","2021",1,1,0,650000,6132,106
"3576","11418","2021",18,18,0,153112.222222222,1358.72222222222,112.611111111111
"3577","11420","2021",3,3,0,194760,1562.66666666667,119.666666666667
"3578","11421","2021",15,14,1,143153.333333333,1475.2,98
"3579","11422","2021",5,5,0,249200,1894.2,121.2
"3580","11423","2021",2,2,0,266097,1888.5,141.5
"3581","11424","2021",1,1,0,108000,1350,80
"3582","11425","2021",34,34,0,172337.705882353,1807.44117647059,94.2058823529412
"3583","11426","2021",20,15,5,157792.5,1711.55,89.55
"3584","11428","2021",4,4,0,97750,1007.75,98.75
"3585","11429","2021",62,59,3,210549.129032258,1895.27419354839,109.596774193548
"3586","11430","2021",20,20,0,189052.25,1719.05,111.8
"3587","11431","2021",7,7,0,125496,1185.85714285714,105.428571428571
"3588","11432","2021",7,6,1,240152.857142857,2257.85714285714,108
"3589","11433","2021",12,11,1,155712.5,1351.33333333333,110.083333333333
"3590","11434","2021",20,20,0,125602.4,1348,97.25
"3591","11435","2021",3,3,0,116133.333333333,1047.33333333333,113.333333333333
"3592","11436","2021",14,14,0,154512.928571429,1852.07142857143,84.4285714285714
"3593","11437","2021",9,9,0,144155.555555556,1495.44444444444,101
"3594","11438","2021",5,5,0,147751.2,1387,109.8
"3595","11439","2021",9,9,0,87675,1176.77777777778,85.1111111111111
"3596","11441","2021",36,31,5,198369.416666667,2248.22222222222,88.8888888888889
"3597","12001","2021",7,7,0,201909.428571429,1915.42857142857,107.285714285714
"3598","12002","2021",7,5,2,129798.571428571,1371.71428571429,96.5714285714286
"3599","12003","2021",3,3,0,148286.666666667,1359.33333333333,111.333333333333
"3600","12004","2021",3,2,1,147333.333333333,1524.33333333333,107.666666666667
"3601","12006","2021",4,4,0,70550,976,85.5
"3602","12007","2021",2,2,0,141000,1391.5,102
"3603","12008","2021",11,11,0,167701.363636364,1585.27272727273,110.454545454545
"3604","12009","2021",2,2,0,40000,767,59
"3605","12010","2021",2,2,0,170300,1568.5,105
"3606","12011","2021",9,8,1,147363.333333333,2055.33333333333,81.6666666666667
"3607","12012","2021",7,7,0,108142.857142857,1090,97.1428571428571
"3608","12013","2021",53,53,0,87310.6226415094,964.150943396226,89.2641509433962
"3609","12015","2021",7,7,0,65917.1428571429,971.142857142857,68.2857142857143
"3610","12016","2021",12,12,0,116941.666666667,1135.58333333333,108
"3611","12017","2021",2,2,0,58930,1448,41
"3612","12018","2021",2,2,0,92500,1217,76
"3613","12019","2021",2,2,0,74500,1300,60.5
"3614","12021","2021",17,17,0,154596.470588235,1630.29411764706,94.6470588235294
"3615","12022","2021",2,2,0,95750,1099,87.5
"3616","12023","2021",2,2,0,120700,1085.5,105.5
"3617","12024","2021",1,1,0,168000,1113,151
"3618","12025","2021",6,5,1,94437.5,897,116
"3619","12026","2021",12,12,0,141530.166666667,1651.66666666667,88.0833333333333
"3620","12027","2021",1,1,0,95500,868,110
"3621","12028","2021",10,10,0,60955,728.1,84.9
"3622","12029","2021",4,4,0,105375,1508,70.75
"3623","12030","2021",10,10,0,124970,1132.3,112.7
"3624","12031","2021",7,7,0,136376.142857143,1513,96.8571428571429
"3625","12032","2021",5,5,0,166260,1631.4,116.4
"3626","12033","2021",30,22,8,190671,1943.86666666667,102.066666666667
"3627","12034","2021",3,3,0,139650,1123,126.666666666667
"3628","12035","2021",2,2,0,74000,863,87
"3629","12036","2021",13,13,0,74846.1538461538,910.384615384615,84.7692307692308
"3630","12037","2021",11,11,0,89237.2727272727,1169.54545454545,91.9090909090909
"3631","12038","2021",3,3,0,113333.333333333,1111,103.666666666667
"3632","12039","2021",3,3,0,68116.6666666667,1066,64
"3633","12041","2021",4,4,0,92220,910,94.5
"3634","12042","2021",5,5,0,156660,2174.2,77
"3635","12043","2021",13,13,0,139063.846153846,1437.38461538462,98.8461538461538
"3636","12044","2021",18,15,3,88274.5,976.222222222222,85.4444444444444
"3637","12045","2021",4,4,0,88520,970,110.25
"3638","12046","2021",3,3,0,183833.333333333,2095,90.6666666666667
"3639","12047","2021",9,9,0,107466.666666667,1415.66666666667,80.8888888888889
"3640","12048","2021",11,11,0,113619.545454545,1383.90909090909,87
"3641","12049","2021",8,8,0,136887.5,1368.75,100.25
"3642","12050","2021",3,3,0,144700,1348,92
"3643","12051","2021",2,2,0,60150,706.5,85
"3644","12052","2021",59,57,2,148070.949152542,1622.8813559322,93.271186440678
"3645","12053","2021",4,4,0,147125,1487,101.25
"3646","12054","2021",10,10,0,107363,1144.1,100.1
"3647","12055","2021",2,2,0,90250,2053,44.5
"3648","12056","2021",27,22,5,156240.37037037,1708.22222222222,93.9259259259259
"3649","12057","2021",17,17,0,77728.5294117647,1027.88235294118,80.5882352941177
"3650","12058","2021",2,2,0,106500,1467.5,71
"3651","12059","2021",5,5,0,107868.2,885,127.2
"3652","12060","2021",2,2,0,159997.5,1915,86
"3653","12061","2021",9,9,0,164444.444444444,1358.88888888889,126.555555555556
"3654","12062","2021",4,4,0,153750,1222.25,128
"3655","12063","2021",10,8,2,108236.7,1437.1,80.9
"3656","12065","2021",9,9,0,85016.1111111111,697.888888888889,114.333333333333
"3657","12066","2021",5,5,0,108378,1229.8,100.2
"3658","12067","2021",2,2,0,194115,1517,131
"3659","12068","2021",4,4,0,117275,1120.25,115.5
"3660","12069","2021",7,7,0,103847.714285714,920,107
"3661","12070","2021",12,10,2,212124.583333333,1692.33333333333,135.166666666667
"3662","12071","2021",7,7,0,88847.5714285714,704.571428571429,136.714285714286
"3663","12072","2021",9,8,1,124805.555555556,2155.44444444444,81
"3664","12073","2021",12,12,0,151565,1313.16666666667,105
"3665","12074","2021",1,1,0,234000,3079,76
"3666","12075","2021",4,4,0,84250,771.75,106.75
"3667","12076","2021",31,30,1,148738.806451613,1677.8064516129,92.1612903225806
"3668","12077","2021",9,9,0,82693.7777777778,1118,74.4444444444444
"3669","12078","2021",2,2,0,151313.5,1165.5,117.5
"3670","12079","2021",10,10,0,144715,1665.5,88.3
"3671","12080","2021",9,8,1,79202.2222222222,951.333333333333,84.5555555555556
"3672","12082","2021",7,6,1,103345.714285714,1603.85714285714,72.1428571428571
"3673","12083","2021",27,24,3,84925.2592592593,1012.22222222222,84.037037037037
"3674","12084","2021",18,16,2,208403.777777778,2131.44444444444,98.6666666666667
"3675","12085","2021",3,3,0,85666.6666666667,1039.33333333333,81.3333333333333
"3676","12086","2021",3,3,0,126000,1663,74.6666666666667
"3677","12088","2021",2,2,0,71000,943,74
"3678","12089","2021",74,58,16,84237.027027027,941.472972972973,92.5675675675676
"3679","12090","2021",26,26,0,244312.269230769,2359.65384615385,105.769230769231
"3680","12091","2021",4,4,0,158290,1795.75,87.25
"3681","12092","2021",7,5,2,99000,989.857142857143,103.571428571429
"3682","12093","2021",7,7,0,196857.142857143,2582.28571428571,80
"3683","12094","2021",22,22,0,93129.0909090909,1089.5,87.9545454545455
"3684","12095","2021",2,2,0,50000,625,75
"3685","12096","2021",75,32,43,120026.36,1439.10666666667,84.4266666666667
"3686","12097","2021",6,6,0,139920,1394.66666666667,98.6666666666667
"3687","12098","2021",6,6,0,148833.333333333,1390.5,115.666666666667
"3688","12099","2021",2,2,0,46500,591.5,80
"3689","12100","2021",35,33,2,110976.285714286,1280.82857142857,88.8
"3690","12101","2021",11,11,0,120968.181818182,1208.45454545455,101.818181818182
"3691","12102","2021",26,23,3,190972.115384615,1756.80769230769,109.115384615385
"3692","12103","2021",6,6,0,145634.833333333,956.833333333333,142
"3693","12104","2021",6,6,0,114833.333333333,1193,93.5
"3694","12105","2021",19,18,1,158198.473684211,1404.73684210526,119.157894736842
"3695","12106","2021",8,8,0,115111.25,1383.625,87.125
"3696","12107","2021",2,2,0,187500,1718.5,106.5
"3697","12108","2021",5,5,0,119000,1233.2,99.2
"3698","12109","2021",2,1,1,76500,1067.5,62
"3699","12110","2021",8,8,0,92920.625,1249.625,82.875
"3700","12111","2021",5,5,0,152622.2,2090,70.4
"3701","12113","2021",5,4,1,158501.8,1420.2,112.2
"3702","12115","2021",5,5,0,127307,1345.2,102.2
"3703","12116","2021",2,2,0,53000,793,81.5
"3704","12118","2021",5,5,0,99216,1021.2,95.6
"3705","12119","2021",17,5,12,90937.6470588235,1454.58823529412,44.4705882352941
"3706","12120","2021",31,24,7,114841.129032258,1433.25806451613,81.1290322580645
"3707","12121","2021",9,7,2,147078.222222222,1367.55555555556,107
"3708","12122","2021",1,1,0,64000,1000,64
"3709","12124","2021",4,4,0,246430,1287,167
"3710","12125","2021",7,7,0,71292.4285714286,853.714285714286,83.8571428571429
"3711","12127","2021",13,13,0,115234.615384615,1105.53846153846,111.846153846154
"3712","12128","2021",5,5,0,107580,1260.6,87.2
"3713","12129","2021",2,2,0,84500,819,101
"3714","12130","2021",14,14,0,80953.5714285714,903.571428571429,86.8571428571429
"3715","12131","2021",13,10,3,186153.846153846,1859.46153846154,103.307692307692
"3716","12133","2021",63,44,19,185051.746031746,2047.34920634921,96.4603174603175
"3717","12134","2021",5,5,0,164080,1912.8,94.2
"3718","12135","2021",6,6,0,177416.666666667,1489.66666666667,131.333333333333
"3719","12136","2021",11,11,0,145163.636363636,1350.09090909091,123.818181818182
"3720","12137","2021",4,4,0,165406.25,1578.25,106.5
"3721","12138","2021",17,14,3,162184.235294118,1827.88235294118,87.7058823529412
"3722","12139","2021",4,4,0,133485,1354.75,93
"3723","12140","2021",10,10,0,178128,1542.7,111.5
"3724","12141","2021",4,4,0,116325,1053.25,117.5
"3725","12142","2021",3,3,0,127900.666666667,1130.33333333333,110
"3726","12143","2021",4,4,0,77000,1002,77.75
"3727","12144","2021",1,1,0,140000,1556,90
"3728","12145","2021",347,131,216,132000.063400576,1673.77809798271,76.9654178674352
"3729","12146","2021",53,45,8,182671.849056604,1990.75471698113,92.2452830188679
"3730","12147","2021",4,4,0,70787.5,868.5,81.25
"3731","12148","2021",20,18,2,122184,1503.35,79.1
"3732","12149","2021",4,4,0,95500,912.25,115.75
"3733","12150","2021",11,11,0,175494.545454545,1492.90909090909,121.545454545455
"3734","12151","2021",1,1,0,25000,379,66
"3735","12153","2021",6,5,1,130500,1016.33333333333,104.5
"3736","12154","2021",5,5,0,187523.6,1420.2,119.8
"3737","12155","2021",8,8,0,125797.5,1762.875,74.875
"3738","12156","2021",4,4,0,208500,1349.5,157
"3739","12157","2021",13,11,2,167815.384615385,1659.53846153846,101.615384615385
"3740","12158","2021",3,3,0,97333.3333333333,1298,72
"3741","12159","2021",8,8,0,107097.5,1178.875,96.625
"3742","12160","2021",9,8,1,156804.666666667,1741.33333333333,91.7777777777778
"3743","12161","2021",3,3,0,101600,2026.66666666667,56
"3744","12162","2021",9,9,0,128338.888888889,1411,94.1111111111111
"3745","12163","2021",2,2,0,39625,1001.5,42.5
"3746","12164","2021",14,13,1,92311.4285714286,917.642857142857,100.5
"3747","12165","2021",3,3,0,122526.666666667,1941,62.6666666666667
"3748","12166","2021",1,1,0,171200,1902,90
"3749","12167","2021",27,27,0,139561.592592593,1443.74074074074,106.777777777778
"3750","12168","2021",21,19,2,129295.428571429,1680.61904761905,82.0952380952381
"3751","12169","2021",41,39,2,131182.268292683,1340.46341463415,97.8536585365854
"3752","12170","2021",7,7,0,118285.714285714,1283.57142857143,92.4285714285714
"3753","12171","2021",6,6,0,123716.666666667,1563,76
"3754","12172","2021",5,5,0,187400,1472,129.8
"3755","12174","2021",43,30,13,188436.976744186,2177.88372093023,87.3488372093023
"3756","12176","2021",219,99,120,163236.570776256,2098.57534246575,78.9406392694064
"3757","12177","2021",9,9,0,88435.5555555556,1107,79.6666666666667
"3758","12178","2021",2,1,1,72525,1323.5,53
"3759","12179","2021",1,1,0,107000,973,110
"3760","12180","2021",2,1,1,145000,1037,141
"3761","12181","2021",3,3,0,140833.333333333,1202.33333333333,116
"3762","12182","2021",6,6,0,136375.833333333,1477.33333333333,98.8333333333333
"3763","12183","2021",4,4,0,166297,1454.75,102.25
"3764","12184","2021",4,4,0,47182.5,963.5,51
"3765","12185","2021",19,19,0,141292.105263158,1511.57894736842,98.5263157894737
"3766","12186","2021",2,2,0,99000,775.5,133
"3767","12187","2021",12,8,4,88413.3333333333,1313.33333333333,70.4166666666667
"3768","12188","2021",3,3,0,130166.666666667,1590.33333333333,78.3333333333333
"3769","12189","2021",5,5,0,176249,1432.8,118.2
"3770","12190","2021",4,4,0,139325,1151.5,127.5
"3771","12191","2021",7,7,0,196364.285714286,1732.14285714286,114.857142857143
"3772","12192","2021",3,3,0,90000,1356.33333333333,67
"3773","12193","2021",1,1,0,142800,1587,90
"3774","12194","2021",9,9,0,180281.333333333,1655.44444444444,113.888888888889
"3775","12195","2021",3,3,0,143133.333333333,1311,103.666666666667
"3776","12197","2021",28,28,0,107057.5,1092.35714285714,104.928571428571
"3777","12198","2021",27,26,1,108165.555555556,1254.77777777778,85
"3778","12199","2021",34,23,11,107969.147058824,1266,85.2058823529412
"3779","12200","2021",14,14,0,191740.357142857,2049.5,106.714285714286
"3780","12201","2021",9,9,0,202993.333333333,1702.22222222222,125.777777777778
"3781","12202","2021",546,79,467,132986.932234432,1950.9652014652,70.981684981685
"3782","12203","2021",6,6,0,109558.333333333,1425.83333333333,83.1666666666667
"3783","12204","2021",4,3,1,95486.25,1778.25,51.25
"3784","12205","2021",5,5,0,125498,1226.4,103.6
"3785","12206","2021",2,2,0,119907.5,1115.5,115.5
"3786","12207","2021",7,7,0,103100,1137.14285714286,94
"3787","12208","2021",82,50,32,116542.756097561,1453.89024390244,81.9390243902439
"3788","12209","2021",16,16,0,135717.375,1277.75,118.375
"3789","12210","2021",14,14,0,135407.142857143,1359.07142857143,93.7857142857143
"3790","12211","2021",5,5,0,103124,1328.2,79
"3791","12212","2021",4,4,0,75000,795.75,93
"3792","12213","2021",12,11,1,116266.666666667,1345.08333333333,86.6666666666667
"3793","12214","2021",12,12,0,117196.25,1083.58333333333,103.916666666667
"3794","12215","2021",7,6,1,173164.285714286,1757.71428571429,103.857142857143
"3795","12216","2021",13,13,0,124757.692307692,1438.23076923077,86.5384615384615
"3796","12217","2021",8,8,0,218150,1819.125,119.875
"3797","12219","2021",12,12,0,89000,1285.5,86.9166666666667
"3798","12220","2021",2,2,0,146700,1805,81.5
"3799","12221","2021",2,2,0,148760,959,149.5
"3800","12222","2021",3,3,0,58500,891,65.3333333333333
"3801","12223","2021",15,15,0,94173.3333333333,1100.26666666667,89.5333333333333
"3802","12224","2021",58,28,30,71413.9827586207,1344.13793103448,52.551724137931
"3803","12225","2021",15,15,0,181754.333333333,2109.93333333333,88.6
"3804","12226","2021",5,5,0,120321,949.6,117.6
"3805","12227","2021",2,2,0,65000,1016.5,67.5
"3806","12228","2021",6,5,1,140416.666666667,1653.5,100.833333333333
"3807","12229","2021",1,1,0,165900,1382,120
"3808","12230","2021",1,1,0,156000,1238,126
"3809","12231","2021",22,20,2,117789.090909091,1119.45454545455,102.090909090909
"3810","12232","2021",11,11,0,100872.727272727,1470.72727272727,74.2727272727273
"3811","12233","2021",4,4,0,173247.5,1718.5,100.25
"3812","12234","2021",10,10,0,153227,1298.4,116.1
"3813","12235","2021",10,10,0,96175.5,1119.4,83.9
"3814","12236","2021",3,3,0,197864.666666667,1642.33333333333,121.333333333333
"3815","12237","2021",17,15,2,134741.176470588,1543.41176470588,101.882352941176
"3816","12239","2021",8,8,0,115557,1882.75,65
"3817","12240","2021",8,8,0,100725,1051.875,99
"3818","12241","2021",16,16,0,268373.125,2217.8125,123.625
"3819","12242","2021",4,4,0,117750,1227.5,99
"3820","12243","2021",15,14,1,124674.666666667,1387,91.2666666666667
"3821","12244","2021",12,12,0,100399.166666667,1007.33333333333,95.25
"3822","12246","2021",6,6,0,90666.6666666667,949.166666666667,132.666666666667
"3823","12247","2021",1,1,0,76000,1086,70
"3824","12248","2021",1,1,0,425000,2471,172
"3825","12250","2021",6,6,0,95500,1547.16666666667,70
"3826","12251","2021",7,7,0,123769.285714286,1243.71428571429,99.4285714285714
"3827","12252","2021",8,8,0,149596.875,1793.625,88.25
"3828","12253","2021",22,14,8,121400.909090909,1782.68181818182,80.1363636363636
"3829","12254","2021",11,11,0,203570.454545455,1795.27272727273,124.454545454545
"3830","12255","2021",13,12,1,108653.846153846,1223,91.0769230769231
"3831","12256","2021",6,6,0,160608.333333333,1470,115
"3832","12257","2021",18,18,0,131401.111111111,1434.16666666667,96.2222222222222
"3833","12258","2021",20,20,0,119490.85,1418.55,87.75
"3834","12259","2021",9,9,0,148439.888888889,1709.77777777778,85.4444444444444
"3835","12260","2021",3,3,0,42666.6666666667,715.333333333333,73.3333333333333
"3836","12261","2021",1,1,0,30000,1000,30
"3837","12262","2021",11,11,0,102571.818181818,1146,87.0909090909091
"3838","12263","2021",5,5,0,116054,1203.4,96
"3839","12264","2021",30,25,5,204786.666666667,2110.86666666667,98.3
"3840","12265","2021",4,4,0,101000,1129.75,82.25
"3841","12266","2021",5,5,0,172048,1416.6,121.6
"3842","12267","2021",6,6,0,83671.1666666667,754.833333333333,114.166666666667
"3843","12268","2021",9,9,0,81533.3333333333,1322.44444444444,75
"3844","12269","2021",1,1,0,108800,2720,40
"3845","12270","2021",46,37,9,120291.434782609,1401.4347826087,83.5652173913043
"3846","12272","2021",5,5,0,154268,1183.6,134.8
"3847","12273","2021",3,3,0,106500,1050,112.666666666667
"3848","12274","2021",1,1,0,75352,754,100
"3849","12276","2021",1,1,0,179500,1832,98
"3850","12277","2021",6,6,0,98175,976.833333333333,99.1666666666667
"3851","12278","2021",7,7,0,190185.714285714,1739.85714285714,110.285714285714
"3852","12280","2021",6,5,1,115443.333333333,1389.66666666667,90.1666666666667
"3853","12281","2021",5,5,0,151962,1465.2,104.6
"3854","12282","2021",4,4,0,119700,1517.5,82.75
"3855","12283","2021",4,4,0,123477.5,1048,122.5
"3856","12284","2021",5,5,0,103737.4,1625,63.2
"3857","12286","2021",17,16,1,184344.647058824,1781.29411764706,102.352941176471
"3858","12287","2021",13,13,0,99516.3076923077,927.230769230769,116.076923076923
"3859","12288","2021",21,19,2,202812.857142857,2140.85714285714,95.8571428571429
"3860","12289","2021",1,1,0,37000,925,40
"3861","12290","2021",5,5,0,194152,2005.2,98.6
"3862","12291","2021",7,7,0,194368.571428571,1868.28571428571,105
"3863","12292","2021",12,12,0,91118.8333333333,1140.75,78.9166666666667
"3864","12293","2021",2,2,0,101000,1086.5,107.5
"3865","12294","2021",3,3,0,212287.666666667,1335.33333333333,193.666666666667
"3866","12296","2021",6,6,0,109761.666666667,1236,93.3333333333333
"3867","12297","2021",10,10,0,124621,1449.9,86.5
"3868","12298","2021",7,7,0,102868.571428571,1199.42857142857,78
"3869","12299","2021",20,19,1,145140,1810.55,92.45
"3870","12300","2021",145,107,38,125000.124137931,1330.34482758621,98.048275862069
"3871","12301","2021",12,12,0,162876.416666667,1514.33333333333,107.333333333333
"3872","12303","2021",2,2,0,120000,1355,122.5
"3873","12305","2021",24,23,1,81171.6666666667,889.125,93.7083333333333
"3874","12307","2021",3,3,0,83843.3333333333,1089.33333333333,102.333333333333
"3875","13001","2021",2517,466,2051,344295.183949146,4954.93206197855,67.1311084624553
"3876","13002","2021",209,130,79,356150.411483254,4243.37799043062,86.2870813397129
"3877","13003","2021",33,31,2,375087.484848485,3633.42424242424,105.212121212121
"3878","13004","2021",757,494,263,227538.22324967,2818.47424042272,81.0898282694848
"3879","13005","2021",436,158,278,266287.506880734,3347.18348623853,79.0160550458716
"3880","13006","2021",25,25,0,393366.4,3904.32,109.92
"3881","13007","2021",106,71,35,356878.339622642,3852.98113207547,91.4716981132076
"3882","13008","2021",11,9,2,513436.363636364,4519,123.727272727273
"3883","13009","2021",2,2,0,813248.5,5530.5,142.5
"3884","13010","2021",55,47,8,272609.309090909,3095.25454545455,92.4363636363636
"3885","13011","2021",9,6,3,662736.666666667,4275.55555555556,133.777777777778
"3886","13012","2021",4,3,1,1338302.5,5837,167.25
"3887","13013","2021",17,15,2,424922.058823529,4291.94117647059,101.176470588235
"3888","13014","2021",111,60,51,215146.423423423,2827.62162162162,76.8198198198198
"3889","13015","2021",171,134,37,482324.333333333,4794.36257309942,101.678362573099
"3890","13016","2021",50,41,9,379067.58,4231.96,90.5
"3891","13017","2021",21,20,1,360142.19047619,3184.38095238095,107.380952380952
"3892","13018","2021",64,60,4,270211.40625,2963.84375,91.703125
"3893","13019","2021",110,98,12,532845.427272727,5039,108.627272727273
"3894","13020","2021",28,25,3,371987.5,3934.64285714286,94.6785714285714
"3895","13021","2021",111,58,53,517125.513513513,5910.23423423423,90.6756756756757
"3896","13022","2021",105,22,83,523176.847619048,7038.95238095238,70
"3897","13023","2021",47,39,8,547257.680851064,4952.65957446809,113.744680851064
"3898","13024","2021",32,22,10,271233.90625,3080.40625,88.8125
"3899","13025","2021",24,13,11,456373.791666667,4724.79166666667,100.25
"3900","13026","2021",249,150,99,268849.353413655,3517.05220883534,78.0803212851406
"3901","13027","2021",252,159,93,240030.543650794,2771.19047619048,87.5793650793651
"3902","13028","2021",663,159,504,305517.788838612,4791.99698340875,64.5716440422323
"3903","13029","2021",24,24,0,526978.958333333,3489.16666666667,159.333333333333
"3904","13030","2021",52,40,12,316019.057692308,3718.53846153846,85.3461538461538
"3905","13031","2021",45,27,18,320285.644444444,4098.37777777778,78.2666666666667
"3906","13032","2021",118,89,29,608547.330508475,5154.70338983051,112.381355932203
"3907","13033","2021",86,76,10,475591.151162791,5068.55813953488,96.1511627906977
"3908","13034","2021",52,49,3,1044776,6654.17307692308,150.826923076923
"3909","13035","2021",113,87,26,285328.17699115,3715.23008849558,79.3362831858407
"3910","13036","2021",64,61,3,400416.203125,3613.859375,105.5625
"3911","13037","2021",108,83,25,316572.657407407,3719.44444444444,85.7962962962963
"3912","13038","2021",58,50,8,416161.293103448,4045.55172413793,102.758620689655
"3913","13039","2021",221,167,54,245119.895927602,3056.81900452489,80.1719457013575
"3914","13040","2021",138,97,41,401880.326086957,4318.78260869565,94.5144927536232
"3915","13041","2021",277,131,146,268624.671480144,3699.78339350181,75.3610108303249
"3916","13042","2021",41,26,15,432826.585365854,4749.82926829268,91.4390243902439
"3917","13043","2021",95,75,20,329556.252631579,3802.82105263158,88.2842105263158
"3918","13044","2021",67,52,15,303533.820895522,3682.58208955224,83.3432835820896
"3919","13045","2021",58,50,8,300333.74137931,3117.27586206897,94.8620689655172
"3920","13046","2021",28,21,7,296826.785714286,4298.85714285714,73.1785714285714
"3921","13047","2021",564,340,224,245347.335106383,3035.34574468085,80.9024822695036
"3922","13048","2021",68,50,18,264244.852941176,2889.54411764706,90.6764705882353
"3923","13049","2021",22,20,2,298506.363636364,3473.36363636364,87.9090909090909
"3924","13050","2021",156,112,44,376320.91025641,3679.16666666667,99.0192307692308
"3925","13051","2021",137,104,33,315491.277372263,3617.93430656934,87.6569343065693
"3926","13052","2021",28,25,3,344066.25,3279.67857142857,106.464285714286
"3927","13053","2021",193,119,74,281611.772020725,3379.91191709845,81.1554404145078
"3928","13054","2021",517,196,321,216758.528046422,2898.52030947776,73.9709864603482
"3929","13055","2021",11164,1414,9750,214211.770512361,3190.50008957363,65.2700644930133
"3930","13056","2021",575,213,362,232228.20173913,3105.82260869565,75.9008695652174
"3931","13057","2021",5,5,0,756451.8,4422.6,159.2
"3932","13058","2021",81,76,5,608868.580246914,5491.30864197531,105.864197530864
"3933","13059","2021",49,37,12,344028.408163265,3638.0612244898,91.6938775510204
"3934","13060","2021",57,33,24,499785.315789474,4763.61403508772,102.228070175439
"3935","13061","2021",1,1,0,108000,3600,30
"3936","13062","2021",38,35,3,438299.894736842,4112.02631578947,106.526315789474
"3937","13063","2021",342,166,176,197437.68128655,2710.86549707602,73.6637426900585
"3938","13064","2021",33,32,1,398739.696969697,3151.87878787879,124.060606060606
"3939","13065","2021",54,51,3,385221.222222222,3602.2962962963,102.481481481481
"3940","13066","2021",78,59,19,298110.91025641,2904.39743589744,100.628205128205
"3941","13067","2021",41,37,4,305364.707317073,2819.43902439024,110.560975609756
"3942","13068","2021",63,61,2,509460.523809524,4679.80952380952,110.111111111111
"3943","13069","2021",173,128,45,313135.219653179,3507.73988439306,88.5433526011561
"3944","13070","2021",50,28,22,294321,3975.42,74.08
"3945","13071","2021",243,164,79,335327.580246914,4034.86419753086,85.1934156378601
"3946","13072","2021",52,49,3,454669.711538462,4335.40384615385,107.5
"3947","13073","2021",57,44,13,356251.333333333,4348.64912280702,84.1052631578947
"3948","13074","2021",69,44,25,293088.31884058,3381.15942028986,87.6376811594203
"3949","13075","2021",108,52,56,319190,4123.56481481481,79.1018518518518
"3950","13076","2021",43,38,5,272746.11627907,2640.46511627907,97.1162790697674
"3951","13077","2021",208,106,102,200933.576923077,2708.58173076923,75.1923076923077
"3952","13078","2021",82,43,39,172133.975609756,2287.17073170732,77.0853658536585
"3953","13079","2021",15,14,1,463593.4,3771.8,116.133333333333
"3954","13080","2021",69,57,12,444514.579710145,4138.55072463768,106.797101449275
"3955","13081","2021",126,90,36,289577.095238095,3365.96825396825,86.4444444444444
"3956","13082","2021",57,52,5,569108.140350877,4812.85964912281,119.719298245614
"3957","13083","2021",50,45,5,294626.5,2817.6,106.26
"3958","13084","2021",73,62,11,291979.246575342,3005.80821917808,100.082191780822
"3959","13085","2021",46,31,15,378019.217391304,4246.36956521739,90.6086956521739
"3960","13086","2021",64,39,25,336222.1875,3812.25,86.390625
"3961","13087","2021",62,37,25,324466.516129032,3883.09677419355,84.5161290322581
"3962","13088","2021",57,37,20,310954.263157895,4851.14035087719,71.7719298245614
"3963","13089","2021",46,31,15,224616.630434783,2526.58695652174,85.6739130434783
"3964","13090","2021",1,1,0,740000,4540,163
"3965","13091","2021",90,76,14,441586.633333333,4211.08888888889,105.511111111111
"3966","13092","2021",145,78,67,257706.551724138,3206.97931034483,80
"3967","13093","2021",4,4,0,466175,3378.75,139.25
"3968","13094","2021",42,25,17,351920.666666667,5248.5,86.9523809523809
"3969","13095","2021",17,17,0,964264.705882353,6354.88235294118,154.941176470588
"3970","13096","2021",110,34,76,214679.627272727,4316.08181818182,51.5545454545455
"3971","13097","2021",166,132,34,281828.439759036,3028.10240963855,94.578313253012
"3972","13098","2021",88,81,7,333797.011363636,3867.23863636364,89.375
"3973","13099","2021",19,11,8,158365.263157895,2569.57894736842,68.3157894736842
"3974","13100","2021",183,147,36,731779.142076503,5647.18579234973,122.136612021858
"3975","13101","2021",29,21,8,328784.310344828,3786.31034482759,86.551724137931
"3976","13102","2021",65,42,23,295466.584615385,3714.98461538462,80.8307692307692
"3977","13103","2021",799,274,525,218585.012515645,2946.23529411765,73.6545682102628
"3978","13104","2021",164,76,88,323179.737804878,6192.35365853659,57.2439024390244
"3979","13105","2021",84,73,11,271419.75,3027.84523809524,90.7261904761905
"3980","13106","2021",144,77,67,262939.5625,3397.43055555556,80.7083333333333
"3981","13107","2021",57,47,10,386941.824561403,4104.22807017544,92.7017543859649
"3982","13108","2021",213,121,92,150939.070422535,1884.2441314554,78.7793427230047
"3983","13109","2021",21,15,6,815486.238095238,5972.80952380952,118.666666666667
"3984","13110","2021",170,126,44,315080.747058824,3816.81176470588,83.3823529411765
"3985","13111","2021",17,11,6,625234.117647059,4570.11764705882,129.823529411765
"3986","13112","2021",92,73,19,387367.543478261,4173.88043478261,94.2826086956522
"3987","13113","2021",110,77,33,444387.172727273,4623.21818181818,94.9
"3988","13114","2021",82,70,12,601798.414634146,4868.80487804878,122.451219512195
"3989","13115","2021",25,24,1,340151.04,3305.8,103.4
"3990","13116","2021",4,4,0,521140.25,4911.25,97.25
"3991","13117","2021",446,231,215,264912.15470852,3308.70179372197,80.2959641255605
"3992","13118","2021",46,41,5,385905.434782609,3990.26086956522,95.8260869565217
"3993","13119","2021",75,36,39,340375.893333333,4147.4,80.1466666666667
"3994","14001","2021",21,21,0,245059.857142857,2284.66666666667,110.238095238095
"3995","14003","2021",4,4,0,166512.25,1696.5,100.75
"3996","14005","2021",25,25,0,216377.2,1823.32,122.36
"3997","14006","2021",16,16,0,248472.1875,2389.125,112.4375
"3998","14007","2021",1,1,0,30000,411,73
"3999","14009","2021",18,15,3,282076.277777778,2726.11111111111,117.055555555556
"4000","14011","2021",31,31,0,194745.64516129,1565.22580645161,129
"4001","14012","2021",3,3,0,175776.666666667,3151,77.3333333333333
"4002","14014","2021",18,18,0,362800,2506.05555555556,145.777777777778
"4003","14015","2021",7,6,1,450311.428571429,2643.71428571429,161.714285714286
"4004","14016","2021",10,10,0,246372.8,2448.7,106.1
"4005","14020","2021",36,34,2,204005.555555556,2292.69444444444,89.8888888888889
"4006","14021","2021",12,11,1,228462.5,2870,83.3333333333333
"4007","14022","2021",20,14,6,158404.25,2575.15,67.2
"4008","14024","2021",18,17,1,356642.944444444,3612.33333333333,104.833333333333
"4009","14025","2021",5,5,0,154540,1999.6,83.6
"4010","14026","2021",14,14,0,219328.714285714,2087.78571428571,105.071428571429
"4011","14027","2021",56,46,10,148508.017857143,1568.41071428571,101.053571428571
"4012","14030","2021",23,23,0,338304.347826087,2805.60869565217,122.217391304348
"4013","14032","2021",7,7,0,448261.428571429,2948.57142857143,131.857142857143
"4014","14033","2021",5,5,0,197597,2442.2,81.6
"4015","14034","2021",1,1,0,260000,2430,107
"4016","14035","2021",26,26,0,139198.884615385,1428.11538461538,98.8461538461538
"4017","14036","2021",3,3,0,253358,1580,154.666666666667
"4018","14037","2021",4,4,0,164800,1764.5,97.75
"4019","14038","2021",16,16,0,279161.25,2292.875,123.8125
"4020","14039","2021",6,6,0,232700,2033,114
"4021","14040","2021",1,1,0,120000,1791,67
"4022","14041","2021",3,3,0,656666.666666667,7216.66666666667,107
"4023","14042","2021",14,14,0,256521.428571429,2323.92857142857,113.5
"4024","14043","2021",2,2,0,189250,2150.5,88
"4025","14044","2021",17,17,0,221349.411764706,2128.11764705882,106.705882352941
"4026","14045","2021",1,1,0,405000,5870,69
"4027","14046","2021",23,22,1,294309.739130435,2551.08695652174,121
"4028","14047","2021",151,62,89,189837.894039735,2338.33112582781,79.0728476821192
"4029","14049","2021",2,2,0,538300,2616.5,210
"4030","14050","2021",1,1,0,1e+05,1471,68
"4031","14054","2021",2,2,0,236580,1023,227
"4032","14055","2021",14,13,1,291688.357142857,3068.21428571429,92.2857142857143
"4033","14057","2021",17,17,0,187921.176470588,2148.11764705882,89.6470588235294
"4034","14059","2021",64,18,46,414810.15625,5110.046875,70.984375
"4035","14060","2021",30,30,0,295754.233333333,2488.66666666667,123.033333333333
"4036","14061","2021",136,135,1,115604.235294118,1189.78676470588,100.639705882353
"4037","14062","2021",7,7,0,263972.857142857,2633,107.428571428571
"4038","14063","2021",2,2,0,115750,1278.5,98.5
"4039","14064","2021",1,1,0,154000,1730,89
"4040","14066","2021",73,54,19,208558.082191781,2996.78082191781,74.4109589041096
"4041","14068","2021",36,30,6,330111.666666667,2807.55555555556,121.25
"4042","14069","2021",17,17,0,153797.058823529,1675.58823529412,93.2941176470588
"4043","14070","2021",6,6,0,281666.666666667,3156.5,90.6666666666667
"4044","14076","2021",57,39,18,234338.859649123,2489.57894736842,94.1578947368421
"4045","14077","2021",13,13,0,318631.538461538,2503.38461538462,112
"4046","14078","2021",9,9,0,219283.333333333,1864.55555555556,117.777777777778
"4047","14079","2021",112,33,79,227525.642857143,3834.21428571429,56.5625
"4048","14080","2021",4,4,0,135275,2401,76.25
"4049","14082","2021",3,3,0,221300,1791,131
"4050","14083","2021",12,12,0,165769,2181.25,79.0833333333333
"4051","14084","2021",8,8,0,192531.25,1355.25,142.125
"4052","14085","2021",14,14,0,310010,2480.14285714286,120.714285714286
"4053","14086","2021",14,14,0,483317.857142857,3190,153.142857142857
"4054","14087","2021",1,1,0,149000,1274,117
"4055","14088","2021",6,6,0,217958.333333333,1910.16666666667,114
"4056","14089","2021",6,6,0,210443.333333333,2427.5,88.3333333333333
"4057","14090","2021",8,8,0,198512.5,1670.375,122.5
"4058","14091","2021",2,2,0,520375,3743.5,140.5
"4059","14092","2021",40,36,4,242226.25,2295.05,107.575
"4060","14093","2021",9,8,1,293786.666666667,2461.55555555556,118.111111111111
"4061","14096","2021",3,3,0,143306.666666667,1309.33333333333,128
"4062","14097","2021",3,3,0,144666.666666667,1727,81
"4063","14098","2021",61,59,2,235403.524590164,2254.95081967213,108.508196721311
"4064","14100","2021",18,17,1,184210.555555556,2044.33333333333,90.7222222222222
"4065","14101","2021",66,60,6,301719.803030303,2796.92424242424,107.272727272727
"4066","14102","2021",14,14,0,228014.285714286,2163.42857142857,110.285714285714
"4067","14103","2021",5,5,0,155370,1625.2,105.4
"4068","14104","2021",3,3,0,472166.666666667,3383,142.666666666667
"4069","14106","2021",7,7,0,315051.428571429,2845.71428571429,114.571428571429
"4070","14107","2021",6,6,0,168066.666666667,1515.83333333333,109.5
"4071","14110","2021",2,2,0,442237.5,3287,128.5
"4072","14111","2021",9,9,0,237500,2028.33333333333,124.777777777778
"4073","14116","2021",3,3,0,226666.666666667,2097.33333333333,111.333333333333
"4074","14117","2021",416,70,346,183646.252403846,4337.20913461538,42.4134615384615
"4075","14118","2021",2251,353,1898,180115.021323856,2873.81919147046,64.2687694358063
"4076","14119","2021",16,16,0,216769.8125,2177.3125,106.4375
"4077","14120","2021",15,15,0,160682.666666667,1649.66666666667,98.9333333333333
"4078","14121","2021",4,4,0,220529.75,1436.5,167.5
"4079","14122","2021",2,2,0,411075,1741,237.5
"4080","14123","2021",19,19,0,326122.473684211,2486.15789473684,132.578947368421
"4081","14124","2021",5,5,0,141600,1485.2,101.2
"4082","14125","2021",20,19,1,338440.6,2601.5,129.65
"4083","14126","2021",19,19,0,282986.842105263,2395.05263157895,113.578947368421
"4084","14127","2021",4,4,0,104500,1007.75,96.25
"4085","14131","2021",11,11,0,321977.272727273,3070.54545454545,119.181818181818
"4086","14132","2021",1,1,0,140000,1186,118
"4087","14134","2021",1,1,0,310600,2251,138
"4088","14135","2021",5,5,0,242060,1867.4,137.8
"4089","14136","2021",2,2,0,222050,2056.5,115.5
"4090","14137","2021",30,29,1,292858.033333333,3240.13333333333,93.6666666666667
"4091","14138","2021",4,4,0,138500,1061.25,132.75
"4092","14140","2021",8,8,0,120832.5,1177,104.375
"4093","14141","2021",1,1,0,238000,1967,121
"4094","14143","2021",40,40,0,139322.75,1412.175,95.925
"4095","14145","2021",9,9,0,202227.777777778,1870.88888888889,112.555555555556
"4096","14146","2021",1,1,0,80000,741,108
"4097","14147","2021",4,4,0,132487.5,1236.75,105
"4098","14149","2021",9,9,0,214860,2397.22222222222,92
"4099","14150","2021",23,23,0,181894.347826087,1644.52173913043,115
"4100","14159","2021",2,2,0,200740,1550,127.5
"4101","14160","2021",3,3,0,302200,2201,140
"4102","14161","2021",12,12,0,413334.166666667,3395.91666666667,120
"4103","14162","2021",28,28,0,131357.142857143,1358.46428571429,100.5
"4104","14163","2021",2,2,0,445250,3029,140
"4105","14165","2021",6,5,1,158066.666666667,2109.16666666667,79.5
"4106","14166","2021",36,33,3,285089.472222222,2893.47222222222,97.5833333333333
"4107","14167","2021",62,42,20,224849.758064516,2670.77419354839,85.5322580645161
"4108","14168","2021",3,3,0,123166.666666667,983.666666666667,97.6666666666667
"4109","14169","2021",3,3,0,197366.666666667,1520.66666666667,147.666666666667
"4110","14171","2021",1,1,0,49999,694,72
"4111","14172","2021",9,9,0,188361.111111111,2089.77777777778,93.7777777777778
"4112","14173","2021",8,8,0,221100,2102.5,114.375
"4113","14174","2021",88,71,17,95724.25,1077.26136363636,88.5568181818182
"4114","14175","2021",2,2,0,120000,1125,100
"4115","14177","2021",16,16,0,290812.5,2232.375,118.3125
"4116","14179","2021",2,2,0,113000,1558.5,61
"4117","14180","2021",1,1,0,215000,2471,87
"4118","14181","2021",79,51,28,198847.164556962,2531.12658227848,77.7215189873418
"4119","14182","2021",11,11,0,172029.090909091,1535.81818181818,105.454545454545
"4120","14183","2021",2,2,0,90000,832.5,100
"4121","14184","2021",1,1,0,248000,1699,146
"4122","14190","2021",2,2,0,193500,1933,103.5
"4123","14191","2021",227,51,176,156002.356828194,3089.44052863436,52.1541850220264
"4124","14193","2021",10,10,0,203605,1945.6,108.6
"4125","14194","2021",11,11,0,110126.363636364,1084.54545454545,98.6363636363636
"4126","14195","2021",6,6,0,202083.333333333,1662.33333333333,118
"4127","14196","2021",3,3,0,194538.333333333,1562.66666666667,128.333333333333
"4128","14197","2021",12,12,0,356128.833333333,2948.16666666667,123.5
"4129","14198","2021",3,3,0,280000,2759.33333333333,105.666666666667
"4130","14200","2021",28,27,1,170043.928571429,1969.32142857143,87.6428571428571
"4131","14202","2021",4,4,0,484250,3577.75,133.5
"4132","14203","2021",3,3,0,366166.666666667,2341.33333333333,166.333333333333
"4133","14204","2021",2,2,0,248210,2188,112
"4134","14205","2021",2,2,0,180500,1659,109.5
"4135","14206","2021",4,4,0,147000,1441,111.25
"4136","14207","2021",6,6,0,233125,2321.33333333333,101.333333333333
"4137","14209","2021",9,9,0,188366.666666667,1973.55555555556,98.3333333333333
"4138","14211","2021",5,5,0,120880,1475.4,80
"4139","14214","2021",2,2,0,192750,1885,102
"4140","14215","2021",17,17,0,220422.411764706,2396.82352941176,92.2941176470588
"4141","14216","2021",1,1,0,140000,1239,113
"4142","14218","2021",8,8,0,268231.25,2176.75,124.125
"4143","14220","2021",340,45,295,382655.385294118,5943.92058823529,61.5441176470588
"4144","14221","2021",41,32,9,226429.902439024,2549.92682926829,94.7560975609756
"4145","14223","2021",1,1,0,576000,2390,241
"4146","14224","2021",2,2,0,195000,1906,102.5
"4147","14225","2021",112,72,40,208219.464285714,3631.78571428571,60.2946428571429
"4148","14226","2021",19,19,0,154627.315789474,1453,105.684210526316
"4149","14227","2021",3,3,0,280500,2754,101.666666666667
"4150","14228","2021",77,57,20,268142.636363636,2930.42857142857,91.3376623376623
"4151","14229","2021",44,42,2,177837.022727273,2038.61363636364,85.8863636363636
"4152","14230","2021",6,6,0,253958.333333333,2208.5,117.5
"4153","14231","2021",5,5,0,312705.4,2575.2,129.6
"4154","14232","2021",2,2,0,305000,1974,156
"4155","14236","2021",6,6,0,206886.666666667,1964.83333333333,108.166666666667
"4156","14237","2021",9,9,0,277054.444444444,2116.33333333333,134
"4157","14238","2021",2,2,0,1048000,5656,176
"4158","14239","2021",3,3,0,114000,1467,93
"4159","14240","2021",6,6,0,156958.333333333,1552.83333333333,106.666666666667
"4160","14241","2021",12,12,0,240926.666666667,1922.75,128.416666666667
"4161","14242","2021",19,9,10,245918.421052632,2545.36842105263,99.7368421052632
"4162","14243","2021",35,20,15,280363.428571429,3000.77142857143,93.3714285714286
"4163","14244","2021",4,4,0,195097.5,1697.75,140
"4164","14245","2021",6,6,0,168233.333333333,1982.16666666667,85
"4165","14246","2021",12,12,0,208355.833333333,2259.33333333333,91
"4166","14248","2021",3,3,0,225833.333333333,2140.66666666667,110.666666666667
"4167","14249","2021",18,14,4,231308.888888889,2014.83333333333,115.444444444444
"4168","14250","2021",3,3,0,174433.333333333,2206,79.6666666666667
"4169","14251","2021",8,8,0,185917.5,2010.75,91.25
"4170","14252","2021",2,2,0,139995,1797.5,71.5
"4171","14254","2021",16,16,0,269881.25,2487.6875,110.9375
"4172","14256","2021",5,5,0,172498,1740.2,98.6
"4173","14257","2021",19,19,0,279601.263157895,2403.78947368421,118.421052631579
"4174","14258","2021",118,56,62,133607.033898305,1722.01694915254,81.2118644067797
"4175","14260","2021",4,4,0,242125,2087.25,111.75
"4176","14261","2021",13,13,0,387425.538461538,2638.92307692308,142.307692307692
"4177","14266","2021",23,23,0,234016.52173913,2362.65217391304,101.695652173913
"4178","14269","2021",5,5,0,562200,3115.8,185.8
"4179","14270","2021",8,8,0,173637.5,1553.875,105.125
"4180","14271","2021",69,41,28,219823.739130435,2719.21739130435,78.8115942028985
"4181","14272","2021",5,5,0,272600,1603,150.8
"4182","14273","2021",4,4,0,198200,2038.25,97.25
"4183","14274","2021",34,32,2,319685.117647059,2901.52941176471,111.941176470588
"4184","14275","2021",12,12,0,256045.416666667,2305.58333333333,111.5
"4185","14276","2021",4,4,0,181910,2359,77
"4186","14277","2021",25,25,0,221900.64,1986,115.64
"4187","14278","2021",12,12,0,206210.25,1914,111.333333333333
"4188","14280","2021",5,5,0,251700,2269,112.6
"4189","14281","2021",16,16,0,178336.25,1700.4375,106.6875
"4190","14282","2021",1,1,0,175000,1326,132
"4191","14283","2021",5,5,0,91880,1331.4,68.4
"4192","14284","2021",2,2,0,219200,1548,143.5
"4193","14286","2021",7,7,0,425241.428571429,2816.85714285714,150.285714285714
"4194","14287","2021",28,28,0,207039.285714286,2050.67857142857,106
"4195","14288","2021",14,14,0,281792.857142857,2400,124.428571428571
"4196","14289","2021",13,13,0,172557.692307692,1367.38461538462,129.153846153846
"4197","14290","2021",7,7,0,210170.714285714,1945.57142857143,120.428571428571
"4198","14291","2021",4,4,0,178775,1657.5,107.5
"4199","14293","2021",3,3,0,288233.333333333,2193,124.333333333333
"4200","14297","2021",12,12,0,248596.666666667,2255.91666666667,112.083333333333
"4201","14298","2021",1,1,0,177000,2269,78
"4202","14299","2021",18,18,0,307427.777777778,2715.38888888889,116
"4203","14300","2021",1,1,0,330000,2062,160
"4204","14301","2021",46,44,2,199399.282608696,2421.36956521739,83.2826086956522
"4205","14302","2021",7,7,0,484707.142857143,3915.57142857143,123.857142857143
"4206","14303","2021",16,16,0,175428.75,1772.8125,100.3125
"4207","14304","2021",19,19,0,385976.315789474,2818,135.842105263158
"4208","14305","2021",13,13,0,383757.692307692,2837.61538461538,125.769230769231
"4209","14306","2021",7,7,0,347392.857142857,3216.57142857143,110.428571428571
"4210","14308","2021",5,5,0,239915.6,2457.2,93.4
"4211","14309","2021",11,10,1,195907.272727273,2603.72727272727,83.3636363636364
"4212","14310","2021",8,8,0,152950,1700.125,95.875
"4213","14311","2021",11,11,0,211458.181818182,2179.90909090909,99
"4214","14312","2021",75,38,37,128385.28,1997.22666666667,64.92
"4215","14316","2021",5,5,0,431320,2965.4,137.2
"4216","14318","2021",7,7,0,286651.285714286,2525.42857142857,118
"4217","14319","2021",14,14,0,234825,2312.92857142857,102.928571428571
"4218","14320","2021",4,4,0,207347.5,1881.75,112.75
"4219","14322","2021",1,1,0,5e+05,2203,227
"4220","14325","2021",62,51,11,239724.209677419,2841.59677419355,90.2741935483871
"4221","14326","2021",11,11,0,262563.636363636,2127.45454545455,121.272727272727
"4222","14327","2021",306,78,228,136298.54248366,2018.33660130719,67.6830065359477
"4223","14328","2021",9,9,0,216633.444444444,2567,87
"4224","14329","2021",2,2,0,199290,1922.5,104
"4225","14332","2021",6,6,0,219000,1985,118.666666666667
"4226","14333","2021",182,88,94,237281.785714286,3299.69230769231,74.9340659340659
"4227","14334","2021",4,4,0,132775,1351,102.5
"4228","14335","2021",5,5,0,379950,2739,147.4
"4229","14336","2021",3,3,0,134166.666666667,1376,113.666666666667
"4230","14337","2021",2,2,0,501000,2971.5,154.5
"4231","14338","2021",184,56,128,210712.407608696,3587.1902173913,57.1902173913044
"4232","14341","2021",158,91,67,188786.53164557,2484.44936708861,77.7151898734177
"4233","14342","2021",58,54,4,128021.793103448,1363.5,93.7241379310345
"4234","14343","2021",2,2,0,194740,1036.5,179.5
"4235","14344","2021",1,1,0,338500,2489,136
"4236","14345","2021",11,11,0,122939.090909091,1310.54545454545,100.727272727273
"4237","14346","2021",10,10,0,179939,1791.8,101.8
"4238","14347","2021",11,11,0,148490.909090909,1504,101.181818181818
"4239","14349","2021",40,40,0,245206.425,2354.5,108.95
"4240","14352","2021",11,11,0,106998.181818182,919.909090909091,112.363636363636
"4241","14353","2021",3,3,0,143313.333333333,1557.33333333333,96
"4242","14354","2021",45,37,8,233537.666666667,2967.08888888889,85.9777777777778
"4243","14355","2021",16,16,0,276525,1829.5,153.1875
"4244","14357","2021",12,12,0,100686.166666667,1256.25,80.8333333333333
"4245","14358","2021",3,3,0,374983.333333333,3489,118
"4246","14360","2021",5,5,0,128222,1183.2,107.4
"4247","14362","2021",3,3,0,356513,3930.33333333333,89.6666666666667
"4248","14364","2021",5,5,0,210800,1593,128.4
"4249","14365","2021",50,42,8,278851.22,3224.58,89.42
"4250","14366","2021",365,137,228,130345.010958904,1695.92328767123,75.6712328767123
"4251","14367","2021",7,7,0,75942.8571428571,818.285714285714,104.571428571429
"4252","14368","2021",12,12,0,128566.083333333,1284.83333333333,95.5
"4253","14369","2021",6,6,0,176416.666666667,1556.33333333333,112.333333333333
"4254","14370","2021",43,43,0,150955.209302326,1589.72093023256,97.0930232558139
"4255","14371","2021",121,120,1,169187.595041322,1549.42975206612,105.090909090909
"4256","14374","2021",1,1,0,105000,2234,47
"4257","14375","2021",2,2,0,146500,1200.5,117
"4258","14377","2021",5,5,0,133960,2023.4,64.6
"4259","14378","2021",2,2,0,116861,1489,76
"4260","14379","2021",6,6,0,228816.666666667,1823.16666666667,126
"4261","14380","2021",2,2,0,216000,2270.5,95
"4262","14381","2021",1,1,0,150000,955,157
"4263","14383","2021",37,35,2,271394.081081081,2842.32432432432,97.0810810810811
"4264","14384","2021",67,47,20,254507.507462687,3005.11940298507,87.7164179104478
"4265","14385","2021",3,3,0,249233.333333333,2354.66666666667,107.666666666667
"4266","14389","2021",5,5,0,253480,1900,148.6
"4267","14390","2021",3,3,0,206666.666666667,1450.33333333333,161.333333333333
"4268","14391","2021",8,8,0,204811.25,1898.625,108.875
"4269","14393","2021",8,8,0,230506.25,2036.5,126.5
"4270","14394","2021",7,7,0,221300,2313.57142857143,102
"4271","14396","2021",14,14,0,294722.357142857,2381.71428571429,125.642857142857
"4272","14397","2021",3,3,0,301330,1817.33333333333,166
"4273","14398","2021",5,5,0,236300,2009,112
"4274","14399","2021",11,11,0,293117.727272727,2492.18181818182,110.545454545455
"4275","14400","2021",2,2,0,306500,2504.5,121.5
"4276","14401","2021",2,2,0,279105,2316,121.5
"4277","14402","2021",1,1,0,180000,1782,101
"4278","14403","2021",14,14,0,208931.071428571,1815.64285714286,119
"4279","14404","2021",3,3,0,185844.333333333,1544.66666666667,113.333333333333
"4280","14405","2021",3,3,0,251333.333333333,1709.33333333333,129.666666666667
"4281","14406","2021",13,13,0,273912.461538462,2138.76923076923,131.615384615385
"4282","14407","2021",24,23,1,444318.833333333,2954.04166666667,155.291666666667
"4283","14408","2021",33,28,5,173493.03030303,2231.45454545455,84.969696969697
"4284","14409","2021",92,45,47,222532.913043478,3767.33695652174,60.9239130434783
"4285","14410","2021",17,17,0,189213.529411765,2003.29411764706,92.6470588235294
"4286","14411","2021",6,6,0,98333.3333333333,1525.16666666667,72.5
"4287","14419","2021",6,6,0,330833.333333333,2615.66666666667,130.333333333333
"4288","14421","2021",8,8,0,147880.75,1512.75,96.625
"4289","14424","2021",3,3,0,165783.333333333,1366,120.666666666667
"4290","14425","2021",3,3,0,499516.666666667,4349.33333333333,108
"4291","14426","2021",6,6,0,372220.333333333,2983.83333333333,123
"4292","14427","2021",5,5,0,101360,1364.4,80.2
"4293","14430","2021",2,2,0,597820,5603,98.5
"4294","14431","2021",131,130,1,142864,1686.41221374046,87.4274809160305
"4295","14435","2021",3,3,0,197476.666666667,1755.66666666667,111.666666666667
"4296","14436","2021",5,5,0,194760,2109.4,90.8
"4297","14437","2021",137,70,67,171955.299270073,2488.63503649635,70.2773722627737
"4298","14438","2021",8,8,0,221231.125,2165.25,103.25
"4299","14439","2021",1,1,0,64000,533,120
"4300","14445","2021",2,2,0,235000,2170,115
"4301","14446","2021",2,2,0,291250,2444.5,127.5
"4302","14449","2021",3,3,0,300333.333333333,2615.33333333333,124
"4303","14452","2021",11,11,0,174390.909090909,1545.81818181818,107.090909090909
"4304","14453","2021",5,5,0,157973,1335.6,115.8
"4305","14454","2021",24,22,2,242230.625,2371.75,104.75
"4306","14455","2021",5,5,0,159500.8,1387,120.4
"4307","14456","2021",38,38,0,235637.894736842,2217.15789473684,106.710526315789
"4308","14457","2021",3,3,0,65000,1224,75.6666666666667
"4309","14458","2021",5,5,0,155865.4,1812,76.8
"4310","14460","2021",31,30,1,200844.838709677,2123.12903225806,95.9354838709677
"4311","14461","2021",5,5,0,231380,1956.2,114.8
"4312","14465","2021",7,7,0,240842.857142857,1698.14285714286,141.857142857143
"4313","14466","2021",1,1,0,294900,2979,99
"4314","14467","2021",1,1,0,176000,1615,109
"4315","14468","2021",9,9,0,150116.666666667,1475.66666666667,98
"4316","14469","2021",2,2,0,97500,1884,59
"4317","14473","2021",2,2,0,189000,2011,104
"4318","14474","2021",5,5,0,227030,2425.4,98.6
"4319","14475","2021",26,26,0,227940.423076923,2251.5,107.115384615385
"4320","14476","2021",2,2,0,140000,1345.5,112
"4321","14478","2021",40,38,2,112962.5,1219.75,92.8
"4322","14480","2021",5,5,0,167600,1489.6,114
"4323","14482","2021",4,4,0,289750,2019.25,139.5
"4324","14483","2021",4,4,0,153512.5,1810,87.75
"4325","14484","2021",3,3,0,210666.666666667,2024.33333333333,105.333333333333
"4326","14486","2021",4,4,0,120761,1514.25,88.25
"4327","14487","2021",12,12,0,233183.333333333,1843.08333333333,123
"4328","14488","2021",230,124,106,211598.17826087,3133.00869565217,70.4304347826087
"4329","14491","2021",4,4,0,290375,2053,143
"4330","14492","2021",2,2,0,558835,3079,184
"4331","14494","2021",5,5,0,414914,3001.8,156.2
"4332","14495","2021",6,6,0,362584.333333333,2869.16666666667,130.833333333333
"4333","14496","2021",2,2,0,87200,1047.5,88
"4334","14497","2021",4,4,0,168000,1911,91
"4335","14498","2021",7,7,0,121571.428571429,1316.85714285714,89.2857142857143
"4336","14499","2021",6,6,0,359002.833333333,2685.5,133.666666666667
"4337","14500","2021",3,3,0,742256.666666667,5003,139.333333333333
"4338","14501","2021",4,4,0,108000,1325.75,97.75
"4339","14502","2021",5,5,0,135200,1295,114.4
"4340","14504","2021",9,9,0,239332.888888889,1875.55555555556,130.222222222222
"4341","14506","2021",7,7,0,201021.428571429,1397,155.142857142857
"4342","14509","2021",4,4,0,444100,2679,173.25
"4343","14510","2021",2,2,0,109000,1393.5,88.5
"4344","14511","2021",4,4,0,168250,1543.25,107.75
"4345","14514","2021",57,39,18,214088.684210526,2572.91228070175,85.6140350877193
"4346","14515","2021",45,25,20,149181.422222222,2244.08888888889,70.0888888888889
"4347","14516","2021",32,32,0,136591.84375,1978.15625,74.28125
"4348","14519","2021",3,3,0,218916.666666667,1262.33333333333,170.666666666667
"4349","14520","2021",9,9,0,217766.666666667,2205.22222222222,101
"4350","14522","2021",6,6,0,270000,1914.33333333333,124.833333333333
"4351","14524","2021",5,5,0,259926.6,2045.8,145.6
"4352","14527","2021",11,11,0,290824.181818182,2460.36363636364,125.545454545455
"4353","14528","2021",5,5,0,177490,2524.4,76.2
"4354","14529","2021",3,3,0,160000,1640.33333333333,103
"4355","14530","2021",19,19,0,262481.421052632,2753.57894736842,97.3157894736842
"4356","14531","2021",2,2,0,52500,643,82.5
"4357","14533","2021",1,1,0,237500,2199,108
"4358","14534","2021",3,3,0,380333.333333333,2588.33333333333,146.666666666667
"4359","14535","2021",13,12,1,257254.615384615,2812.15384615385,90.7692307692308
"4360","14536","2021",45,33,12,203672.511111111,2320.2,86.3333333333333
"4361","14538","2021",29,27,2,238027.965517241,2300.06896551724,104.310344827586
"4362","14540","2021",4,4,0,398250,2885,132.75
"4363","14541","2021",4,4,0,184750,2038.5,90.25
"4364","14542","2021",8,8,0,341833.75,2504.75,138.875
"4365","14543","2021",34,34,0,321574.764705882,2444.20588235294,137.882352941176
"4366","14546","2021",3,3,0,110933.333333333,1198,87.3333333333333
"4367","14550","2021",2,2,0,290000,2648,112.5
"4368","14552","2021",8,8,0,229257.5,2065.75,114.375
"4369","14554","2021",19,19,0,221611.578947368,2432.63157894737,95
"4370","14555","2021",10,10,0,293856.8,2338,125.8
"4371","14556","2021",15,15,0,223154,2402.8,92.8666666666667
"4372","14557","2021",51,23,28,333507.098039216,3798.07843137255,82.7843137254902
"4373","14558","2021",15,14,1,286006,3097.6,100.066666666667
"4374","14559","2021",8,8,0,91687.5,971,94
"4375","14562","2021",70,47,23,255139.057142857,3239.15714285714,79.7142857142857
"4376","14563","2021",7,7,0,581575.285714286,2846,180.857142857143
"4377","14565","2021",10,10,0,198150,2868,81.9
"4378","14566","2021",18,18,0,307727.055555556,2509.55555555556,121.777777777778
"4379","14569","2021",1,1,0,175000,1577,111
"4380","14570","2021",34,34,0,162983.823529412,1446.52941176471,113.735294117647
"4381","14571","2021",8,8,0,166685.375,1854.625,97.25
"4382","14572","2021",15,15,0,102183.666666667,1339.06666666667,76.6
"4383","14574","2021",19,19,0,248492.105263158,2078,126.842105263158
"4384","14575","2021",10,10,0,504338.5,3485.3,131.7
"4385","14576","2021",8,8,0,190603.5,1361.875,155.375
"4386","14578","2021",27,27,0,378307.777777778,3087.2962962963,117.037037037037
"4387","14579","2021",11,11,0,172290.909090909,1738.72727272727,110.363636363636
"4388","14582","2021",9,9,0,142177.777777778,1678.88888888889,85.1111111111111
"4389","14586","2021",2,2,0,158350,1237.5,118
"4390","14587","2021",17,15,2,240354.705882353,2462.29411764706,99.4705882352941
"4391","14588","2021",5,5,0,173020,1689,108.6
"4392","14589","2021",17,17,0,176440.588235294,1765,100.941176470588
"4393","14590","2021",2,2,0,87500,767,115
"4394","14591","2021",8,8,0,194180.625,1626.875,124
"4395","14592","2021",16,16,0,269345,2378,120.125
"4396","14593","2021",16,16,0,378092.5,3127.8125,121.0625
"4397","14595","2021",4,4,0,175000,1795,103
"4398","14598","2021",2,2,0,293575,3262.5,86.5
"4399","14601","2021",2,2,0,215000,2082,104
"4400","14602","2021",5,5,0,134198,1764.6,87.6
"4401","14603","2021",4,4,0,209200,1742.25,124.75
"4402","14605","2021",10,10,0,322942,3121,110.8
"4403","14606","2021",7,7,0,271958.571428571,3369,85.1428571428571
"4404","14607","2021",3,3,0,206666.666666667,1684.33333333333,123.333333333333
"4405","14609","2021",3,3,0,257900,2292.66666666667,111
"4406","14610","2021",33,28,5,262038,2388.63636363636,114.545454545455
"4407","14613","2021",2,2,0,183025,1334,131.5
"4408","14614","2021",13,12,1,224679.230769231,1551,118.769230769231
"4409","14619","2021",3,3,0,89333.3333333333,1353,80
"4410","14620","2021",6,6,0,257005.833333333,1971.83333333333,141.833333333333
"4411","14621","2021",15,15,0,122851.333333333,1226.6,101.4
"4412","14622","2021",1,1,0,106000,646,164
"4413","14623","2021",35,33,2,209752.8,2331.91428571429,91.6285714285714
"4414","14625","2021",4,4,0,168500,1874.75,88.5
"4415","14626","2021",12,12,0,172979.166666667,1903.58333333333,89.5833333333333
"4416","14627","2021",3,3,0,196843.333333333,1828.66666666667,108
"4417","14630","2021",4,4,0,275272.5,2488.5,121.25
"4418","14635","2021",1,1,0,375030,2451,153
"4419","14637","2021",5,5,0,160600,1947.8,78.2
"4420","14639","2021",4,4,0,189850,1568.75,122.75
"4421","14640","2021",4,4,0,300850,2161.25,141.25
"4422","14643","2021",15,15,0,207000.866666667,1892.26666666667,111.066666666667
"4423","14644","2021",17,17,0,214900.294117647,1922.29411764706,115.647058823529
"4424","14645","2021",10,10,0,385259,3529,113.4
"4425","14646","2021",1,1,0,268000,1595,168
"4426","14648","2021",4,4,0,220612.5,2211.75,105.25
"4427","14649","2021",4,4,0,168700,1679.75,104.75
"4428","14650","2021",3,3,0,183623.333333333,1634,112
"4429","14651","2021",4,4,0,372887.5,3127.75,132.5
"4430","14654","2021",104,101,3,158832.086538462,1681.95192307692,95.7307692307692
"4431","14656","2021",24,23,1,119852.208333333,1337.25,90.25
"4432","14657","2021",3,3,0,206433.333333333,1645.33333333333,126
"4433","14658","2021",63,63,0,111766.936507937,1074.96825396825,103.777777777778
"4434","14659","2021",29,29,0,179074.896551724,2042.55172413793,89.4137931034483
"4435","14660","2021",2,2,0,410000,2503,164
"4436","14661","2021",1,1,0,270000,900,300
"4437","14663","2021",23,20,3,220730.434782609,2395.82608695652,98.3913043478261
"4438","14664","2021",3,3,0,192263.333333333,1688.33333333333,104.666666666667
"4439","14665","2021",9,9,0,286529.333333333,2593.22222222222,106
"4440","14666","2021",18,18,0,258514.722222222,2577.88888888889,106.388888888889
"4441","14667","2021",3,3,0,194000,2281.33333333333,88.3333333333333
"4442","14668","2021",5,5,0,182340,1585.4,117.4
"4443","14669","2021",6,6,0,166583.333333333,1104,160.833333333333
"4444","14672","2021",11,11,0,157154.545454545,1307.72727272727,118
"4445","14674","2021",4,4,0,224372.5,2237.25,101
"4446","14675","2021",23,23,0,240078.695652174,2360.17391304348,106.130434782609
"4447","14676","2021",15,15,0,252151.666666667,2164.06666666667,128.666666666667
"4448","14677","2021",6,6,0,300750,2523.83333333333,109.333333333333
"4449","14678","2021",8,8,0,230087.5,1729.625,133.125
"4450","14679","2021",6,6,0,197993.333333333,2017.16666666667,101
"4451","14680","2021",5,5,0,318920,2708.8,106.4
"4452","14681","2021",1,1,0,235000,1567,150
"4453","14682","2021",11,11,0,342734.727272727,2642.72727272727,138.181818181818
"4454","14685","2021",21,20,1,273790,2329.71428571429,116.571428571429
"4455","14687","2021",3,3,0,400666.666666667,3359.66666666667,123
"4456","14689","2021",58,55,3,162730.344827586,1727.58620689655,99.8965517241379
"4457","14692","2021",20,20,0,208783,2075.7,104.35
"4458","14694","2021",7,7,0,282778.571428571,2467.57142857143,116
"4459","14698","2021",4,4,0,275750,2409,114.75
"4460","14699","2021",106,39,67,231798.867924528,3318.05660377358,67.9716981132076
"4461","14700","2021",9,9,0,224137.777777778,2035,111.777777777778
"4462","14701","2021",94,18,76,397166.638297872,5134.07446808511,74.5851063829787
"4463","14705","2021",2,2,0,258689,1375,175.5
"4464","14706","2021",3,3,0,150434,1571.66666666667,91.6666666666667
"4465","14707","2021",5,5,0,274960,2221.4,126
"4466","14708","2021",4,4,0,336125,2093.5,158.75
"4467","14709","2021",8,8,0,298825,2479.125,122.75
"4468","14710","2021",1,1,0,173000,1518,114
"4469","14711","2021",13,12,1,185107.692307692,1733.76923076923,119.923076923077
"4470","14712","2021",46,44,2,202435.869565217,2262.15217391304,92.8913043478261
"4471","14713","2021",10,10,0,255262,2446.8,123.9
"4472","14714","2021",11,11,0,174159.090909091,1664.18181818182,107.454545454545
"4473","14715","2021",349,112,237,245892.570200573,4729.52722063037,53.3151862464183
"4474","14719","2021",15,14,1,216440,1955.53333333333,112.4
"4475","14720","2021",14,14,0,156440,1370.07142857143,122.428571428571
"4476","14721","2021",7,7,0,269512.857142857,1779.42857142857,153.857142857143
"4477","14723","2021",3,3,0,239533.333333333,2059,116.666666666667
"4478","14724","2021",26,7,19,207205.769230769,3625.30769230769,60.6923076923077
"4479","14726","2021",92,92,0,113743.304347826,1047.16304347826,104.097826086957
"4480","14728","2021",4,4,0,219950,1608.75,145
"4481","14731","2021",7,7,0,1172995.14285714,5567.28571428571,206.714285714286
"4482","14732","2021",3,3,0,237133.333333333,1707.33333333333,135.333333333333
"4483","14733","2021",6,6,0,351726.666666667,1816,174.666666666667
"4484","14734","2021",4,4,0,186250,1802.25,101.75
"4485","14735","2021",10,10,0,168166,2249.9,91.1
"4486","14737","2021",6,6,0,220248.333333333,1849.66666666667,121.166666666667
"4487","14738","2021",56,48,8,252762.946428571,2587.94642857143,101.857142857143
"4488","14739","2021",30,30,0,302165.333333333,2656.5,113.766666666667
"4489","14740","2021",28,28,0,141098.75,1531.07142857143,96.1785714285714
"4490","14741","2021",2,2,0,58000,1435,39.5
"4491","14742","2021",4,4,0,121200,1045.75,127.5
"4492","14744","2021",3,3,0,253066.666666667,2042.66666666667,122.333333333333
"4493","14745","2021",12,12,0,193908.333333333,1807.83333333333,112.666666666667
"4494","14747","2021",10,10,0,263968,2463.5,105.7
"4495","14748","2021",3,3,0,607376.333333333,3641.66666666667,164.666666666667
"4496","14751","2021",3,3,0,113966.666666667,1194,93.6666666666667
"4497","14752","2021",25,21,4,190069.6,2203.88,93.24
"4498","14753","2021",7,7,0,272707.857142857,2001.28571428571,138.142857142857
"4499","14754","2021",385,55,330,155435.132467532,3794.66233766234,41.1220779220779
"4500","14755","2021",33,27,6,424718.757575758,4161.48484848485,88.8181818181818
"4501","14756","2021",2,2,0,130500,1226,101.5
"4502","14758","2021",7,7,0,429190,2612.42857142857,166.428571428571
"4503","14759","2021",5,5,0,213020,1600.2,128
"4504","14760","2021",8,8,0,217818.75,1770.5,120.875
"4505","14761","2021",15,14,1,203026,2235.93333333333,93.8666666666667
"4506","14762","2021",218,158,60,132983.440366972,1410.33944954128,95.9587155963303
"4507","14764","2021",25,24,1,118588.2,1310.92,92.04
"4508","15001","2021",12,9,3,103010.416666667,1085.41666666667,101.75
"4509","15002","2021",3,3,0,57123.3333333333,1009.33333333333,56.6666666666667
"4510","15003","2021",9,9,0,106063.333333333,1097.33333333333,101.222222222222
"4511","15004","2021",1,1,0,111750,1596,70
"4512","15005","2021",1,1,0,170800,3105,55
"4513","15006","2021",13,12,1,97659.2307692308,1079.92307692308,86.9230769230769
"4514","15008","2021",6,6,0,64333.3333333333,908.166666666667,73.5
"4515","15009","2021",3,3,0,122766.666666667,1206,107.333333333333
"4516","15010","2021",4,4,0,98600,1104,91
"4517","15011","2021",2,2,0,55000,826,71
"4518","15012","2021",84,56,28,134972.583333333,1520.13095238095,87.4523809523809
"4519","15013","2021",3,3,0,55000,760.666666666667,73
"4520","15014","2021",508,114,394,103007.627952756,1382.72637795276,74.3641732283465
"4521","15015","2021",5,5,0,89009.6,1048.4,88.4
"4522","15016","2021",10,10,0,138355,1371.5,99.5
"4523","15017","2021",3,3,0,174850,1556,110.333333333333
"4524","15018","2021",1,1,0,230000,1575,146
"4525","15019","2021",4,4,0,108992.5,979.25,111.75
"4526","15020","2021",5,5,0,90100,1410.4,68.8
"4527","15021","2021",9,9,0,99120,1022.11111111111,100.555555555556
"4528","15022","2021",1,1,0,190950,2031,94
"4529","15024","2021",3,3,0,62000,1512.33333333333,56.6666666666667
"4530","15025","2021",3,2,1,148140,1727.33333333333,95.6666666666667
"4531","15026","2021",3,2,1,41000,1230.33333333333,34
"4532","15027","2021",12,12,0,140286.583333333,1408.41666666667,101.333333333333
"4533","15028","2021",3,3,0,138816.666666667,1599.66666666667,85
"4534","15029","2021",5,5,0,110298,1564.8,78.6
"4535","15030","2021",3,3,0,100723,1748,65.6666666666667
"4536","15032","2021",2,2,0,93700,668,135.5
"4537","15033","2021",4,3,1,78625,826.25,91.25
"4538","15034","2021",4,3,1,110815,1457,83.5
"4539","15036","2021",9,8,1,90655.5555555556,884.777777777778,93.8888888888889
"4540","15037","2021",10,9,1,107011.5,1271.9,89.4
"4541","15038","2021",18,18,0,122486.111111111,1242.94444444444,105.111111111111
"4542","15040","2021",1,1,0,84700,1129,75
"4543","15042","2021",6,6,0,76250,827.166666666667,83.3333333333333
"4544","15043","2021",1,1,0,75860,892,85
"4545","15045","2021",8,4,4,55218.75,819.625,72.5
"4546","15046","2021",3,3,0,106007.333333333,931.666666666667,108
"4547","15048","2021",1,1,0,152900,1699,90
"4548","15049","2021",14,14,0,86747.8571428571,1151.64285714286,82.5714285714286
"4549","15050","2021",7,5,2,84927.1428571429,1295.42857142857,70.4285714285714
"4550","15051","2021",3,3,0,51733.3333333333,548,93.3333333333333
"4551","15052","2021",2,2,0,54595,571,89.5
"4552","15053","2021",3,3,0,136666.666666667,1362.33333333333,96.3333333333333
"4553","15054","2021",23,20,3,151863.913043478,1832.08695652174,91.0869565217391
"4554","15055","2021",3,3,0,190416.666666667,1338.33333333333,138.333333333333
"4555","15056","2021",10,10,0,188773,1542.4,143
"4556","15057","2021",2,2,0,104875,856,129
"4557","15058","2021",3,3,0,148400,1547.33333333333,101.333333333333
"4558","15059","2021",2,2,0,86750,868,92.5
"4559","15061","2021",8,7,1,88150,1317.875,81.25
"4560","15063","2021",3,3,0,51750,788.333333333333,70.6666666666667
"4561","15066","2021",4,3,1,42250,774.25,56.25
"4562","15067","2021",2,2,0,69000,1284,52
"4563","15069","2021",6,6,0,112606.666666667,993,114
"4564","15070","2021",4,4,0,128875,975,126.25
"4565","15072","2021",7,7,0,108071.428571429,1418.71428571429,80
"4566","15073","2021",4,4,0,118000,1233.25,100.25
"4567","15074","2021",4,4,0,155790,1650,99.25
"4568","15075","2021",2,2,0,144450,1181,122.5
"4569","15076","2021",3,3,0,44513.3333333333,353.666666666667,125
"4570","15077","2021",1,1,0,196000,1400,140
"4571","15078","2021",4,4,0,98000,943,96.5
"4572","15079","2021",3,3,0,91000,1331.66666666667,68.3333333333333
"4573","15080","2021",7,7,0,88900,993.714285714286,87.7142857142857
"4574","15081","2021",1,1,0,105260,1053,100
"4575","15082","2021",4,4,0,155375,1522.75,100
"4576","15083","2021",30,30,0,135456,1462.63333333333,96.2666666666667
"4577","15085","2021",7,7,0,122768.571428571,1394.85714285714,87
"4578","15086","2021",4,3,1,106410,936.25,105.5
"4579","15087","2021",2,2,0,135750,1289,104
"4580","15088","2021",10,10,0,81984.8,1011.6,83.1
"4581","15089","2021",7,7,0,125000,2351.85714285714,65.1428571428571
"4582","15090","2021",11,11,0,149977.272727273,1441,108.181818181818
"4583","15091","2021",1,1,0,66000,943,70
"4584","15092","2021",19,19,0,147523.684210526,1337.78947368421,109.210526315789
"4585","15093","2021",1,1,0,42250,469,90
"4586","15094","2021",10,9,1,96567.7,1082.7,93.4
"4587","15095","2021",4,4,0,79250,922.25,89
"4588","15096","2021",1,1,0,105000,2059,51
"4589","15097","2021",4,4,0,70225,844,89
"4590","15098","2021",2,2,0,96365,1218.5,90.5
"4591","15100","2021",1,1,0,109300,1301,84
"4592","15101","2021",55,8,47,90891.1636363636,2419.14545454545,40.5818181818182
"4593","15102","2021",1,1,0,113000,1329,85
"4594","15103","2021",4,4,0,222250,1880,127.25
"4595","15104","2021",6,6,0,42956.6666666667,688,62
"4596","15106","2021",6,6,0,89827,888,97.3333333333333
"4597","15107","2021",4,4,0,68512.5,1285.75,58.25
"4598","15108","2021",11,9,2,135606.363636364,2009.45454545455,84.1818181818182
"4599","15110","2021",1,1,0,82000,683,120
"4600","15111","2021",5,5,0,181686,1695,119.8
"4601","15112","2021",1,1,0,40000,506,79
"4602","15113","2021",6,6,0,96385,1751.33333333333,68.3333333333333
"4603","15114","2021",12,11,1,83583.4166666667,841.833333333333,99.9166666666667
"4604","15116","2021",5,5,0,83700,827.2,101.2
"4605","15117","2021",11,11,0,131753.636363636,1500.90909090909,89.2727272727273
"4606","15118","2021",14,14,0,150489.285714286,1217,119.214285714286
"4607","15119","2021",27,26,1,96262.5925925926,1066.7037037037,95.8888888888889
"4608","15120","2021",41,27,14,100557.024390244,1057.14634146341,90.8780487804878
"4609","15121","2021",1,1,0,45000,562,80
"4610","15122","2021",28,28,0,101535.642857143,1318.85714285714,75.0357142857143
"4611","15123","2021",1,1,0,40600,541,75
"4612","15124","2021",17,16,1,102205.235294118,942.294117647059,104.294117647059
"4613","15126","2021",3,3,0,54333.3333333333,733,82.3333333333333
"4614","15127","2021",8,8,0,84534,998.125,83.75
"4615","15128","2021",3,3,0,110666.666666667,1805.33333333333,78.3333333333333
"4616","15129","2021",4,4,0,80102.5,1139.75,66.5
"4617","15130","2021",5,5,0,70738,996.4,77.4
"4618","15131","2021",4,4,0,100325,1003,103.5
"4619","15132","2021",1,1,0,35000,438,80
"4620","15133","2021",1,1,0,40000,667,60
"4621","15134","2021",11,11,0,89483.6363636364,1541.45454545455,84.8181818181818
"4622","15135","2021",1,1,0,110000,1222,90
"4623","15137","2021",6,6,0,113000,1142.5,102.166666666667
"4624","15138","2021",26,18,8,111350.769230769,1180.34615384615,89.0769230769231
"4625","15139","2021",1,1,0,65000,691,94
"4626","15140","2021",27,27,0,178671.37037037,1848.40740740741,97.6296296296296
"4627","15141","2021",26,24,2,108973.846153846,1124.03846153846,107.730769230769
"4628","15142","2021",19,19,0,91856.8421052632,912.842105263158,92.6842105263158
"4629","15143","2021",1,1,0,160820,1087,148
"4630","15144","2021",4,4,0,272828.5,1753,143.5
"4631","15146","2021",2,2,0,109160,1436,75
"4632","15147","2021",5,5,0,172502,1656.8,106.4
"4633","15148","2021",6,6,0,128650,1117.83333333333,114.666666666667
"4634","15149","2021",7,7,0,92028.5714285714,1077.57142857143,90.8571428571429
"4635","15151","2021",6,6,0,42483.3333333333,645,69
"4636","15152","2021",9,9,0,129622.777777778,1250.55555555556,98.6666666666667
"4637","15153","2021",39,37,2,93352.7948717949,1007.53846153846,99.8974358974359
"4638","15154","2021",13,12,1,108212.307692308,1214.69230769231,90.5384615384615
"4639","15155","2021",1,1,0,40000,1000,40
"4640","15156","2021",6,6,0,149235,1568.83333333333,98
"4641","15157","2021",2,2,0,164350,1230,156.5
"4642","15158","2021",3,3,0,69100,1196.33333333333,59
"4643","15159","2021",3,3,0,146666.666666667,1460.66666666667,92
"4644","15160","2021",8,8,0,127005.75,1386.25,88.25
"4645","15161","2021",1,1,0,115000,548,210
"4646","15162","2021",40,26,14,79991.35,1058.15,80.7
"4647","15163","2021",6,6,0,152033.333333333,1490.33333333333,102.5
"4648","15164","2021",3,3,0,134003.333333333,2015.33333333333,78.6666666666667
"4649","15165","2021",3,3,0,183996.666666667,1631,96
"4650","15166","2021",3,3,0,143466.666666667,1249,115.333333333333
"4651","15167","2021",1,1,0,65000,433,150
"4652","15168","2021",6,3,3,101136,1472,69
"4653","15169","2021",18,18,0,90813.8888888889,982.222222222222,96.2777777777778
"4654","15170","2021",5,5,0,64200,821,80.6
"4655","15172","2021",1,1,0,114950,1948,59
"4656","15173","2021",4,4,0,71827.5,937,65.75
"4657","15174","2021",5,5,0,139470,1112.4,135
"4658","15175","2021",9,9,0,91211.4444444444,1240.88888888889,75.4444444444444
"4659","15176","2021",5,5,0,66100,722,92.2
"4660","15178","2021",2,2,0,103500,1214,79
"4661","15179","2021",6,6,0,153250,1153.16666666667,126
"4662","15180","2021",2,2,0,107020,1255,81.5
"4663","15181","2021",4,4,0,92977,936.75,104
"4664","15182","2021",1,1,0,115215,1694,68
"4665","15184","2021",10,9,1,168105.7,1590.2,109.4
"4666","15185","2021",4,4,0,88000,1637.25,67.25
"4667","15186","2021",3,3,0,90000,962.666666666667,88.3333333333333
"4668","15187","2021",53,25,28,114499.79245283,1630.66037735849,77.9811320754717
"4669","15188","2021",11,11,0,130882.272727273,1184.54545454545,106.636363636364
"4670","15189","2021",10,10,0,129124,1568.9,84.8
"4671","15190","2021",3,3,0,82983.3333333333,982.333333333333,73.3333333333333
"4672","15191","2021",13,13,0,111125.384615385,1144.30769230769,94.7692307692308
"4673","15192","2021",10,6,4,111927.5,1533.6,80.4
"4674","15196","2021",16,15,1,166928.75,1525.0625,114.375
"4675","15199","2021",1,1,0,110160,644,171
"4676","15200","2021",3,3,0,78583.3333333333,934.666666666667,82.3333333333333
"4677","15201","2021",2,2,0,47500,531,90
"4678","15202","2021",9,9,0,86697.2222222222,1006.66666666667,92.8888888888889
"4679","15203","2021",4,3,1,110810,1753.25,73.75
"4680","15204","2021",23,23,0,142646.173913043,1521.13043478261,91.695652173913
"4681","15205","2021",1,1,0,73000,1377,53
"4682","15206","2021",1,1,0,235000,1335,176
"4683","15207","2021",3,3,0,92083.3333333333,1061.33333333333,83.6666666666667
"4684","15208","2021",6,6,0,72593.3333333333,1309.83333333333,65.1666666666667
"4685","15209","2021",1,1,0,95000,2639,36
"4686","15211","2021",2,2,0,21500,523,41
"4687","15212","2021",3,3,0,120000,1003.66666666667,111.666666666667
"4688","15213","2021",4,4,0,97650,1051.5,105.25
"4689","15214","2021",1,1,0,163000,1734,94
"4690","15215","2021",13,13,0,149860.307692308,1407,110.846153846154
"4691","15216","2021",4,4,0,95250,1570.75,67.75
"4692","15217","2021",1,1,0,77000,939,82
"4693","15218","2021",2,2,0,37500,919,41
"4694","15219","2021",7,5,2,116214.285714286,1714.85714285714,93.2857142857143
"4695","15221","2021",13,12,1,175319.230769231,1767.30769230769,102.615384615385
"4696","15222","2021",2,2,0,107575,913,126
"4697","15223","2021",5,5,0,94300,870.8,104
"4698","15224","2021",4,4,0,87625,1063.5,79.5
"4699","15225","2021",3,3,0,101200,1748.66666666667,69.3333333333333
"4700","15226","2021",3,3,0,128000,1858.33333333333,76
"4701","15228","2021",4,4,0,186281.25,1107.25,143.25
"4702","15229","2021",1,1,0,190000,1267,150
"4703","15231","2021",5,5,0,97226,975.4,99.8
"4704","15232","2021",2,2,0,113700,1064,109.5
"4705","15233","2021",2,2,0,192100,1954,98
"4706","15234","2021",1,1,0,167000,1777,94
"4707","15235","2021",8,8,0,106468.75,1134.875,94.875
"4708","15236","2021",14,14,0,129007.142857143,1625.42857142857,79.1428571428571
"4709","15237","2021",1,1,0,187500,2259,83
"4710","15238","2021",4,4,0,82600,931,94.25
"4711","15240","2021",7,5,2,77780.7142857143,1330.28571428571,56
"4712","15241","2021",2,2,0,121500,853,120
"4713","15242","2021",2,2,0,90350,1116,90.5
"4714","15243","2021",12,12,0,117054.166666667,1031.5,106.416666666667
"4715","15244","2021",7,7,0,105405.714285714,1194.71428571429,91
"4716","15245","2021",1,1,0,80000,2500,32
"4717","15246","2021",2,2,0,79000,1108.5,90
"4718","15247","2021",1,1,0,41200,458,90
"4719","15248","2021",10,10,0,90735,887,100.3
"4720","15249","2021",5,5,0,54260,660.6,84
"4721","15250","2021",10,10,0,73957,937.7,80.9
"4722","15251","2021",4,4,0,118415,1355.5,93.25
"4723","15252","2021",9,9,0,139084.222222222,1490.77777777778,89.3333333333333
"4724","15253","2021",2,2,0,76650,1385.5,65
"4725","15254","2021",1,1,0,140000,2222,63
"4726","15255","2021",14,14,0,131468.571428571,1457.28571428571,90.9285714285714
"4727","15258","2021",23,14,9,97351,1262.60869565217,77.8260869565217
"4728","15259","2021",1,1,0,237000,4086,58
"4729","15260","2021",5,5,0,106980,944.8,116.4
"4730","15261","2021",11,11,0,123513.636363636,1424.90909090909,87.0909090909091
"4731","15262","2021",2,2,0,102000,1102.5,94
"4732","15263","2021",3,3,0,57933.3333333333,682.666666666667,74.3333333333333
"4733","15264","2021",2,2,0,245250,1178,203.5
"4734","15265","2021",24,23,1,68647.0833333333,796.291666666667,92.75
"4735","15266","2021",8,8,0,125401.5,1317,99.25
"4736","15267","2021",42,42,0,170468.785714286,1543.7619047619,113.52380952381
"4737","15268","2021",8,7,1,98650,1429.5,83.125
"4738","15269","2021",3,3,0,86333.3333333333,1009.33333333333,78.3333333333333
"4739","16001","2021",8,8,0,106399.875,1249,82.75
"4740","16002","2021",11,11,0,96203.6363636364,932.636363636364,103.272727272727
"4741","16003","2021",13,13,0,140146.153846154,1339.61538461538,113.384615384615
"4742","16005","2021",29,29,0,111253.965517241,1029.20689655172,109.241379310345
"4743","16007","2021",11,11,0,143250,983.090909090909,141.818181818182
"4744","16008","2021",9,9,0,131142.777777778,1007.77777777778,117.111111111111
"4745","16009","2021",6,6,0,108375,900,117.833333333333
"4746","16011","2021",9,9,0,188016.666666667,1446.22222222222,129.555555555556
"4747","16012","2021",4,4,0,148954.5,1203,123.5
"4748","16013","2021",5,5,0,196500,1420,133
"4749","16014","2021",3,3,0,95000,811.666666666667,108.666666666667
"4750","16015","2021",823,515,308,133887.341433779,1663.62575941677,81.3487241798299
"4751","16016","2021",11,11,0,97750,860.454545454545,107
"4752","16018","2021",10,10,0,237915,1606.7,145
"4753","16019","2021",16,16,0,126404.375,1308.625,94.75
"4754","16020","2021",15,15,0,119582.8,1312.33333333333,93.6
"4755","16023","2021",14,14,0,112800,1136.07142857143,102.357142857143
"4756","16024","2021",9,9,0,115611.111111111,1479.66666666667,83.6666666666667
"4757","16025","2021",23,23,0,176622.608695652,1813.60869565217,112.260869565217
"4758","16026","2021",19,19,0,164285.421052632,1542.78947368421,106.473684210526
"4759","16027","2021",3,3,0,117676,904,145
"4760","16028","2021",74,68,6,135875.027027027,1349.08108108108,107.648648648649
"4761","16029","2021",4,4,0,196288.75,1214,171.25
"4762","16030","2021",10,10,0,168780.3,1474.7,114.2
"4763","16031","2021",6,6,0,152334.833333333,1031,144.166666666667
"4764","16032","2021",4,4,0,147500,1125,125.5
"4765","16034","2021",6,6,0,90083.3333333333,844.5,113.666666666667
"4766","16035","2021",9,9,0,94692.7777777778,805.333333333333,115.777777777778
"4767","16036","2021",5,5,0,126440,1058.4,117.2
"4768","16037","2021",4,4,0,225518,1340.75,163
"4769","16038","2021",12,12,0,105857.833333333,894.083333333333,115.333333333333
"4770","16039","2021",1,1,0,61000,709,86
"4771","16040","2021",3,3,0,228061.666666667,1625.33333333333,153.333333333333
"4772","16041","2021",2,2,0,175000,1560,106
"4773","16042","2021",7,7,0,72693.5714285714,629.142857142857,113.142857142857
"4774","16044","2021",2,2,0,217675,1391,151
"4775","16046","2021",13,13,0,131161.538461538,1005.38461538462,120.307692307692
"4776","16047","2021",4,4,0,159200,1472.25,107.75
"4777","16048","2021",1,1,0,95000,1188,80
"4778","16049","2021",13,13,0,227621.153846154,1499.92307692308,146.307692307692
"4779","16050","2021",4,4,0,239038.25,1819.25,112.75
"4780","16052","2021",3,3,0,102866.666666667,1090.66666666667,93.6666666666667
"4781","16053","2021",2,2,0,94000,879,90
"4782","16054","2021",5,5,0,124610.2,1214,107.6
"4783","16055","2021",14,14,0,141221.428571429,1394.92857142857,103
"4784","16056","2021",12,12,0,148916.666666667,1251,115
"4785","16057","2021",5,5,0,225400,1276.6,139.8
"4786","16058","2021",27,27,0,188742.407407407,1669.62962962963,114.851851851852
"4787","16059","2021",3,3,0,84666.6666666667,922.666666666667,92.3333333333333
"4788","16060","2021",7,7,0,115642.857142857,1062.42857142857,114.285714285714
"4789","16061","2021",43,43,0,168649.465116279,1484.6976744186,116
"4790","16062","2021",2,2,0,124500,1009.5,116
"4791","16063","2021",6,6,0,133306.166666667,1015.66666666667,123.5
"4792","16064","2021",16,16,0,104334.6875,1215.125,88.75
"4793","16065","2021",11,11,0,97063.4545454545,1054,104.454545454545
"4794","16066","2021",18,18,0,115983.277777778,1110.66666666667,101.555555555556
"4795","16067","2021",5,5,0,145591.8,1413.6,104.6
"4796","16068","2021",11,11,0,98473.1818181818,981,103.272727272727
"4797","16069","2021",4,4,0,117050,1705,64.75
"4798","16070","2021",49,48,1,82160.0408163265,885.102040816327,92.6530612244898
"4799","16071","2021",12,12,0,132540,1563,85.1666666666667
"4800","16072","2021",6,6,0,190688.666666667,1455.33333333333,128.666666666667
"4801","16073","2021",32,31,1,136400.625,1297.4375,104.34375
"4802","16074","2021",6,6,0,147160.833333333,970,146
"4803","16075","2021",4,4,0,127525,1369.25,99
"4804","16076","2021",20,20,0,112804.8,1120.4,96.75
"4805","16077","2021",7,7,0,243091.142857143,1756,129.142857142857
"4806","16078","2021",68,67,1,174455.029411765,1658.36764705882,106.323529411765
"4807","16079","2021",6,6,0,144150,1418.66666666667,112.5
"4808","16081","2021",8,8,0,113341,977.375,113.75
"4809","16082","2021",9,9,0,116983.222222222,865.777777777778,145.888888888889
"4810","16083","2021",12,12,0,111661.5,982.25,108.666666666667
"4811","16084","2021",9,8,1,117600,1505.11111111111,83.3333333333333
"4812","16085","2021",47,47,0,118121.29787234,1156.85106382979,99.4893617021277
"4813","16086","2021",18,18,0,112752.444444444,1177.55555555556,98.7222222222222
"4814","16087","2021",5,5,0,177204.6,1029.4,181.8
"4815","16088","2021",15,15,0,184318.8,1417.73333333333,133.8
"4816","16089","2021",60,59,1,171482.183333333,1757.28333333333,105.883333333333
"4817","16090","2021",55,53,2,128085.090909091,1164.43636363636,109.418181818182
"4818","16091","2021",3,3,0,153333.333333333,1222,120.666666666667
"4819","16093","2021",29,29,0,140265.896551724,1324.31034482759,105.551724137931
"4820","16095","2021",3,3,0,335900,2011.66666666667,145.333333333333
"4821","16096","2021",8,8,0,79500,1241.75,89.875
"4822","16097","2021",38,37,1,143514.842105263,1350.13157894737,106.236842105263
"4823","16098","2021",1,1,0,141000,1306,108
"4824","16099","2021",3,3,0,187500,1040.33333333333,184.666666666667
"4825","16100","2021",13,13,0,86730.7692307692,904.076923076923,93.5384615384615
"4826","16101","2021",9,9,0,171917.777777778,1482.66666666667,127.444444444444
"4827","16102","2021",406,303,103,146380.4408867,1679.99507389163,88.0911330049261
"4828","16103","2021",4,4,0,70398.75,735.5,94.5
"4829","16104","2021",9,9,0,137444.444444444,1165.44444444444,118
"4830","16105","2021",7,7,0,137685.714285714,1009.28571428571,141.285714285714
"4831","16106","2021",57,54,3,92216.2631578947,1006.59649122807,95.3859649122807
"4832","16107","2021",8,8,0,132956.25,1442.75,103.125
"4833","16108","2021",5,5,0,144570,921.4,159.2
"4834","16109","2021",12,12,0,153902.583333333,1351.66666666667,116.333333333333
"4835","16110","2021",17,17,0,121513.352941176,1024.17647058824,118
"4836","16111","2021",3,3,0,79333.3333333333,629,120.666666666667
"4837","16112","2021",1,1,0,41000,532,77
"4838","16113","2021",93,88,5,142919.301075269,1655.03225806452,92.0430107526882
"4839","16114","2021",5,5,0,75740,665.8,116.6
"4840","16116","2021",4,4,0,148750,1605.75,90.5
"4841","16117","2021",1,1,0,171000,2111,81
"4842","16118","2021",4,4,0,510875,3200.25,176.75
"4843","16119","2021",22,21,1,139862.727272727,1318.18181818182,106.818181818182
"4844","16120","2021",18,18,0,225054.388888889,1573.88888888889,139.388888888889
"4845","16121","2021",4,4,0,89875,997.75,107.25
"4846","16122","2021",3,3,0,85166.6666666667,733.666666666667,121.333333333333
"4847","16123","2021",2,2,0,108500,1300,84.5
"4848","16124","2021",28,28,0,103915.892857143,1220.78571428571,89.3214285714286
"4849","16125","2021",5,5,0,139600,1155.2,119.6
"4850","16127","2021",3,3,0,118666.666666667,1145,103
"4851","16128","2021",5,5,0,88602,904.6,98.8
"4852","16130","2021",5,5,0,175490,1725,106.6
"4853","16131","2021",6,6,0,75733.3333333333,966.833333333333,79.3333333333333
"4854","16132","2021",15,15,0,107176.666666667,1263.06666666667,93.1333333333333
"4855","16133","2021",3,3,0,188333.333333333,1767,111.333333333333
"4856","16134","2021",21,21,0,103109.523809524,1074.71428571429,98.1428571428571
"4857","16135","2021",6,6,0,99072.5,864,113.5
"4858","16136","2021",5,5,0,123040,1215.4,102
"4859","16137","2021",1,1,0,75000,862,87
"4860","16138","2021",48,45,3,170866.520833333,1709.16666666667,98
"4861","16139","2021",7,7,0,186347.142857143,1697.85714285714,119.142857142857
"4862","16140","2021",4,4,0,149497.5,902.5,152.75
"4863","16141","2021",9,9,0,99266.6666666667,1084.11111111111,103.222222222222
"4864","16142","2021",5,5,0,97265,792.8,116.8
"4865","16143","2021",7,7,0,204942.857142857,1578.28571428571,122
"4866","16144","2021",12,12,0,102605.833333333,1028.83333333333,99.25
"4867","16145","2021",12,12,0,149539.25,1343.83333333333,112.166666666667
"4868","16146","2021",29,29,0,188722.103448276,1573.44827586207,114.206896551724
"4869","16147","2021",4,4,0,181000,1593.5,121.5
"4870","16148","2021",17,17,0,93239.4117647059,894.764705882353,104.294117647059
"4871","16150","2021",20,20,0,217247.75,1547.65,143.5
"4872","16151","2021",15,15,0,250820.733333333,1972.73333333333,149.4
"4873","16152","2021",11,11,0,170909.090909091,1362.63636363636,119
"4874","16153","2021",17,17,0,158318.117647059,1390.94117647059,115.941176470588
"4875","16154","2021",127,104,23,132381.811023622,1539.11811023622,88.1968503937008
"4876","16155","2021",1,1,0,40000,526,76
"4877","16157","2021",3,3,0,153333.333333333,3602.33333333333,85
"4878","16158","2021",9,9,0,171462.777777778,1145.66666666667,151.777777777778
"4879","16160","2021",9,9,0,243161.666666667,1915,108.555555555556
"4880","16161","2021",3,3,0,176233.333333333,1384,143.333333333333
"4881","16162","2021",2,2,0,49250,545,92
"4882","16163","2021",15,15,0,183742,1269.8,149.266666666667
"4883","16164","2021",7,7,0,108928.571428571,918,115.142857142857
"4884","16165","2021",8,8,0,117340,961.875,118.25
"4885","16166","2021",98,83,15,135002.020408163,1570.10204081633,87.8469387755102
"4886","16167","2021",87,79,8,148405.206896552,1445.59770114943,101.758620689655
"4887","16168","2021",20,20,0,168273.5,1450.75,118.2
"4888","16169","2021",15,15,0,145448.666666667,1413.8,104.266666666667
"4889","16170","2021",13,13,0,149473.461538462,1253.69230769231,122.461538461538
"4890","16171","2021",7,7,0,115900,949.142857142857,111.428571428571
"4891","16173","2021",2,2,0,69225,647.5,105.5
"4892","16174","2021",11,11,0,164190.909090909,1275.72727272727,133.272727272727
"4893","16175","2021",17,17,0,142725.882352941,1358.94117647059,102.705882352941
"4894","16176","2021",3,3,0,269050,1498,188
"4895","16177","2021",1,1,0,115000,1597,72
"4896","16180","2021",5,5,0,104400,1504.2,81.6
"4897","16181","2021",8,8,0,87502.375,1026.5,86.5
"4898","16182","2021",14,14,0,110642.857142857,1169.07142857143,97.4285714285714
"4899","16183","2021",2,2,0,215750,1435.5,184.5
"4900","16184","2021",1,1,0,128000,1524,84
"4901","16185","2021",1,1,0,82000,471,174
"4902","16186","2021",4,4,0,228732.5,1540.75,135.25
"4903","16187","2021",25,25,0,169279,1609.32,102.48
"4904","16188","2021",8,8,0,123568.75,1121.5,100.375
"4905","16189","2021",6,6,0,149000,1027,153.166666666667
"4906","16190","2021",6,6,0,123908.333333333,1284.5,98.5
"4907","16191","2021",4,4,0,151558.25,1309.5,118.25
"4908","16192","2021",53,53,0,85570.3773584906,910.452830188679,91.2075471698113
"4909","16193","2021",16,16,0,173080.8125,1521.0625,118.1875
"4910","16194","2021",2,2,0,118000,1347.5,88.5
"4911","16195","2021",5,5,0,126600,1232.2,104.2
"4912","16196","2021",19,19,0,122422.105263158,1090.52631578947,112.947368421053
"4913","16198","2021",6,6,0,155133.333333333,1784.83333333333,91.8333333333333
"4914","16199","2021",53,53,0,159322.094339623,1699.75471698113,95.2830188679245
"4915","16200","2021",8,8,0,112875,1197,121.125
"4916","16203","2021",5,5,0,87210,826,104.6
"4917","16204","2021",20,20,0,169504.5,1140.55,148.7
"4918","16205","2021",7,7,0,134361,1287.14285714286,105.142857142857
"4919","16206","2021",39,38,1,111599.487179487,1047.58974358974,104.871794871795
"4920","16207","2021",11,11,0,128502.272727273,1086.36363636364,116
"4921","16208","2021",10,10,0,172402.3,1478,114.8
"4922","16209","2021",11,11,0,151245.454545455,1120.54545454545,124.909090909091
"4923","16210","2021",15,15,0,195611.066666667,1424.2,150.266666666667
"4924","16211","2021",10,10,0,142640,1318.6,108.4
"4925","16212","2021",8,8,0,122306.25,942.875,112.5
"4926","16213","2021",4,4,0,151550,1089.75,139.75
"4927","16215","2021",4,4,0,97387.5,907.25,112.75
"4928","16216","2021",6,6,0,133666.666666667,1001,136.333333333333
"4929","16217","2021",18,18,0,174822.444444444,1814.83333333333,99.0555555555556
"4930","16218","2021",4,4,0,152800,1353.75,126.25
"4931","16220","2021",10,10,0,171930.6,1723.6,101.4
"4932","16221","2021",4,4,0,95500,903.5,104.75
"4933","16222","2021",15,15,0,107974.666666667,888.6,113.933333333333
"4934","16223","2021",38,38,0,116422.026315789,1174.71052631579,101.973684210526
"4935","16224","2021",9,9,0,137222.333333333,1206.88888888889,107.777777777778
"4936","16225","2021",21,21,0,93496,1102.14285714286,91.9523809523809
"4937","16226","2021",15,15,0,147760.333333333,1274.6,118.066666666667
"4938","16227","2021",3,3,0,172200.333333333,1824.33333333333,93
"4939","16229","2021",4,4,0,90647,738,109
"4940","16230","2021",33,32,1,128186.878787879,1210.54545454545,109.69696969697
"4941","16231","2021",7,7,0,93089,963.857142857143,85.8571428571429
"4942","16232","2021",24,24,0,170071.833333333,1531.20833333333,111.375
"4943","16233","2021",10,10,0,175635,1504.7,115
"4944","16234","2021",6,6,0,220231.166666667,1648,140.5
"4945","16236","2021",29,29,0,151493.793103448,1367.68965517241,109
"4946","16237","2021",3,3,0,78333.3333333333,683,113.333333333333
"4947","16238","2021",2,2,0,124500,969.5,118
"4948","16239","2021",1,1,0,73900,1211,61
"4949","16240","2021",1,1,0,85000,675,126
"4950","16241","2021",4,4,0,102575,1072.75,90.75
"4951","16242","2021",45,45,0,142735.977777778,1356.51111111111,119.088888888889
"4952","16243","2021",16,16,0,245288.125,1774.0625,145.3125
"4953","16244","2021",40,37,3,131879.125,1453.8,93.5
"4954","16245","2021",11,11,0,83071,1167.45454545455,85.6363636363636
"4955","16246","2021",4,4,0,219950.25,1606.25,128
"4956","16248","2021",1,1,0,232285,944,246
"4957","16249","2021",9,9,0,65888.8888888889,935,80.1111111111111
"4958","16250","2021",4,4,0,151837.5,1308.25,109.75
"4959","16251","2021",2,2,0,153000,1481,103.5
"4960","16252","2021",2,2,0,106191,1256,84.5
"4961","16253","2021",13,13,0,117464.461538462,919,122.692307692308
"4962","16254","2021",7,7,0,97771.4285714286,1059.57142857143,89.2857142857143
"4963","16255","2021",1,1,0,174979,2500,70
"4964","16256","2021",6,6,0,147530.666666667,1255.66666666667,122.5
"4965","16258","2021",14,14,0,160451.428571429,1362.85714285714,117.142857142857
"4966","16260","2021",6,6,0,177833.333333333,1590.66666666667,113
"4967","16261","2021",4,4,0,164991.25,1366,120.25
"4968","16263","2021",2,2,0,148000,1164,129
"4969","16264","2021",7,7,0,59767.7142857143,606.857142857143,95
"4970","16267","2021",1,1,0,137000,965,142
"4971","16268","2021",4,4,0,166457.5,1113.25,137.25
"4972","16269","2021",7,7,0,152107.142857143,1506.42857142857,100.571428571429
"4973","16270","2021",10,10,0,54870.5,627.9,94.2
"4974","16271","2021",27,27,0,222833.888888889,1822.48148148148,121.518518518519
"4975","16272","2021",10,10,0,129650,1284.6,112.7
"4976","16273","2021",3,3,0,89333.3333333333,1609,62
"4977","16275","2021",8,8,0,141223.625,1108.75,127.75
"4978","16276","2021",7,7,0,140842.857142857,1290.85714285714,114.714285714286
"4979","16277","2021",8,8,0,118218.75,1073,112
"4980","16279","2021",5,5,0,128680,1278.8,84.4
"4981","16280","2021",31,31,0,157614.451612903,1716.96774193548,100.548387096774
"4982","16281","2021",68,65,3,141014.602941176,1452.72058823529,99.9411764705882
"4983","16282","2021",8,8,0,132050,1074.75,122.75
"4984","16283","2021",6,6,0,234269.166666667,1837,129.833333333333
"4985","16284","2021",3,3,0,160000,1184,133.333333333333
"4986","16285","2021",7,7,0,79005.7142857143,800.428571428571,95.5714285714286
"4987","16286","2021",44,44,0,124807.454545455,1105.77272727273,113.909090909091
"4988","16287","2021",54,54,0,180549.425925926,1635.25925925926,112.611111111111
"4989","16289","2021",10,10,0,135374,1157.1,110.7
"4990","16290","2021",5,5,0,131000,1486.4,108.8
"4991","16291","2021",128,124,4,142261.734375,1582.40625,92.421875
"4992","16292","2021",79,74,5,98177.8860759494,1076.6582278481,93.379746835443
"4993","16293","2021",4,4,0,122825,1037.75,105.5
"4994","16295","2021",25,25,0,153131.04,1406.96,109.84
"4995","16297","2021",7,6,1,152271.428571429,1423.85714285714,105.428571428571
"4996","16298","2021",3,3,0,247333.333333333,1645,144.333333333333
"4997","16300","2021",30,30,0,98543.3333333333,901.333333333333,112.3
"4998","16301","2021",4,4,0,194950,1220.25,155.75
"4999","16302","2021",4,4,0,103625,1151.75,98
"5000","16303","2021",4,4,0,148105,1514,105.25
"5001","16304","2021",23,23,0,204428.47826087,1834.26086956522,114.913043478261
"5002","16306","2021",7,7,0,148102.428571429,1384.85714285714,112.857142857143
"5003","16307","2021",6,6,0,138750,1365.33333333333,102.333333333333
"5004","16308","2021",18,18,0,142444.444444444,1019.22222222222,126.944444444444
"5005","16310","2021",8,8,0,110535.875,1056.375,108.375
"5006","16312","2021",7,7,0,122112.285714286,1010.57142857143,120.857142857143
"5007","16315","2021",1,1,0,435400,1910,228
"5008","16316","2021",6,6,0,147750,1192.33333333333,120.5
"5009","16317","2021",9,9,0,122820.333333333,941.111111111111,117.222222222222
"5010","16318","2021",5,5,0,93060,1100.4,87.8
"5011","16320","2021",13,13,0,116895.384615385,1188.84615384615,98.2307692307692
"5012","16321","2021",1,1,0,127500,944,135
"5013","16323","2021",6,6,0,112500,982.333333333333,108.833333333333
"5014","16325","2021",4,4,0,124250,1217.5,119
"5015","16326","2021",1,1,0,58000,611,95
"5016","16329","2021",13,13,0,75192.3846153846,816.230769230769,92.6153846153846
"5017","16330","2021",13,13,0,180036.923076923,1323.84615384615,130.076923076923
"5018","16331","2021",2,2,0,112000,1064,105.5
"5019","16334","2021",1,1,0,228000,1520,150
"5020","16335","2021",1,1,0,164000,1262,130
"5021","16336","2021",9,9,0,110836.111111111,990.444444444444,117
"5022","16337","2021",15,15,0,102665.333333333,914.133333333333,109.4
"5023","16338","2021",3,3,0,81666.6666666667,675.666666666667,115.333333333333
"5024","16339","2021",12,12,0,139642.833333333,1234.91666666667,119.166666666667
"5025","16340","2021",14,14,0,165513.928571429,1333.5,126.357142857143
"5026","16341","2021",63,40,23,107464.841269841,1427.39682539683,77.015873015873
"5027","16342","2021",4,4,0,87950,589.25,148.25
"5028","16343","2021",3,3,0,201000,1430,140.333333333333
"5029","16345","2021",1,1,0,46000,397,116
"5030","16346","2021",2,2,0,159500,1303.5,125
"5031","16347","2021",12,12,0,185699.583333333,1766.91666666667,109.416666666667
"5032","16348","2021",18,18,0,176082.5,1489.77777777778,124.166666666667
"5033","16349","2021",8,8,0,191941.375,1525,124.875
"5034","16350","2021",18,18,0,161441,1377.33333333333,115.944444444444
"5035","16352","2021",4,4,0,102500,1156.25,89.25
"5036","16353","2021",13,13,0,156769.230769231,1316.92307692308,117.615384615385
"5037","16354","2021",1,1,0,255900,1207,212
"5038","16355","2021",19,19,0,151739.473684211,1259.42105263158,119.315789473684
"5039","16356","2021",2,2,0,126300,987,124.5
"5040","16357","2021",9,9,0,105400,1152.22222222222,92.5555555555556
"5041","16358","2021",114,110,4,164732.280701754,1769.36842105263,97.8333333333333
"5042","16359","2021",14,14,0,187807.142857143,1500.57142857143,120.428571428571
"5043","16360","2021",7,7,0,174928.571428571,1320.28571428571,133.714285714286
"5044","16361","2021",7,7,0,101355.714285714,764.428571428571,117.714285714286
"5045","16362","2021",7,7,0,124446.857142857,1028.42857142857,117.857142857143
"5046","16363","2021",8,8,0,156687.5,1215.375,126.25
"5047","16364","2021",2,2,0,64750,582.5,110.5
"5048","16366","2021",31,31,0,165907.741935484,1498,114.161290322581
"5049","16368","2021",10,10,0,182493.8,1481.6,131.5
"5050","16369","2021",17,17,0,112745.294117647,1088.82352941176,103.470588235294
"5051","16370","2021",16,16,0,200630.9375,1486.5,135.125
"5052","16372","2021",6,6,0,138850,1254,117
"5053","16373","2021",5,5,0,158538.2,1789.4,97
"5054","16374","2021",124,105,19,152537.89516129,1563.56451612903,97.008064516129
"5055","16375","2021",8,8,0,84500,994.75,88.25
"5056","16377","2021",5,5,0,83522,1080.2,88.4
"5057","16378","2021",10,10,0,113110,1153.8,98.3
"5058","16379","2021",25,25,0,142177.2,1369.6,108.28
"5059","16380","2021",3,3,0,125133.333333333,1313,92.6666666666667
"5060","16381","2021",5,5,0,163510,959,172.2
"5061","16382","2021",10,10,0,152137,1413.4,112.4
"5062","16383","2021",11,11,0,153278.181818182,1393.54545454545,125.363636363636
"5063","16384","2021",4,4,0,149250,1137,126.75
"5064","16385","2021",13,13,0,141169.230769231,1375.92307692308,101
"5065","16387","2021",6,6,0,126408,1405.33333333333,89.8333333333333
"5066","16388","2021",14,14,0,161478.928571429,1321.64285714286,121.142857142857
"5067","16389","2021",1,1,0,145000,1450,100
"5068","16390","2021",6,6,0,124806.333333333,1080.16666666667,110
"5069","16392","2021",5,5,0,93700,955.6,117.8
"5070","16393","2021",25,25,0,134065.64,1289,97.16
"5071","16394","2021",1,1,0,228000,1500,152
"5072","16395","2021",7,7,0,93857.1428571429,940.571428571429,102.857142857143
"5073","16396","2021",7,7,0,124285.714285714,1077.14285714286,110.857142857143
"5074","16397","2021",8,8,0,107062.5,968.5,108.25
"5075","16398","2021",2,2,0,148170,1380.5,112.5
"5076","16399","2021",6,6,0,242998,1504.16666666667,155.166666666667
"5077","16400","2021",13,13,0,130997.692307692,1218.15384615385,109.923076923077
"5078","16401","2021",4,4,0,108364.5,1155.5,90.5
"5079","16402","2021",4,4,0,144537.5,1474,94.75
"5080","16403","2021",3,3,0,179080,1189.33333333333,165.333333333333
"5081","16404","2021",1,1,0,85000,944,90
"5082","16405","2021",4,4,0,148125,1205.5,168
"5083","16406","2021",17,17,0,126665.941176471,1245.11764705882,98.1764705882353
"5084","16408","2021",10,10,0,123140,1422.8,92.1
"5085","16409","2021",11,11,0,77872.7272727273,768.181818181818,101.545454545455
"5086","16412","2021",6,6,0,153691.666666667,1545.33333333333,93
"5087","16413","2021",4,4,0,123368.75,1120.75,126.75
"5088","16414","2021",5,5,0,77760,972,81.6
"5089","16415","2021",11,11,0,165520.909090909,1506.27272727273,103.636363636364
"5090","16416","2021",7,7,0,110688.571428571,1046.42857142857,104.857142857143
"5091","16418","2021",19,19,0,161662.631578947,1516.94736842105,108.789473684211
"5092","16419","2021",4,4,0,103750,1187.75,84.5
"5093","16420","2021",1,1,0,152381,1858,82
"5094","16421","2021",9,8,1,117722.222222222,1146.33333333333,97.8888888888889
"5095","16422","2021",8,8,0,129462.5,1103.875,119.75
"5096","16423","2021",4,4,0,87750,1079,82.25
"5097","16424","2021",10,10,0,141541.5,1287.5,109.8
"5098","16425","2021",10,10,0,133356.7,1340.4,96.9
"5099","17003","2021",68,68,0,251138.367647059,2448.22058823529,105.897058823529
"5100","17004","2021",3,3,0,400500,6467.33333333333,62
"5101","17007","2021",9,9,0,301866.666666667,1732.66666666667,175.666666666667
"5102","17008","2021",46,46,0,249620.108695652,2327.80434782609,108.5
"5103","17009","2021",26,26,0,241521.038461538,2475.03846153846,97.9230769230769
"5104","17010","2021",60,54,6,380721,3747.58333333333,105.716666666667
"5105","17011","2021",9,9,0,149988.888888889,1341.55555555556,112.666666666667
"5106","17012","2021",3,3,0,137946.666666667,1328.66666666667,104
"5107","17013","2021",10,10,0,120748.3,1217.2,105.7
"5108","17015","2021",14,14,0,189537.5,1816.92857142857,108.5
"5109","17016","2021",17,17,0,140408.823529412,1179,117.823529411765
"5110","17017","2021",18,18,0,146912.222222222,1456.22222222222,100.777777777778
"5111","17018","2021",18,18,0,180922.222222222,1799.16666666667,107.666666666667
"5112","17019","2021",45,43,2,604207.2,6144.82222222222,102.933333333333
"5113","17020","2021",2,2,0,242500,1496,182
"5114","17021","2021",122,107,15,213905.573770492,2380.25409836066,94.7540983606557
"5115","17022","2021",21,21,0,152316.666666667,1283.04761904762,119.619047619048
"5116","17023","2021",7,7,0,174480.142857143,1540.28571428571,108.571428571429
"5117","17024","2021",33,32,1,123819.484848485,1282.06060606061,106.939393939394
"5118","17025","2021",17,17,0,154067.647058824,1266.17647058824,120.941176470588
"5119","17026","2021",9,9,0,218116.666666667,1595.88888888889,141.222222222222
"5120","17027","2021",4,4,0,212500,1725,131.25
"5121","17028","2021",188,100,88,253711.542553191,3669.24468085106,72.4521276595745
"5122","17029","2021",1,1,0,165000,1204,137
"5123","17030","2021",7,7,0,195185.714285714,1706.57142857143,122.142857142857
"5124","17031","2021",2,2,0,65000,647.5,99.5
"5125","17032","2021",14,14,0,271421.142857143,2371.14285714286,115.071428571429
"5126","17033","2021",5,5,0,85600,1082.4,74.4
"5127","17034","2021",12,12,0,157785.416666667,2253.33333333333,76.6666666666667
"5128","17035","2021",4,4,0,129392.5,1009.5,124.5
"5129","17036","2021",19,19,0,189170.526315789,1868.47368421053,101.157894736842
"5130","17037","2021",13,13,0,106592.307692308,929.692307692308,127.461538461538
"5131","17038","2021",3,3,0,156166.666666667,1585.33333333333,103.333333333333
"5132","17039","2021",3,3,0,204681.666666667,1351,178
"5133","17041","2021",29,29,0,206486.551724138,2094.31034482759,99.448275862069
"5134","17042","2021",4,4,0,156185,1532.75,99.75
"5135","17043","2021",19,19,0,156639.473684211,1339.15789473684,114.526315789474
"5136","17044","2021",15,15,0,143871,1301.86666666667,111
"5137","17045","2021",19,19,0,197441.947368421,1589.52631578947,129.210526315789
"5138","17046","2021",5,5,0,211989.2,2103.4,104.8
"5139","17047","2021",1,1,0,126500,1265,100
"5140","17048","2021",3,3,0,93616.6666666667,867.333333333333,111.333333333333
"5141","17049","2021",2,2,0,57425,722,79.5
"5142","17050","2021",6,6,0,90833.3333333333,1102.33333333333,79.8333333333333
"5143","17051","2021",89,86,3,745500.617977528,7072.79775280899,106.123595505618
"5144","17052","2021",15,15,0,124956.666666667,1312.86666666667,95.2
"5145","17053","2021",28,28,0,155622.821428571,1499.03571428571,110.142857142857
"5146","17054","2021",2,2,0,153000,1653,92.5
"5147","17055","2021",6,6,0,158250,1349,119.333333333333
"5148","17056","2021",9,9,0,178327.777777778,1490.11111111111,119.777777777778
"5149","17057","2021",17,17,0,229226.470588235,1851.82352941176,128.941176470588
"5150","17058","2021",79,79,0,213329.405063291,2387.92405063291,94.7974683544304
"5151","17059","2021",18,18,0,350147.222222222,2775.05555555556,126.611111111111
"5152","17060","2021",6,6,0,126065.166666667,1520.66666666667,87.3333333333333
"5153","17061","2021",3,3,0,175233.333333333,1431.33333333333,119.666666666667
"5154","17062","2021",2,2,0,160485,1219.5,126
"5155","17063","2021",5,5,0,244800,1560.6,139.8
"5156","17064","2021",87,87,0,359252.08045977,2977.80459770115,118.471264367816
"5157","17065","2021",31,31,0,227279.677419355,2311.41935483871,102.709677419355
"5158","17066","2021",2,2,0,124857.5,1174.5,135
"5159","17067","2021",4,4,0,109150,1028.5,115.5
"5160","17068","2021",7,7,0,151369.285714286,1610.28571428571,110
"5161","17069","2021",10,10,0,140400,1059.1,133.4
"5162","17070","2021",16,16,0,135841.875,1186.5625,116.375
"5163","17071","2021",11,11,0,102222.727272727,935.181818181818,112.818181818182
"5164","17072","2021",19,19,0,127992.631578947,1280.21052631579,108.421052631579
"5165","17073","2021",13,13,0,173922.307692308,1725,100.153846153846
"5166","17074","2021",14,12,2,172705.714285714,1371.5,132
"5167","17075","2021",27,27,0,239717.481481481,2199.81481481481,107.925925925926
"5168","17076","2021",4,4,0,203750,1910.25,126.25
"5169","17077","2021",16,16,0,190895.75,1506.8125,123.625
"5170","17078","2021",4,4,0,239696.25,1456,156.75
"5171","17079","2021",44,43,1,229898.340909091,2167.02272727273,111.159090909091
"5172","17080","2021",22,22,0,213338.272727273,1856.13636363636,113.272727272727
"5173","17081","2021",9,9,0,93888.8888888889,1265.55555555556,82
"5174","17082","2021",3,3,0,134000,1293,99.3333333333333
"5175","17083","2021",17,17,0,171317.647058824,1683.29411764706,106.705882352941
"5176","17084","2021",12,12,0,140085,1353,115.416666666667
"5177","17085","2021",5,5,0,218200,1606.6,142.6
"5178","17086","2021",55,55,0,167886.272727273,1687.63636363636,103.236363636364
"5179","17087","2021",4,4,0,163200,1308.5,134
"5180","17089","2021",8,8,0,155728.25,1364.625,118
"5181","17091","2021",31,31,0,278864.419354839,2234.67741935484,122.548387096774
"5182","17092","2021",3,3,0,168166.666666667,1203,141.666666666667
"5183","17093","2021",140,130,10,248172.807142857,3168.89285714286,82.4357142857143
"5184","17094","2021",193,140,53,377335.062176166,4674.33160621762,84.9222797927461
"5185","17095","2021",3,3,0,221566.666666667,2437.33333333333,140.666666666667
"5186","17096","2021",1,1,0,167250,1520,110
"5187","17097","2021",11,11,0,189254.545454545,1857.09090909091,108.363636363636
"5188","17098","2021",13,13,0,165461.923076923,1694,106.153846153846
"5189","17099","2021",11,11,0,115801.818181818,1144,108.272727272727
"5190","17100","2021",12,12,0,157353.333333333,1366.5,116.583333333333
"5191","17101","2021",10,10,0,78223,748.3,113.2
"5192","17102","2021",18,18,0,221550.833333333,1849.77777777778,121.277777777778
"5193","17104","2021",15,15,0,124010,1111.53333333333,111
"5194","17105","2021",3,3,0,101333.333333333,941.333333333333,103.333333333333
"5195","17106","2021",2,2,0,128525,1106,121.5
"5196","17107","2021",35,34,1,213671.142857143,2096.51428571429,102.828571428571
"5197","17108","2021",4,4,0,124213.75,1163.75,109
"5198","17109","2021",32,28,4,290773.09375,2971.59375,98.59375
"5199","17110","2021",15,15,0,144000.8,1235.8,125.333333333333
"5200","17111","2021",11,11,0,133918.181818182,1343.54545454545,102.818181818182
"5201","17112","2021",9,9,0,191385.333333333,1529.55555555556,124
"5202","17113","2021",11,11,0,165193.909090909,1573.90909090909,109.909090909091
"5203","17114","2021",4,4,0,90000,634.25,133.25
"5204","17115","2021",3,3,0,92143,1006.66666666667,85.6666666666667
"5205","17117","2021",4,4,0,86016.25,811.25,103.75
"5206","17118","2021",4,4,0,170712.5,1414.25,120.25
"5207","17119","2021",23,23,0,217966,2065.04347826087,104.391304347826
"5208","17120","2021",34,34,0,201830.529411765,1829.67647058824,117.617647058824
"5209","17121","2021",44,41,3,625352.75,7059.93181818182,100.886363636364
"5210","17122","2021",1,1,0,2e+05,1333,150
"5211","17124","2021",9,9,0,140513.333333333,1290.33333333333,117.333333333333
"5212","17125","2021",5,5,0,171822,1417.2,115.8
"5213","17126","2021",4,4,0,110570,960.75,123
"5214","17127","2021",48,41,7,163374.770833333,1713.60416666667,96.6041666666667
"5215","17128","2021",10,10,0,157727.5,1389.1,115.9
"5216","17129","2021",4,4,0,120868.25,1177.75,97
"5217","17130","2021",9,9,0,98050,1063.11111111111,96.6666666666667
"5218","17131","2021",42,41,1,169980.595238095,1814.57142857143,98.4761904761905
"5219","17132","2021",13,13,0,213533.076923077,1752.15384615385,128.230769230769
"5220","17133","2021",8,8,0,174605,1461.125,111.5
"5221","17134","2021",12,12,0,214323.666666667,1483.75,141.333333333333
"5222","17135","2021",8,8,0,158456.25,1164.875,129.375
"5223","17136","2021",27,26,1,270699,2662.22222222222,100.703703703704
"5224","17137","2021",7,7,0,137370,1297.57142857143,106.714285714286
"5225","17138","2021",17,17,0,116500,1045.41176470588,119.117647058824
"5226","17139","2021",8,8,0,130943.75,1208.875,121.875
"5227","17140","2021",148,130,18,245982.148648649,3554.89864864865,75.4662162162162
"5228","17141","2021",8,8,0,163362.125,1603.75,101.75
"5229","17142","2021",80,77,3,319613.7,3154.8125,102.375
"5230","17143","2021",13,9,4,137673.076923077,1503.38461538462,99.3076923076923
"5231","17145","2021",5,5,0,226500,1314.2,175.6
"5232","17146","2021",66,59,7,216071.590909091,2164.48484848485,99.1969696969697
"5233","17147","2021",21,20,1,174139.952380952,1618.14285714286,111.142857142857
"5234","17148","2021",5,5,0,200367,1859.2,99.4
"5235","17149","2021",2,2,0,152500,1137.5,182
"5236","17150","2021",11,11,0,142486.363636364,1099.27272727273,131.090909090909
"5237","17151","2021",20,19,1,204155.5,1945.75,113.55
"5238","17152","2021",20,20,0,180225,1840.4,105.9
"5239","17153","2021",32,32,0,285834.375,2770.65625,104.71875
"5240","17154","2021",12,12,0,162020.833333333,1508.41666666667,107.583333333333
"5241","17155","2021",88,84,4,230878.875,2339.18181818182,100.909090909091
"5242","17156","2021",1,1,0,57000,413,138
"5243","17157","2021",2,2,0,149500,1531.5,98.5
"5244","17158","2021",26,26,0,234055.230769231,2270.57692307692,98.9615384615385
"5245","17159","2021",3,3,0,117680.333333333,2410.33333333333,87.3333333333333
"5246","17160","2021",10,10,0,245039,1895.2,133
"5247","17161","2021",91,84,7,649803.21978022,6911.79120879121,95.1978021978022
"5248","17162","2021",13,13,0,99283.2307692308,952.384615384615,103.769230769231
"5249","17163","2021",7,7,0,181400,1230,149.714285714286
"5250","17164","2021",34,34,0,185800.558823529,1687.52941176471,112.029411764706
"5251","17165","2021",10,10,0,127190,1342.6,94.1
"5252","17166","2021",28,28,0,245029.821428571,2090.64285714286,121.071428571429
"5253","17167","2021",8,8,0,133498.75,1546.75,85.5
"5254","17168","2021",146,118,28,303999.945205479,3765.56164383562,87.472602739726
"5255","17171","2021",12,12,0,185750,1583.58333333333,115.083333333333
"5256","17172","2021",41,41,0,171374.780487805,1454.26829268293,118.243902439024
"5257","17173","2021",4,4,0,96265,881.75,117
"5258","17174","2021",14,14,0,144621.357142857,1678.21428571429,99.7142857142857
"5259","17175","2021",8,8,0,177640.5,1549.375,117.375
"5260","17176","2021",3,3,0,132666.666666667,1026,135.666666666667
"5261","17177","2021",1,1,0,80000,548,146
"5262","17178","2021",1,1,0,545000,1493,365
"5263","17179","2021",26,25,1,198416.538461538,1912.03846153846,102.846153846154
"5264","17180","2021",4,4,0,99350,1075,91
"5265","17181","2021",3,3,0,225162.333333333,1536,131
"5266","17182","2021",13,13,0,167445,1530.92307692308,109
"5267","17183","2021",18,18,0,171064.722222222,1560.66666666667,111.944444444444
"5268","17184","2021",11,11,0,195268.181818182,1732.54545454545,115
"5269","17185","2021",49,49,0,179101.428571429,1941.55102040816,87.8775510204082
"5270","17186","2021",21,21,0,213127.904761905,1744.90476190476,123.142857142857
"5271","17187","2021",6,6,0,180961.5,1510.83333333333,125.333333333333
"5272","17188","2021",6,6,0,126666.666666667,1197.66666666667,108.166666666667
"5273","17190","2021",57,47,10,350649.859649123,3666.36842105263,95.5614035087719
"5274","17191","2021",12,12,0,133820.833333333,1456.58333333333,92.25
"5275","17192","2021",5,5,0,150110,1101.8,139
"5276","17193","2021",51,51,0,317036.078431373,3114.33333333333,104.725490196078
"5277","17194","2021",68,67,1,318574.544117647,2889.91176470588,110.602941176471
"5278","17195","2021",11,11,0,175239.090909091,1288.45454545455,135.454545454545
"5279","17196","2021",9,9,0,149055.555555556,1193.44444444444,127.555555555556
"5280","17197","2021",70,50,20,144858.585714286,1780.35714285714,85.9
"5281","17198","2021",3,3,0,188333.333333333,2076.33333333333,94.3333333333333
"5282","17199","2021",4,4,0,170400,1770.75,102.25
"5283","17200","2021",136,124,12,376132.691176471,3544.625,106.830882352941
"5284","17201","2021",17,17,0,183857.117647059,1673.47058823529,107.705882352941
"5285","17202","2021",11,11,0,133679.090909091,1284.63636363636,110.818181818182
"5286","17203","2021",16,16,0,234613.125,2028,113.6875
"5287","17204","2021",4,4,0,195563.75,1983.25,101.25
"5288","17205","2021",3,3,0,189966.666666667,2286.66666666667,84.3333333333333
"5289","17206","2021",4,4,0,123250,845.75,156.25
"5290","17207","2021",30,29,1,554109.733333333,6131.6,95.2
"5291","17208","2021",23,23,0,265265.130434783,2477.04347826087,107.173913043478
"5292","17209","2021",4,4,0,74750,931.25,84.25
"5293","17210","2021",7,7,0,173937.142857143,1242.85714285714,125.571428571429
"5294","17211","2021",6,6,0,116033.333333333,1008.5,109.5
"5295","17212","2021",4,4,0,168260,1456,116.25
"5296","17213","2021",1,1,0,214000,1427,150
"5297","17214","2021",3,3,0,164616.666666667,1919.66666666667,86.6666666666667
"5298","17216","2021",11,11,0,214222.727272727,1757.27272727273,118.818181818182
"5299","17217","2021",3,3,0,158333.333333333,1445.33333333333,138.333333333333
"5300","17218","2021",98,79,19,158556.367346939,1774.40816326531,90.6122448979592
"5301","17219","2021",135,126,9,204823.740740741,2410.05185185185,89.7407407407407
"5302","17220","2021",3,3,0,111833.333333333,1024.66666666667,123.333333333333
"5303","17221","2021",20,20,0,172602.05,1248.95,136.85
"5304","17222","2021",65,64,1,366181.092307692,3454.87692307692,108.276923076923
"5305","17223","2021",5,5,0,117000,970.2,128.4
"5306","17224","2021",37,36,1,127817.297297297,1207.91891891892,114.567567567568
"5307","17225","2021",204,184,20,242417.362745098,3909.58333333333,67.3872549019608
"5308","17226","2021",17,17,0,173910.294117647,1534.70588235294,117.470588235294
"5309","17227","2021",4,4,0,107625,1350.75,78.25
"5310","17228","2021",72,58,14,239832.5,2531.27777777778,95.8472222222222
"5311","17229","2021",2,2,0,247600,1570.5,168
"5312","17230","2021",121,103,18,259465.826446281,3132.30578512397,87.2066115702479
"5313","17231","2021",1,1,0,137500,1910,72
"5314","17232","2021",20,18,2,182507.65,1627.2,115.4
"5315","17233","2021",4,4,0,282412.5,1766,170.25
"5316","17234","2021",6,6,0,141033.333333333,1246,114.333333333333
"5317","17235","2021",14,14,0,155344.785714286,1326.78571428571,122.714285714286
"5318","17236","2021",22,18,4,101901.136363636,1329.31818181818,84.0454545454545
"5319","17237","2021",12,12,0,138245,1620.83333333333,86.1666666666667
"5320","17239","2021",5,5,0,128540,1240.6,101.2
"5321","17240","2021",63,55,8,112309.841269841,1230.20634920635,94.6349206349206
"5322","17241","2021",20,19,1,117500,1561.5,91.85
"5323","17242","2021",13,13,0,181421,1353.84615384615,130.384615384615
"5324","17243","2021",21,21,0,122742.047619048,1156.42857142857,106.619047619048
"5325","17244","2021",10,10,0,155951.5,1674.1,113.6
"5326","17245","2021",15,15,0,337828.2,2918.46666666667,116.266666666667
"5327","17246","2021",8,8,0,158710.5,1712.75,92.75
"5328","17247","2021",29,26,3,251836.75862069,2855.8275862069,91.3103448275862
"5329","17248","2021",41,38,3,161740.634146341,1665.31707317073,103.536585365854
"5330","17250","2021",5,5,0,105790,975.2,102.6
"5331","17252","2021",1,1,0,130000,2063,63
"5332","17253","2021",12,12,0,168686.666666667,1723.08333333333,98.8333333333333
"5333","17254","2021",4,4,0,142775,1403.5,109
"5334","17255","2021",13,13,0,214491.538461538,1810.69230769231,115.307692307692
"5335","17256","2021",6,6,0,148781.833333333,1221.16666666667,124
"5336","17257","2021",13,13,0,97519.2307692308,923.692307692308,108.615384615385
"5337","17258","2021",2,2,0,90000,859,105
"5338","17259","2021",1,1,0,150000,882,170
"5339","17260","2021",2,2,0,154500,1146.5,147.5
"5340","17261","2021",8,8,0,178962.5,1674,143.625
"5341","17262","2021",16,16,0,177135,1645.0625,103.8125
"5342","17263","2021",4,4,0,110812.5,1431.5,81.75
"5343","17264","2021",90,88,2,350784.666666667,3398.46666666667,104.744444444444
"5344","17265","2021",28,28,0,178410.714285714,1742.17857142857,106.714285714286
"5345","17266","2021",11,11,0,131159.272727273,1160.18181818182,110.636363636364
"5346","17267","2021",30,30,0,232365.666666667,2121.93333333333,113.9
"5347","17268","2021",2,2,0,40000,463,84
"5348","17269","2021",6,6,0,123960.166666667,1299,97.6666666666667
"5349","17270","2021",8,8,0,102188.125,1602.25,82.875
"5350","17271","2021",8,8,0,139176.875,1080,122.75
"5351","17273","2021",17,17,0,160507.647058824,1357.29411764706,123.764705882353
"5352","17274","2021",164,107,57,320076.652439024,3549.46951219512,89.9939024390244
"5353","17275","2021",8,8,0,202585.25,1813.5,106.625
"5354","17277","2021",17,17,0,150450,1364.35294117647,105.352941176471
"5355","17278","2021",7,7,0,175185.714285714,1691.57142857143,106.857142857143
"5356","17279","2021",9,9,0,172029.777777778,1539,109.888888888889
"5357","17280","2021",16,16,0,175345.9375,1394.125,124.6875
"5358","17282","2021",2,2,0,162500,1218,137.5
"5359","17283","2021",76,69,7,128473.223684211,1367.72368421053,99.6842105263158
"5360","17284","2021",26,26,0,170377.5,1627.19230769231,108.153846153846
"5361","17285","2021",16,16,0,133738.875,1239.1875,117.5625
"5362","17286","2021",50,49,1,852716.4,7518.72,114.96
"5363","17287","2021",3,3,0,174500,823,213.666666666667
"5364","17288","2021",1,1,0,30000,667,45
"5365","17289","2021",8,8,0,262697.25,1901.125,134.25
"5366","17290","2021",3,3,0,246666.666666667,1209.33333333333,173.333333333333
"5367","17291","2021",116,87,29,299293.327586207,3409.11206896552,89.0086206896552
"5368","17292","2021",10,10,0,184115.5,1520.5,120.1
"5369","17293","2021",11,11,0,207828,1989.72727272727,105.272727272727
"5370","17294","2021",4,4,0,110772.5,1461.25,75.25
"5371","17295","2021",8,8,0,130808.75,1211,106.625
"5372","17296","2021",18,18,0,212033.333333333,1781.55555555556,121.277777777778
"5373","17297","2021",62,59,3,690324.870967742,7176.24193548387,98.9354838709677
"5374","17298","2021",19,19,0,163542.894736842,1705.63157894737,98.1578947368421
"5375","17299","2021",660,304,356,154351.146969697,2218.42575757576,74.319696969697
"5376","17300","2021",1707,632,1075,300787.265377856,4577.95840656122,68.1862917398946
"5377","17301","2021",2,2,0,70550,1037.5,75.5
"5378","17302","2021",10,10,0,152080,1595.9,95
"5379","17303","2021",17,17,0,167676.470588235,1483.88235294118,115.647058823529
"5380","17304","2021",9,9,0,205266.111111111,1544.55555555556,133.555555555556
"5381","17305","2021",3,3,0,104047,916.333333333333,110
"5382","17306","2021",936,421,515,272510.397435897,3687.63888888889,74.6356837606838
"5383","17307","2021",28,28,0,257237.5,2175.14285714286,120.357142857143
"5384","17308","2021",40,40,0,205449.725,1909.15,111.525
"5385","17309","2021",25,25,0,110189.08,1143.32,93.8
"5386","17310","2021",30,30,0,174006,1676.6,116.7
"5387","17311","2021",43,42,1,238699.348837209,2687.37209302326,91.2093023255814
"5388","17312","2021",16,16,0,147653.75,1216.625,126.75
"5389","17313","2021",4,4,0,149491,1005.5,122.75
"5390","17314","2021",11,11,0,186175.363636364,1647.90909090909,108.545454545455
"5391","17315","2021",24,24,0,218233.625,2404,93.875
"5392","17316","2021",3,3,0,115000,1038,113.333333333333
"5393","17317","2021",6,6,0,146083.333333333,1198.5,133
"5394","17318","2021",54,52,2,454142.166666667,5060.35185185185,96.8518518518518
"5395","17320","2021",7,7,0,160714.285714286,1765.14285714286,100
"5396","17321","2021",4,4,0,180500,1953.25,87.75
"5397","17322","2021",15,15,0,188910.866666667,1824.53333333333,104.133333333333
"5398","17323","2021",98,97,1,308951.163265306,4099.35714285714,80.5510204081633
"5399","17325","2021",8,8,0,143941.25,1416.875,90
"5400","17326","2021",2,2,0,276000,1484.5,178
"5401","17327","2021",9,9,0,143535.222222222,1171.33333333333,131.888888888889
"5402","17328","2021",30,30,0,167477.333333333,1608.36666666667,110.1
"5403","17329","2021",9,9,0,162188.888888889,1724.66666666667,97.2222222222222
"5404","17330","2021",29,29,0,202136.379310345,1472.20689655172,135.137931034483
"5405","17331","2021",19,19,0,163255.263157895,1502.21052631579,110
"5406","17332","2021",3,3,0,79000,980,81.3333333333333
"5407","17333","2021",294,174,120,258002.289115646,3762.28571428571,71.0680272108844
"5408","17334","2021",9,9,0,132207.666666667,1140.88888888889,111.333333333333
"5409","17335","2021",7,7,0,186594.285714286,1775.71428571429,112.142857142857
"5410","17336","2021",45,45,0,235793.888888889,2058.42222222222,118.044444444444
"5411","17337","2021",212,195,17,262010.830188679,3582.87264150943,77.3537735849057
"5412","17338","2021",37,37,0,141270.297297297,1233.97297297297,122.594594594595
"5413","17339","2021",12,12,0,196930.833333333,1623.08333333333,123
"5414","17340","2021",37,37,0,165779.513513514,1407.54054054054,118.891891891892
"5415","17341","2021",2,2,0,250587.5,1798.5,140
"5416","17342","2021",10,10,0,194335.3,1616.3,126.8
"5417","17344","2021",23,23,0,131923.913043478,1279.73913043478,107.086956521739
"5418","17345","2021",3,3,0,223335,1678,141.333333333333
"5419","17346","2021",28,28,0,187856.321428571,1944.85714285714,96.5
"5420","17347","2021",149,129,20,132762.040268456,1335.39597315436,103.41610738255
"5421","17348","2021",13,13,0,193426.923076923,1949.69230769231,102
"5422","17349","2021",66,66,0,202545.803030303,1897.04545454545,108.166666666667
"5423","17350","2021",16,16,0,134572.4375,1381.4375,100.625
"5424","17351","2021",40,40,0,220608,2595.6,92.275
"5425","17353","2021",49,49,0,260872.040816327,2564.38775510204,105.65306122449
"5426","17354","2021",9,9,0,168104.555555556,1561.77777777778,106.777777777778
"5427","17355","2021",8,8,0,189031.25,1393.625,146.625
"5428","17356","2021",5,5,0,183340,1311.8,144.4
"5429","17357","2021",4,4,0,263337.75,1432,182
"5430","17358","2021",6,6,0,127317.833333333,1068.66666666667,113.833333333333
"5431","17359","2021",18,18,0,151453.333333333,1545.61111111111,103.777777777778
"5432","17360","2021",91,91,0,740485.32967033,6271.1978021978,122.835164835165
"5433","17362","2021",1,1,0,168000,1647,102
"5434","17363","2021",4,4,0,197625,1668.5,115.5
"5435","17364","2021",4,4,0,182459.25,1622,113.25
"5436","17365","2021",5,5,0,135480.4,1275.2,106.8
"5437","17366","2021",7,7,0,152717.142857143,1200.42857142857,124.857142857143
"5438","17367","2021",1,1,0,70000,609,115
"5439","17369","2021",68,39,29,595737.352941177,7105.11764705882,83.0882352941177
"5440","17372","2021",1,1,0,115350,1424,81
"5441","17373","2021",35,35,0,264370.371428571,2028.08571428571,134.485714285714
"5442","17374","2021",3,3,0,199000,1571.33333333333,125.666666666667
"5443","17375","2021",28,28,0,168555,2117.64285714286,82.6071428571429
"5444","17376","2021",29,28,1,269242.931034483,2814.41379310345,96.9310344827586
"5445","17377","2021",6,6,0,154638,1198.66666666667,128.833333333333
"5446","17378","2021",2,2,0,113850,1498.5,75
"5447","17379","2021",5,5,0,222791,1682.2,138.8
"5448","17380","2021",263,186,77,332139.266159696,4290.90494296578,79.3269961977186
"5449","17381","2021",5,5,0,164932,1260.6,133.6
"5450","17382","2021",9,9,0,155487.777777778,1264.55555555556,129.888888888889
"5451","17383","2021",8,8,0,159285,1257.75,135.625
"5452","17384","2021",3,3,0,91163.3333333333,938.666666666667,106.333333333333
"5453","17385","2021",299,290,9,270779.040133779,3453.27090301003,80.1404682274247
"5454","17386","2021",5,5,0,142300,1168,125
"5455","17387","2021",23,22,1,188850.782608696,1838.39130434783,112
"5456","17388","2021",5,5,0,108916,949.2,133.4
"5457","17389","2021",7,7,0,197000.571428571,1493.71428571429,123.571428571429
"5458","17390","2021",3,3,0,134275,1077.66666666667,119
"5459","17391","2021",40,40,0,322526.4,3152.625,102.05
"5460","17393","2021",24,24,0,191789.083333333,1869.75,101.916666666667
"5461","17394","2021",19,19,0,175910.526315789,1475.73684210526,124.368421052632
"5462","17395","2021",4,4,0,217875,2133,120
"5463","17396","2021",49,49,0,240810.571428571,2166.36734693878,117.530612244898
"5464","17397","2021",63,63,0,174013.412698413,1659.96825396825,105
"5465","17398","2021",1,1,0,245200,2229,110
"5466","17400","2021",9,9,0,151683.333333333,1510.55555555556,106.111111111111
"5467","17401","2021",3,3,0,162000,1275.66666666667,137.666666666667
"5468","17403","2021",5,5,0,119000,1485,81.6
"5469","17404","2021",9,9,0,171763.333333333,1255,127
"5470","17405","2021",6,6,0,163916.666666667,1686.66666666667,105
"5471","17406","2021",12,12,0,183219.416666667,2183,95
"5472","17407","2021",83,79,4,299602.722891566,2993.74698795181,104.265060240964
"5473","17408","2021",11,11,0,213308.818181818,1899.18181818182,123.636363636364
"5474","17409","2021",59,56,3,321220.93220339,2654.4406779661,122.016949152542
"5475","17410","2021",12,12,0,154929.166666667,1314.25,119.333333333333
"5476","17411","2021",51,47,4,267491.274509804,3887.13725490196,70.7843137254902
"5477","17412","2021",12,12,0,181081.25,1600.58333333333,119.5
"5478","17413","2021",34,31,3,344978.911764706,2986.52941176471,113.470588235294
"5479","17414","2021",88,87,1,338041.602272727,3119.60227272727,110.284090909091
"5480","17415","2021",473,356,117,174927.594080338,1927.61945031712,91.7716701902748
"5481","17416","2021",1,1,0,132000,923,143
"5482","17417","2021",2,2,0,94150,1203.5,77
"5483","17418","2021",5,5,0,183000,1416,136.8
"5484","17420","2021",35,30,5,380226.314285714,3344.11428571429,112.114285714286
"5485","17421","2021",193,170,23,205944.74611399,2263.66839378238,92.860103626943
"5486","17422","2021",4,4,0,148296.25,1180.25,129.25
"5487","17424","2021",4,4,0,100312.5,1305.75,95.25
"5488","17425","2021",61,60,1,218937.114754098,2322.93442622951,97.4918032786885
"5489","17426","2021",8,8,0,147650,1291.875,115.25
"5490","17427","2021",2,2,0,91500,1212,74.5
"5491","17428","2021",10,10,0,108100,940.6,113.2
"5492","17429","2021",36,36,0,224512.555555556,2292.38888888889,98.5
"5493","17430","2021",3,3,0,108468,1204,90.3333333333333
"5494","17431","2021",5,5,0,204780,1609.4,132
"5495","17432","2021",2,2,0,121750,1515,75.5
"5496","17433","2021",4,4,0,200125,2052.5,106
"5497","17434","2021",147,133,14,173923.884353742,1944.97278911565,92.5442176870748
"5498","17435","2021",4,4,0,251307.5,2061.5,135
"5499","17436","2021",18,18,0,175091.722222222,1542.44444444444,114.555555555556
"5500","17437","2021",7,7,0,308000,3064.28571428571,132.571428571429
"5501","17438","2021",2,2,0,116500,1190,95.5
"5502","17439","2021",21,21,0,162318.571428571,1581.7619047619,106.333333333333
"5503","17440","2021",12,11,1,130875,1333.66666666667,101.25
"5504","17441","2021",10,10,0,178110,1469.3,130.4
"5505","17442","2021",8,8,0,191943.75,1634.625,114
"5506","17443","2021",29,29,0,242817.965517241,2615.20689655172,92.7931034482759
"5507","17444","2021",20,20,0,185467.1,1943.3,103.55
"5508","17445","2021",4,4,0,222000,1757,149.75
"5509","17446","2021",6,6,0,156916.666666667,1229.33333333333,135.333333333333
"5510","17447","2021",47,47,0,233533.85106383,2184.08510638298,107.510638297872
"5511","17448","2021",22,22,0,150478.681818182,1536.40909090909,104.136363636364
"5512","17449","2021",188,151,37,170793.117021277,1897.22872340426,93.7765957446808
"5513","17450","2021",7,7,0,114028.571428571,1361.28571428571,87.2857142857143
"5514","17451","2021",9,9,0,173591.333333333,1414,128.444444444444
"5515","17452","2021",173,144,29,262050.589595376,3215.47976878613,88.0924855491329
"5516","17453","2021",20,20,0,209323.85,1744.3,116.6
"5517","17454","2021",8,8,0,139488.5,1333.625,112.625
"5518","17455","2021",10,10,0,196960,1928.4,105.3
"5519","17457","2021",39,39,0,180606.743589744,2016.84615384615,101.769230769231
"5520","17458","2021",2,2,0,186000,1243,160.5
"5521","17459","2021",15,15,0,152353.866666667,1312.13333333333,122.666666666667
"5522","17460","2021",6,6,0,266433.333333333,2157.83333333333,139.666666666667
"5523","17461","2021",258,145,113,301504.833333333,4408.24418604651,70.4341085271318
"5524","17462","2021",13,13,0,187449.230769231,1688.38461538462,117.153846153846
"5525","17463","2021",25,25,0,284690.4,2518.08,114.4
"5526","17464","2021",2,2,0,118565,1329,111.5
"5527","17465","2021",8,8,0,124535.125,1330.125,91
"5528","17466","2021",45,42,3,257741.488888889,2333.13333333333,112.533333333333
"5529","17467","2021",1,1,0,129000,1449,89
"5530","17468","2021",1,1,0,121500,1105,110
"5531","17469","2021",9,9,0,138370,1290.66666666667,108.333333333333
"5532","17470","2021",2,2,0,212500,1825,143.5
"5533","17471","2021",7,7,0,82206.5714285714,889.428571428571,102.857142857143
"5534","17472","2021",40,40,0,296935.1,2861.85,105.5
"5535","17473","2021",1,1,0,120000,1200,100
"5536","17474","2021",18,18,0,117084.666666667,1202.22222222222,102.777777777778
"5537","17476","2021",4,4,0,144318.75,1564.25,90.75
"5538","17477","2021",2,2,0,96974.5,876,127
"5539","17478","2021",1,1,0,68000,1360,50
"5540","17479","2021",3,3,0,213650,1006.33333333333,204
"5541","17480","2021",12,12,0,204499.916666667,1659.75,130.75
"5542","17481","2021",4,4,0,150000,1430.75,105
"5543","17482","2021",13,13,0,218538.461538462,1825.92307692308,122
"5544","17483","2021",27,27,0,275618.407407407,3075.88888888889,94.1481481481482
"5545","17484","2021",66,61,5,185370.015151515,2162.07575757576,86.2272727272727
"5546","17485","2021",44,42,2,284701.704545455,3456.25,84.5454545454545
"5547","17486","2021",58,57,1,311244.448275862,4112.12068965517,77.551724137931
"5548","18001","2021",7,7,0,110000,860.142857142857,116.571428571429
"5549","18002","2021",7,7,0,69768.5714285714,552.571428571429,128.714285714286
"5550","18003","2021",17,17,0,114352.941176471,1158,100.764705882353
"5551","18004","2021",19,19,0,167114.736842105,1537.21052631579,108.421052631579
"5552","18005","2021",9,8,1,154325,1152.66666666667,140.333333333333
"5553","18006","2021",2,2,0,148000,1721,86
"5554","18007","2021",1,1,0,140000,864,162
"5555","18008","2021",9,9,0,164465.333333333,1269.33333333333,136.222222222222
"5556","18009","2021",4,4,0,68250,766.25,104.5
"5557","18010","2021",1,1,0,45000,643,70
"5558","18011","2021",41,40,1,121987.853658537,1173.78048780488,101.390243902439
"5559","18012","2021",5,5,0,88200,1156.4,70.4
"5560","18013","2021",2,2,0,161444,1165,138
"5561","18014","2021",6,6,0,185316.5,1657.83333333333,111.166666666667
"5562","18015","2021",77,69,8,107055.974025974,1358.54545454545,82.038961038961
"5563","18016","2021",6,6,0,117000,1084.33333333333,108.333333333333
"5564","18017","2021",1,1,0,89000,2119,42
"5565","18018","2021",26,25,1,119473.076923077,1384.96153846154,87.3461538461538
"5566","18019","2021",8,8,0,80750,821,94
"5567","18020","2021",12,12,0,98023.25,1114.66666666667,86.8333333333333
"5568","18021","2021",7,7,0,71125,887.285714285714,87
"5569","18022","2021",8,8,0,51000,823.375,71.125
"5570","18023","2021",37,36,1,151854.054054054,1427.97297297297,96.5945945945946
"5571","18024","2021",6,6,0,127750,1078.16666666667,118.833333333333
"5572","18025","2021",5,5,0,130900,1480.4,81.4
"5573","18026","2021",13,13,0,129923.076923077,1245.92307692308,101.769230769231
"5574","18027","2021",11,11,0,98645.4545454545,903.181818181818,112.090909090909
"5575","18028","2021",22,22,0,169930.818181818,1665,102.045454545455
"5576","18029","2021",7,7,0,99980,972,107.142857142857
"5577","18030","2021",18,18,0,100788.333333333,1239.16666666667,81.0555555555556
"5578","18031","2021",13,13,0,71076.9230769231,814.538461538462,86.4615384615385
"5579","18032","2021",24,24,0,96843.8333333333,1158.04166666667,83.5416666666667
"5580","18033","2021",1173,543,630,125030.742540494,1604.73060528559,77.6240409207161
"5581","18034","2021",2,2,0,141500,1228,117
"5582","18035","2021",16,16,0,109718.75,1112.75,100.625
"5583","18036","2021",8,8,0,170731.25,1350,122.375
"5584","18037","2021",21,20,1,170900.619047619,1585.52380952381,106.333333333333
"5585","18038","2021",12,11,1,84377.3333333333,996.25,84.4166666666667
"5586","18039","2021",5,5,0,84520,964,90.2
"5587","18040","2021",1,1,0,175000,1620,108
"5588","18041","2021",3,3,0,92813.3333333333,1058.66666666667,86
"5589","18043","2021",8,8,0,76565.625,1017.375,81
"5590","18044","2021",7,7,0,102126.285714286,1011.71428571429,95.8571428571429
"5591","18045","2021",7,7,0,189142.857142857,1398.42857142857,106
"5592","18046","2021",2,2,0,94850,1046.5,90.5
"5593","18047","2021",13,13,0,128592.307692308,1024.15384615385,128.384615384615
"5594","18048","2021",6,6,0,98903.3333333333,1079.33333333333,89.1666666666667
"5595","18049","2021",10,10,0,87926,990.2,94.2
"5596","18050","2021",42,42,0,145582.166666667,1581.97619047619,92.4047619047619
"5597","18051","2021",3,3,0,51666.6666666667,732.666666666667,73
"5598","18052","2021",12,12,0,85258.3333333333,866.583333333333,94.9166666666667
"5599","18053","2021",9,9,0,60777.7777777778,727.888888888889,83.7777777777778
"5600","18054","2021",5,5,0,80000,774.2,99.2
"5601","18055","2021",21,21,0,78127.2380952381,990.428571428571,80.0952380952381
"5602","18056","2021",6,6,0,70720.8333333333,869.833333333333,78
"5603","18057","2021",34,34,0,74068.9705882353,1070.73529411765,70.6176470588235
"5604","18058","2021",27,26,1,72481.4814814815,909.222222222222,83.1111111111111
"5605","18059","2021",19,19,0,58539.4736842105,719.263157894737,82.8421052631579
"5606","18060","2021",1,1,0,94500,1086,87
"5607","18062","2021",2,2,0,115500,1305.5,88
"5608","18064","2021",4,4,0,107750,1580.25,74
"5609","18065","2021",13,13,0,87038.4615384615,1025.84615384615,81.9230769230769
"5610","18066","2021",9,9,0,90325.6666666667,930.777777777778,92.2222222222222
"5611","18067","2021",11,11,0,172544.545454545,1536.54545454545,106.181818181818
"5612","18068","2021",1,1,0,277000,11080,25
"5613","18069","2021",8,8,0,123493.875,1209.625,98.875
"5614","18070","2021",3,3,0,116666.666666667,1091.66666666667,108
"5615","18072","2021",3,3,0,107933.333333333,932.333333333333,113
"5616","18073","2021",5,5,0,49800,785,53.8
"5617","18074","2021",4,4,0,121750,1276,95.75
"5618","18075","2021",11,11,0,111085,1131.09090909091,99.2727272727273
"5619","18076","2021",11,11,0,95590.9090909091,961.272727272727,101.454545454545
"5620","18077","2021",11,11,0,83556.8181818182,771.454545454545,108.636363636364
"5621","18078","2021",3,3,0,63333.3333333333,856.666666666667,75.6666666666667
"5622","18079","2021",11,11,0,82567.2727272727,977.363636363636,83.3636363636364
"5623","18080","2021",3,3,0,84333.3333333333,798.333333333333,102.333333333333
"5624","18081","2021",5,5,0,132693.6,1333.6,101.8
"5625","18082","2021",24,24,0,129816.875,1255.79166666667,103.791666666667
"5626","18083","2021",17,17,0,100482.352941176,1028.94117647059,96.4705882352941
"5627","18084","2021",5,5,0,130500,1399.6,86.6
"5628","18085","2021",4,4,0,48377.5,695,70.25
"5629","18086","2021",6,6,0,121333.333333333,1008.83333333333,116.833333333333
"5630","18087","2021",63,63,0,101535.873015873,1061.7619047619,94.6031746031746
"5631","18088","2021",2,2,0,105000,879,113
"5632","18089","2021",4,4,0,84639,1175.75,72.75
"5633","18090","2021",7,7,0,90714.2857142857,927.142857142857,99.2857142857143
"5634","18092","2021",12,12,0,160887.916666667,1519.33333333333,112.083333333333
"5635","18093","2021",2,2,0,110145,1481.5,71.5
"5636","18094","2021",10,10,0,132480,1224.9,104.2
"5637","18095","2021",5,5,0,108200,1018.2,105.4
"5638","18096","2021",25,25,0,119502.52,1196.08,96.88
"5639","18097","2021",36,36,0,173556.666666667,1695.38888888889,101.555555555556
"5640","18098","2021",2,2,0,242000,1289,148.5
"5641","18099","2021",5,5,0,64600,763,83.4
"5642","18100","2021",14,14,0,83161.0714285714,853.285714285714,94.1428571428571
"5643","18101","2021",6,6,0,99000,1325.5,92.1666666666667
"5644","18102","2021",7,7,0,74222.8571428571,877.714285714286,82.8571428571429
"5645","18103","2021",37,36,1,80564.8648648649,892.486486486486,89.1081081081081
"5646","18104","2021",6,6,0,69616.6666666667,899,71.1666666666667
"5647","18105","2021",9,9,0,102222.222222222,1108.77777777778,92.8888888888889
"5648","18106","2021",2,2,0,57000,706.5,84.5
"5649","18107","2021",2,2,0,198500,1633,121.5
"5650","18108","2021",36,36,0,87741.6666666667,1130.11111111111,77.2777777777778
"5651","18109","2021",30,30,0,82982.2666666667,935.8,96.8
"5652","18110","2021",16,15,1,65787.5,948.5,74.5625
"5653","18111","2021",4,4,0,116325,1441.75,85.25
"5654","18112","2021",5,5,0,100905.4,959,100.6
"5655","18113","2021",3,3,0,72333.3333333333,1024.66666666667,73.3333333333333
"5656","18114","2021",2,2,0,174371,926.5,177
"5657","18115","2021",14,14,0,97682.2142857143,1132.57142857143,96.5
"5658","18116","2021",13,13,0,76615.3846153846,837.615384615385,87.6153846153846
"5659","18117","2021",9,9,0,81222.2222222222,1141.66666666667,84.8888888888889
"5660","18118","2021",31,31,0,70400,911.838709677419,73.3870967741936
"5661","18119","2021",3,3,0,97333.3333333333,1274,77.3333333333333
"5662","18120","2021",11,11,0,115645.454545455,920.363636363636,131.181818181818
"5663","18121","2021",2,2,0,75000,1124,67
"5664","18122","2021",6,6,0,144616.666666667,1349.5,100.5
"5665","18124","2021",5,5,0,103600,1253.2,98
"5666","18125","2021",23,23,0,135315.217391304,1121.08695652174,119.04347826087
"5667","18126","2021",18,18,0,129653.333333333,1345.88888888889,93.8333333333333
"5668","18127","2021",22,22,0,80583.0454545455,796,96.4090909090909
"5669","18129","2021",1,1,0,205000,1444,142
"5670","18130","2021",3,3,0,89166.6666666667,1767,79.3333333333333
"5671","18131","2021",1,1,0,279770,769,364
"5672","18132","2021",1,1,0,87000,737,118
"5673","18133","2021",20,20,0,82170.8,1060.25,79.15
"5674","18134","2021",20,20,0,87340,745.45,112.1
"5675","18135","2021",8,8,0,82652.5,923.75,91.75
"5676","18136","2021",9,9,0,89460.7777777778,1137,82.7777777777778
"5677","18137","2021",17,17,0,75882.2352941177,812.705882352941,90.8823529411765
"5678","18138","2021",34,34,0,157431.911764706,1617.52941176471,98.5588235294118
"5679","18139","2021",11,11,0,73009.0909090909,1162.09090909091,66.2727272727273
"5680","18140","2021",28,28,0,116260.714285714,1055.5,109.178571428571
"5681","18141","2021",122,114,8,116696.254098361,1306.27049180328,90.5655737704918
"5682","18142","2021",11,11,0,100409.090909091,1044.63636363636,99.1818181818182
"5683","18143","2021",4,4,0,101500,934.25,113.75
"5684","18144","2021",7,7,0,137007.142857143,1448.28571428571,108.714285714286
"5685","18145","2021",27,27,0,99342.5925925926,1348.37037037037,88.5555555555556
"5686","18146","2021",6,6,0,80166.6666666667,1053.33333333333,73.3333333333333
"5687","18147","2021",6,6,0,129448.333333333,1084.33333333333,116.833333333333
"5688","18148","2021",25,25,0,126034.8,1298.92,95.88
"5689","18149","2021",9,9,0,87055.5555555556,815.888888888889,102.777777777778
"5690","18150","2021",8,8,0,216262.5,1565.875,137.375
"5691","18151","2021",10,10,0,66650,971.9,69.6
"5692","18153","2021",2,2,0,83489,672,117.5
"5693","18154","2021",6,6,0,73666.6666666667,701.166666666667,113.5
"5694","18155","2021",7,7,0,76551.4285714286,891.428571428571,87.1428571428571
"5695","18156","2021",6,6,0,66129.1666666667,1019.16666666667,67.8333333333333
"5696","18157","2021",18,18,0,128660,1411.11111111111,92.8333333333333
"5697","18158","2021",16,16,0,162953.625,1543.6875,105.875
"5698","18159","2021",18,18,0,165010.833333333,1613.88888888889,98.6666666666667
"5699","18160","2021",24,24,0,109013.75,1123.125,98.5833333333333
"5700","18161","2021",6,6,0,69558.3333333333,1125.5,61.5
"5701","18162","2021",7,7,0,143339.571428571,1348.28571428571,100.714285714286
"5702","18163","2021",4,4,0,81125,1016.25,69.75
"5703","18164","2021",3,3,0,71333.3333333333,901.333333333333,78
"5704","18165","2021",19,19,0,100452.631578947,1176.84210526316,84.9473684210526
"5705","18166","2021",6,6,0,123583.333333333,1201.5,102.666666666667
"5706","18167","2021",7,7,0,75428.5714285714,1069.71428571429,70.2857142857143
"5707","18168","2021",10,10,0,126606,1252.7,116.4
"5708","18169","2021",1,1,0,358000,2238,160
"5709","18170","2021",9,9,0,119774.444444444,1243.77777777778,98.6666666666667
"5710","18171","2021",4,4,0,95750,1042,79
"5711","18172","2021",25,24,1,108633,1057.28,101.04
"5712","18173","2021",4,4,0,200250,1230.5,158.75
"5713","18174","2021",5,5,0,406000,2606.6,173.8
"5714","18175","2021",18,18,0,68222.2222222222,818.111111111111,84.3888888888889
"5715","18176","2021",6,6,0,115833.333333333,1070.33333333333,97.8333333333333
"5716","18177","2021",2,2,0,70000,1049.5,62
"5717","18178","2021",5,5,0,76036,831.8,95.4
"5718","18179","2021",12,12,0,160241.666666667,1513.83333333333,112.166666666667
"5719","18180","2021",28,28,0,170892.857142857,1689.82142857143,103.071428571429
"5720","18181","2021",7,7,0,135957.142857143,1205.28571428571,108.285714285714
"5721","18182","2021",4,4,0,120750,1117.75,107.25
"5722","18183","2021",4,4,0,71625,630,116
"5723","18184","2021",4,4,0,71750,710.5,95.5
"5724","18185","2021",3,3,0,85666.6666666667,1060,83.6666666666667
"5725","18186","2021",8,8,0,105960.875,1125,96.5
"5726","18187","2021",25,25,0,79051.96,983.8,81.88
"5727","18188","2021",3,3,0,112000,1416.33333333333,78.3333333333333
"5728","18189","2021",2,2,0,142555.5,1106,155
"5729","18190","2021",14,14,0,102439.285714286,1022.21428571429,96.1428571428571
"5730","18191","2021",3,3,0,88000,926,96.6666666666667
"5731","18192","2021",5,5,0,125980,1097.4,105.8
"5732","18193","2021",4,4,0,100362.5,693.75,123.5
"5733","18194","2021",9,9,0,99523.5555555556,1011.33333333333,99.5555555555556
"5734","18195","2021",3,3,0,40333.3333333333,696.333333333333,56.3333333333333
"5735","18196","2021",2,2,0,44500,523.5,84.5
"5736","18197","2021",167,148,19,96879.7604790419,1120.22155688623,88.8562874251497
"5737","18198","2021",8,8,0,105556.125,882,110.875
"5738","18199","2021",6,6,0,67166.6666666667,759.666666666667,89.5
"5739","18200","2021",17,17,0,73170.5882352941,876.470588235294,83.6470588235294
"5740","18201","2021",14,14,0,129115.5,1304.92857142857,96.9285714285714
"5741","18203","2021",3,3,0,57631.6666666667,691.666666666667,82.3333333333333
"5742","18204","2021",3,3,0,116333.333333333,961,126
"5743","18205","2021",111,109,2,192482.468468468,1890.76576576577,102.414414414414
"5744","18206","2021",16,16,0,167205.625,1436.75,117.75
"5745","18207","2021",135,120,15,102919.82962963,1181.62962962963,86.8592592592593
"5746","18208","2021",4,4,0,139555,1301.25,103
"5747","18209","2021",10,10,0,156691.7,1501.5,111.8
"5748","18210","2021",7,7,0,93884.2857142857,967.714285714286,97.7142857142857
"5749","18211","2021",9,9,0,163065.555555556,1458.66666666667,112.555555555556
"5750","18212","2021",12,12,0,105196.75,1172.83333333333,89.4166666666667
"5751","18213","2021",58,58,0,143420.224137931,1543.96551724138,94.551724137931
"5752","18214","2021",11,11,0,103454.545454545,1158.45454545455,86.8181818181818
"5753","18215","2021",2,2,0,43500,655.5,65
"5754","18216","2021",18,18,0,98028.6111111111,1098.94444444444,83
"5755","18217","2021",2,2,0,60750,882.5,79
"5756","18218","2021",9,9,0,149110,1435.88888888889,104.888888888889
"5757","18219","2021",4,4,0,196750,1567.75,117.5
"5758","18220","2021",8,8,0,65522.5,863.5,76.375
"5759","18221","2021",7,7,0,116643.571428571,814,123.571428571429
"5760","18223","2021",37,37,0,140221.135135135,1333.48648648649,108.297297297297
"5761","18224","2021",6,6,0,77574.5,926.666666666667,92.8333333333333
"5762","18225","2021",3,3,0,98333.3333333333,1078,81.6666666666667
"5763","18226","2021",1,1,0,140000,1556,90
"5764","18227","2021",4,4,0,112537.5,1942.75,61.5
"5765","18228","2021",5,5,0,114400,919.2,116.2
"5766","18229","2021",10,10,0,190835,1756.2,112.8
"5767","18230","2021",6,6,0,79666.6666666667,1009,91.1666666666667
"5768","18231","2021",5,5,0,122900,947,129.2
"5769","18232","2021",4,4,0,47500,910.75,56.5
"5770","18233","2021",39,38,1,132115.384615385,1368.46153846154,94.2051282051282
"5771","18234","2021",11,11,0,110454.545454545,1078.27272727273,104.545454545455
"5772","18235","2021",17,17,0,133152.941176471,1355.70588235294,99.2352941176471
"5773","18236","2021",2,2,0,97000,1049,99
"5774","18237","2021",14,14,0,146486.642857143,1340,95.4285714285714
"5775","18238","2021",7,7,0,88214.2857142857,980.142857142857,95.2857142857143
"5776","18240","2021",19,19,0,65942.1052631579,803.210526315789,85.7368421052632
"5777","18241","2021",18,18,0,153365.277777778,1443.16666666667,101.722222222222
"5778","18242","2021",41,41,0,77304.8780487805,830.878048780488,92.219512195122
"5779","18243","2021",5,4,1,77800,1123.2,67
"5780","18245","2021",12,12,0,89074.8333333333,847.333333333333,99.4166666666667
"5781","18246","2021",22,22,0,125762.272727273,1277.72727272727,104.181818181818
"5782","18247","2021",10,10,0,112344.2,1183.2,89.9
"5783","18248","2021",2,2,0,104000,1031.5,100.5
"5784","18249","2021",11,11,0,96090.9090909091,1102.27272727273,91
"5785","18251","2021",1,1,0,25000,446,56
"5786","18252","2021",15,15,0,78502.6666666667,982.4,83.0666666666667
"5787","18253","2021",6,6,0,140105.833333333,1476.83333333333,95
"5788","18254","2021",7,7,0,139357.142857143,1375.28571428571,101.714285714286
"5789","18255","2021",12,12,0,178291.75,1592.75,117.333333333333
"5790","18256","2021",7,7,0,83414.2857142857,868.285714285714,97.8571428571429
"5791","18257","2021",9,9,0,138888.888888889,1327.22222222222,103.111111111111
"5792","18258","2021",17,17,0,95558.8235294118,1042.88235294118,88.5294117647059
"5793","18259","2021",7,7,0,82428.5714285714,878.285714285714,88.1428571428571
"5794","18261","2021",8,8,0,109093.75,902.625,117.25
"5795","18262","2021",5,5,0,110400,1443,85.8
"5796","18263","2021",9,9,0,227753.333333333,1593,90.2222222222222
"5797","18265","2021",11,11,0,71718.1818181818,823.363636363636,86.0909090909091
"5798","18266","2021",5,5,0,101544.2,1131.6,84.6
"5799","18267","2021",55,55,0,165752.8,1641.50909090909,102.763636363636
"5800","18268","2021",14,14,0,70000,875.357142857143,79.8571428571429
"5801","18269","2021",17,16,1,63070.5882352941,910.882352941176,69.2352941176471
"5802","18270","2021",8,8,0,61625,726.75,86.75
"5803","18271","2021",13,13,0,182865.769230769,1420,128.461538461538
"5804","18272","2021",10,10,0,81037.6,903.9,90.1
"5805","18273","2021",14,14,0,70647.1428571429,807.571428571429,89.1428571428571
"5806","18274","2021",7,7,0,189397.142857143,1681,87.2857142857143
"5807","18275","2021",2,2,0,70000,830,85
"5808","18276","2021",3,3,0,103766.666666667,750.666666666667,130.333333333333
"5809","18278","2021",12,12,0,54154.1666666667,669.833333333333,81.0833333333333
"5810","18279","2021",468,362,106,78309.2115384615,1025.77777777778,78.2777777777778
"5811","18280","2021",2,2,0,105283,1612,77
"5812","18281","2021",37,36,1,126371.945945946,1236.2972972973,102.648648648649
"5813","18282","2021",7,7,0,139902.857142857,1187.57142857143,119.142857142857
"5814","18283","2021",3,3,0,144306.333333333,1125.66666666667,137.333333333333
"5815","18284","2021",1,1,0,275000,1821,151
"5816","18285","2021",2,2,0,47500,785.5,63
"5817","18286","2021",11,11,0,77677.2727272727,991.909090909091,82.9090909090909
"5818","18287","2021",14,14,0,98364.2857142857,1197.92857142857,84.1428571428571
"5819","18288","2021",1,1,0,116000,1589,73
"5820","18289","2021",10,10,0,120496.2,1346.3,90.6
"5821","18290","2021",8,8,0,153501.25,1229,117.125
"5822","19001","2021",7,7,0,149857.142857143,1266.14285714286,131.428571428571
"5823","19002","2021",4,4,0,111687.5,1176,98.25
"5824","19003","2021",3,3,0,181333.333333333,1537,121
"5825","19004","2021",12,12,0,106333.333333333,1096.41666666667,100.583333333333
"5826","19005","2021",65,63,2,158024.892307692,1448.96923076923,108.615384615385
"5827","19007","2021",22,22,0,176230.454545455,1718.54545454545,103.409090909091
"5828","19008","2021",6,6,0,89616.6666666667,1231,71.8333333333333
"5829","19010","2021",45,44,1,105503.822222222,1173.42222222222,93.9555555555555
"5830","19011","2021",26,22,4,106228.076923077,1222.61538461538,90.8846153846154
"5831","19012","2021",6,6,0,83641.6666666667,1096.83333333333,78.5
"5832","19013","2021",15,15,0,171275,1527.8,110.866666666667
"5833","19014","2021",7,7,0,73285.7142857143,949.285714285714,80.4285714285714
"5834","19015","2021",14,14,0,161389.642857143,1452.57142857143,111.571428571429
"5835","19016","2021",3,2,1,95764.3333333333,1376.66666666667,69
"5836","19017","2021",3,2,1,172866.666666667,2480.33333333333,73.3333333333333
"5837","19018","2021",5,5,0,70300,784,91.6
"5838","19019","2021",30,26,4,117821.133333333,1204.4,96.7
"5839","19020","2021",2,2,0,74250,1125.5,70
"5840","19022","2021",2,2,0,98270,1537,62.5
"5841","19023","2021",13,13,0,112165.384615385,1170.30769230769,91.6153846153846
"5842","19024","2021",8,8,0,146333.125,1218.125,136.375
"5843","19025","2021",8,8,0,147496.25,1327,119.375
"5844","19026","2021",5,5,0,129800,1190.8,108
"5845","19027","2021",3,3,0,132333.333333333,980.666666666667,146.333333333333
"5846","19028","2021",47,41,6,78088.7234042553,869.765957446809,91.8723404255319
"5847","19029","2021",8,8,0,212601.75,1854.5,108.25
"5848","19030","2021",14,14,0,142895.714285714,1503,94.3571428571429
"5849","19031","2021",945,487,458,137168.717460317,1750.36613756614,78.0126984126984
"5850","19033","2021",24,22,2,70647.0416666667,806.625,90.8333333333333
"5851","19034","2021",8,8,0,111340,1453.125,76.75
"5852","19035","2021",7,7,0,157228.571428571,2231.14285714286,81.7142857142857
"5853","19036","2021",37,35,2,100414.324324324,1180.16216216216,91.2702702702703
"5854","19037","2021",23,23,0,149593,1447.4347826087,106.652173913043
"5855","19038","2021",12,12,0,119916.666666667,1271.08333333333,100.333333333333
"5856","19039","2021",1,1,0,46000,708,65
"5857","19040","2021",1,1,0,190950,1055,181
"5858","19041","2021",9,9,0,107866.666666667,1031.33333333333,103.555555555556
"5859","19042","2021",3,3,0,109666.666666667,1058.66666666667,101
"5860","19043","2021",4,4,0,179757.5,1924.75,85.5
"5861","19044","2021",8,8,0,122250,1300.125,95.75
"5862","19045","2021",2,2,0,149652,2417,78.5
"5863","19046","2021",1,1,0,2e+05,2041,98
"5864","19047","2021",3,3,0,99800,1326.66666666667,78.6666666666667
"5865","19048","2021",3,2,1,164946.666666667,2030.66666666667,97
"5866","19049","2021",12,12,0,116595.666666667,1846.66666666667,63.5833333333333
"5867","19050","2021",1,1,0,225823,1636,138
"5868","19051","2021",4,3,1,89500,1315.5,82.75
"5869","19052","2021",1,1,0,72270,723,100
"5870","19053","2021",1,1,0,74000,587,126
"5871","19054","2021",5,5,0,131660,1564,89.8
"5872","19055","2021",3,3,0,119923.333333333,929.666666666667,124.333333333333
"5873","19056","2021",5,5,0,102200,1195.2,84
"5874","19057","2021",10,10,0,244758,3532.1,86.2
"5875","19058","2021",5,5,0,99140,1222.2,88.6
"5876","19059","2021",4,4,0,74327.5,1308.75,60.75
"5877","19060","2021",11,10,1,143347.727272727,1601.36363636364,89
"5878","19061","2021",11,9,2,83454.5454545455,1043.36363636364,80.6363636363636
"5879","19062","2021",19,19,0,112051.578947368,1101.63157894737,102
"5880","19063","2021",35,30,5,205252.657142857,2113.54285714286,111.485714285714
"5881","19064","2021",1,1,0,249600,2355,106
"5882","19066","2021",35,30,5,120563.942857143,1390.85714285714,83.5142857142857
"5883","19067","2021",4,4,0,193537.5,1300.25,123.75
"5884","19068","2021",7,7,0,165058.571428571,1690,108.428571428571
"5885","19069","2021",1,1,0,30800,684,45
"5886","19070","2021",5,5,0,84700,867,110.8
"5887","19071","2021",6,5,1,110358.666666667,1118,98.1666666666667
"5888","19072","2021",33,32,1,132516.363636364,1427.57575757576,93.7575757575758
"5889","19073","2021",40,35,5,98011.25,1068.45,95.3
"5890","19074","2021",2,2,0,91625,807,115
"5891","19075","2021",13,13,0,78780.7692307692,1142.46153846154,69.6923076923077
"5892","19076","2021",4,4,0,140800,1173.25,106.75
"5893","19077","2021",3,3,0,169566.666666667,1298.33333333333,121.666666666667
"5894","19078","2021",8,8,0,118906.25,1455.125,90.75
"5895","19079","2021",8,8,0,116231.25,1260.375,97
"5896","19080","2021",5,4,1,93674,1226,91
"5897","19081","2021",8,8,0,131090.125,1054.5,127.125
"5898","19082","2021",16,16,0,167453.6875,1760.5625,95.8125
"5899","19083","2021",3,3,0,165796.666666667,1171.33333333333,134
"5900","19084","2021",9,9,0,90719.6666666667,1335.77777777778,70.1111111111111
"5901","19085","2021",6,6,0,147166.666666667,1367.66666666667,108.5
"5902","19086","2021",8,8,0,71492,905.5,83.875
"5903","19087","2021",3,3,0,58366.6666666667,586,102
"5904","19088","2021",2,2,0,130000,1134.5,115
"5905","19089","2021",9,9,0,108853.555555556,1032.55555555556,109.333333333333
"5906","19090","2021",2,2,0,1e+05,1500,72
"5907","19091","2021",2,2,0,117500,1357.5,87
"5908","19093","2021",11,11,0,199172.727272727,1509.36363636364,117.727272727273
"5909","19094","2021",20,19,1,117075.5,1306.5,103.45
"5910","19095","2021",5,5,0,69400,763.6,89.4
"5911","19096","2021",2,2,0,85000,820,106.5
"5912","19097","2021",2,2,0,67500,900,70
"5913","19098","2021",8,8,0,117512.5,1169.125,97.875
"5914","19099","2021",4,4,0,187500,1733.75,105.75
"5915","19100","2021",9,9,0,109863.333333333,1145.77777777778,100.666666666667
"5916","19101","2021",15,14,1,99643.4666666667,1213.86666666667,82
"5917","19102","2021",7,6,1,109000,1222.14285714286,90.8571428571429
"5918","19103","2021",1,1,0,81000,1110,73
"5919","19105","2021",6,6,0,111316.666666667,1303.33333333333,79
"5920","19106","2021",5,5,0,83480,1269,66.2
"5921","19107","2021",23,16,7,132934.130434783,1747.52173913043,75.8695652173913
"5922","19109","2021",1,1,0,149300,1641,91
"5923","19110","2021",1,1,0,61000,871,70
"5924","19112","2021",2,2,0,161000,1972.5,83
"5925","19113","2021",18,18,0,94697.2222222222,1530.38888888889,79.3888888888889
"5926","19114","2021",1,1,0,130000,1016,128
"5927","19115","2021",8,8,0,203325,1844.625,108.625
"5928","19117","2021",12,12,0,138077.333333333,1672.25,83.0833333333333
"5929","19118","2021",16,16,0,80038.75,1054.5625,76.125
"5930","19120","2021",3,3,0,204083.333333333,1790.66666666667,116
"5931","19121","2021",35,35,0,127903.314285714,1147.34285714286,116.942857142857
"5932","19122","2021",6,6,0,91333.3333333333,952.166666666667,99.3333333333333
"5933","19123","2021",147,92,55,136188.714285714,1647.81632653061,81.0068027210884
"5934","19124","2021",20,20,0,136025,1624.8,86.85
"5935","19125","2021",17,17,0,144533.470588235,1696.29411764706,84.1176470588235
"5936","19126","2021",5,5,0,170300,2007,80.2
"5937","19128","2021",5,5,0,134960,1342.6,107.6
"5938","19129","2021",21,21,0,111681.428571429,1094.33333333333,103.428571428571
"5939","19130","2021",11,11,0,106705.909090909,1225.54545454545,94.2727272727273
"5940","19131","2021",15,15,0,100890,1143.93333333333,100.6
"5941","19132","2021",1,0,1,115000,1438,80
"5942","19133","2021",1,1,0,169000,1374,123
"5943","19134","2021",8,6,2,99737.5,1284.5,72.125
"5944","19135","2021",6,6,0,96033.3333333333,1011,89.5
"5945","19136","2021",32,30,2,111367.1875,1105.28125,101.46875
"5946","19138","2021",20,19,1,138017.5,1726.85,83.65
"5947","19139","2021",2,2,0,96250,1168.5,85
"5948","19140","2021",11,11,0,107590.909090909,1226.45454545455,83
"5949","19142","2021",2,2,0,115500,1975,57.5
"5950","19143","2021",6,6,0,120416.666666667,1141,106.666666666667
"5951","19144","2021",4,4,0,108750,1666.25,78.5
"5952","19145","2021",5,5,0,122160,1240.8,96.2
"5953","19146","2021",26,25,1,126313.5,1316.73076923077,95.0384615384615
"5954","19147","2021",10,10,0,124120,1579.1,84.8
"5955","19148","2021",20,19,1,74080,996.6,75.8
"5956","19149","2021",7,7,0,119026.857142857,1256.85714285714,94.2857142857143
"5957","19150","2021",6,6,0,160916.666666667,1983.33333333333,82.3333333333333
"5958","19151","2021",9,9,0,190766.666666667,1972.88888888889,95.4444444444444
"5959","19152","2021",8,8,0,155957.5,1929.625,79.375
"5960","19153","2021",57,43,14,128152.631578947,1449.22807017544,89.280701754386
"5961","19154","2021",8,8,0,133713.75,1334.25,108.875
"5962","19155","2021",3,3,0,128833.333333333,962.666666666667,126.333333333333
"5963","19157","2021",4,4,0,71750,1218,62
"5964","19158","2021",5,5,0,103300,1225.6,96.2
"5965","19159","2021",1,1,0,68000,1000,68
"5966","19160","2021",7,7,0,91571.4285714286,1028.14285714286,93.4285714285714
"5967","19161","2021",9,9,0,160280,1657.55555555556,100.111111111111
"5968","19162","2021",19,19,0,157133.157894737,1412.47368421053,114.105263157895
"5969","19163","2021",7,7,0,123681.428571429,1897.57142857143,60.8571428571429
"5970","19164","2021",18,17,1,92221.6666666667,1330.38888888889,83.7222222222222
"5971","19165","2021",5,5,0,44660,630.6,75
"5972","19169","2021",6,6,0,150408.333333333,1530.33333333333,101
"5973","19170","2021",3,3,0,172666.666666667,1569.66666666667,102.333333333333
"5974","19171","2021",2,2,0,85400,972.5,88
"5975","19172","2021",3,3,0,149106.666666667,1206.33333333333,117.666666666667
"5976","19173","2021",3,3,0,59233.3333333333,781.666666666667,76.6666666666667
"5977","19174","2021",4,4,0,48750,770.25,61
"5978","19175","2021",3,3,0,151703.333333333,1176.66666666667,121.666666666667
"5979","19176","2021",8,8,0,133312.5,1177.875,115.125
"5980","19177","2021",1,1,0,34000,1214,28
"5981","19178","2021",10,10,0,159640,1603.2,100.6
"5982","19180","2021",5,5,0,99054,1100.6,101.4
"5983","19181","2021",9,9,0,133366.666666667,1368.66666666667,103.444444444444
"5984","19182","2021",11,10,1,131127.272727273,1365.54545454545,94.3636363636364
"5985","19184","2021",4,4,0,172372,1607,116
"5986","19186","2021",3,3,0,86400,1236.33333333333,73
"5987","19187","2021",7,7,0,147757.142857143,1198.85714285714,124
"5988","19188","2021",5,5,0,1e+05,1771.6,53
"5989","19189","2021",2,2,0,44000,758.5,55
"5990","19190","2021",2,2,0,57500,697,107
"5991","19191","2021",16,16,0,173675,1559,109.25
"5992","19192","2021",10,10,0,97000,881.3,114.2
"5993","19193","2021",4,4,0,58902.5,693.25,92.75
"5994","19194","2021",20,20,0,130007.5,1558.65,87.8
"5995","19195","2021",2,2,0,115525,1434,106.5
"5996","19196","2021",8,8,0,102537.5,1222.25,90.125
"5997","19198","2021",3,2,1,153320,1828.33333333333,84
"5998","19199","2021",1,1,0,86420,1080,80
"5999","19201","2021",4,4,0,151575,1373,108
"6000","19202","2021",17,16,1,165551.411764706,1567.88235294118,105.235294117647
"6001","19203","2021",15,15,0,126470.133333333,1312.4,94.9333333333333
"6002","19204","2021",2,2,0,101600,833.5,106
"6003","19205","2021",1,1,0,117000,1000,117
"6004","19207","2021",13,13,0,114744.615384615,1377.76923076923,85.9230769230769
"6005","19208","2021",1,1,0,87600,584,150
"6006","19209","2021",4,4,0,147151.25,1407.75,98.75
"6007","19211","2021",8,8,0,117818.25,1586.75,78.5
"6008","19212","2021",2,2,0,109860,1746.5,60
"6009","19213","2021",5,5,0,82000,1138.4,75.2
"6010","19214","2021",12,11,1,108883,1098.16666666667,90.3333333333333
"6011","19216","2021",3,3,0,179100,1774.66666666667,101.666666666667
"6012","19217","2021",2,2,0,120000,1417,82
"6013","19220","2021",8,8,0,84125,1107.125,79
"6014","19221","2021",1,1,0,397150,3055,130
"6015","19222","2021",14,14,0,118770.714285714,1122.78571428571,104.214285714286
"6016","19223","2021",3,3,0,145000,1156,141.666666666667
"6017","19225","2021",5,5,0,105500,1498.6,70.6
"6018","19226","2021",1,1,0,75000,852,88
"6019","19227","2021",14,14,0,149744.214285714,1457.42857142857,102.785714285714
"6020","19228","2021",3,3,0,81433.3333333333,968,86
"6021","19229","2021",47,41,6,177980.510638298,1867.44680851064,93.936170212766
"6022","19230","2021",4,4,0,137500,1323,103
"6023","19231","2021",8,8,0,92358.125,1266.375,75.5
"6024","19233","2021",1,1,0,67500,1125,60
"6025","19234","2021",9,9,0,118415,1461.88888888889,90.1111111111111
"6026","19235","2021",3,3,0,103000,1191,90.6666666666667
"6027","19236","2021",12,12,0,103320.833333333,1081.41666666667,94.8333333333333
"6028","19237","2021",20,20,0,135568.4,1362.15,103.35
"6029","19238","2021",2,2,0,103500,1398,77.5
"6030","19239","2021",13,12,1,116314.615384615,1416.84615384615,78.1538461538462
"6031","19240","2021",10,10,0,83252,876.3,93.3
"6032","19241","2021",6,6,0,94949,1075.5,96.3333333333333
"6033","19242","2021",4,4,0,119260,1595,82
"6034","19243","2021",14,13,1,101387.142857143,1474.28571428571,70.8571428571429
"6035","19245","2021",7,7,0,108711.571428571,1215.57142857143,96
"6036","19246","2021",15,15,0,201134.333333333,1922.33333333333,105.733333333333
"6037","19247","2021",3,3,0,145616.666666667,1447.66666666667,102.666666666667
"6038","19248","2021",8,8,0,130528.5,1314.375,108.5
"6039","19249","2021",3,3,0,64500,783,84
"6040","19250","2021",5,5,0,81981.6,1226.2,67.6
"6041","19251","2021",4,4,0,80850,733.75,121
"6042","19252","2021",10,10,0,94089.2,835,117
"6043","19253","2021",6,6,0,124288.333333333,1507.33333333333,82
"6044","19254","2021",11,11,0,120882.727272727,1626.45454545455,74.6363636363636
"6045","19255","2021",30,30,0,151163.766666667,1411.33333333333,111.2
"6046","19256","2021",7,7,0,77916.7142857143,981.285714285714,83.1428571428571
"6047","19257","2021",4,4,0,121195,1300.5,87
"6048","19258","2021",7,7,0,110521.428571429,1429.57142857143,80
"6049","19259","2021",3,3,0,170716.666666667,1806.66666666667,89.3333333333333
"6050","19260","2021",7,7,0,154000,1857.71428571429,87.2857142857143
"6051","19261","2021",11,11,0,68863.6363636364,877.272727272727,89.7272727272727
"6052","19262","2021",3,3,0,100666.666666667,1153.66666666667,86.6666666666667
"6053","19263","2021",7,7,0,114642.857142857,1115.14285714286,103.857142857143
"6054","19264","2021",10,10,0,88640,1154.7,73.9
"6055","19265","2021",6,6,0,86000,1188.66666666667,78
"6056","19266","2021",2,2,0,30000,528,58
"6057","19269","2021",42,42,0,90479.5238095238,988.47619047619,97.9047619047619
"6058","19270","2021",12,12,0,152362.5,1608,96.3333333333333
"6059","19271","2021",3,3,0,128000,1255.66666666667,100.666666666667
"6060","19272","2021",225,112,113,81267.3511111111,981.733333333333,83.5333333333333
"6061","19273","2021",11,11,0,232010.909090909,2430.63636363636,104.909090909091
"6062","19274","2021",63,49,14,190947.523809524,1854.42857142857,103.412698412698
"6063","19275","2021",120,101,19,108991.566666667,1179.96666666667,92.0833333333333
"6064","19276","2021",25,23,2,112360.4,1133.2,97.44
"6065","19277","2021",1,1,0,117500,1040,113
"6066","19278","2021",27,27,0,193887,1762.74074074074,107
"6067","19279","2021",4,4,0,70205.5,936.25,73.25
"6068","19280","2021",4,4,0,142300,1524.75,95
"6069","19281","2021",1,1,0,294249,2750,107
"6070","19284","2021",5,5,0,106863,1283.6,80.4
"6071","19285","2021",17,17,0,117881.470588235,1410.17647058824,87.2941176470588
"6072","19286","2021",13,13,0,100430.769230769,1282.07692307692,93.3076923076923
"6073","19287","2021",2,2,0,166000,1834.5,90.5
"6074","19288","2021",15,15,0,166935,1590.8,105.8
"6075","19289","2021",2,2,0,117000,1175,84
"6076","21001","2021",1,1,0,127000,2540,50
"6077","21002","2021",1,1,0,165000,1701,97
"6078","21003","2021",20,10,10,284932,3033.3,90.55
"6079","21004","2021",7,7,0,83691.7142857143,823,102
"6080","21005","2021",30,25,5,208217.933333333,2152.86666666667,101.366666666667
"6081","21006","2021",4,4,0,75083.25,1102.25,72.25
"6082","21007","2021",4,4,0,154625,1226,120
"6083","21008","2021",6,6,0,107666.666666667,1088.66666666667,102.666666666667
"6084","21009","2021",3,3,0,89100,973.666666666667,89.3333333333333
"6085","21010","2021",1,1,0,397000,1588,250
"6086","21012","2021",1,1,0,110000,973,113
"6087","21013","2021",3,2,1,195493.333333333,1791.66666666667,105.666666666667
"6088","21014","2021",1,1,0,70000,1273,55
"6089","21015","2021",2,2,0,44500,668.5,68
"6090","21016","2021",6,4,2,247166.666666667,2130.16666666667,105.166666666667
"6091","21017","2021",12,12,0,251943.333333333,2091.41666666667,121.083333333333
"6092","21020","2021",3,3,0,199333.333333333,1346,155
"6093","21021","2021",39,36,3,274265.820512821,2481.89743589744,112.769230769231
"6094","21022","2021",4,4,0,273725,1624.5,173.5
"6095","21023","2021",21,20,1,121507.142857143,1111.28571428571,112.52380952381
"6096","21025","2021",2,2,0,106000,1006,109
"6097","21026","2021",2,2,0,3e+05,1496.5,214
"6098","21027","2021",14,13,1,409111.5,2913.5,144.214285714286
"6099","21028","2021",6,6,0,163483.333333333,1700.33333333333,96.1666666666667
"6100","21029","2021",2,2,0,215400,1382,153.5
"6101","21030","2021",1,1,0,45000,634,71
"6102","21031","2021",4,4,0,226862.5,1945.5,128.25
"6103","21032","2021",1,1,0,160200,1252,128
"6104","21033","2021",2,2,0,196650,1652.5,127
"6105","21034","2021",1,1,0,156000,867,180
"6106","21035","2021",5,5,0,132168,1681.6,76.8
"6107","21036","2021",1,1,0,73000,593,123
"6108","21037","2021",8,8,0,251537.5,2769.5,94.75
"6109","21038","2021",82,45,37,141831.097560976,1523.67073170732,91.5365853658537
"6110","21040","2021",2,2,0,133250,1134.5,113.5
"6111","21041","2021",1,1,0,169800,1572,108
"6112","21042","2021",2,2,0,185000,1492,119.5
"6113","21043","2021",3,3,0,78000,621,127.333333333333
"6114","21044","2021",1,1,0,175000,1215,144
"6115","21045","2021",4,4,0,129492.5,1407.75,96.75
"6116","21046","2021",5,5,0,135260,1116.8,118.8
"6117","21048","2021",9,9,0,312233.333333333,2872.88888888889,109.333333333333
"6118","21049","2021",1,1,0,146200,1052,139
"6119","21050","2021",8,7,1,188063.75,1914.125,97
"6120","21051","2021",3,3,0,175850,1800,99.6666666666667
"6121","21053","2021",3,3,0,119250,1061,103.333333333333
"6122","21054","2021",329,135,194,211022.638297872,2496.79939209726,83.209726443769
"6123","21056","2021",8,7,1,265100,2445.75,107.5
"6124","21057","2021",6,6,0,205325.5,2044.83333333333,96.5
"6125","21058","2021",3,3,0,70000,444,146.333333333333
"6126","21059","2021",6,5,1,261866.666666667,2640,97
"6127","21060","2021",24,24,0,230640.625,2331.33333333333,100.708333333333
"6128","21061","2021",1,1,0,72000,706,102
"6129","21062","2021",6,6,0,142941.666666667,1270.83333333333,120
"6130","21063","2021",3,3,0,156193.333333333,1206.66666666667,124
"6131","21064","2021",1,1,0,78000,1950,40
"6132","21066","2021",2,2,0,31284.5,1564.5,20
"6133","21067","2021",5,5,0,233390,2205.8,109.6
"6134","21070","2021",1,1,0,151418,3155,48
"6135","21071","2021",10,10,0,207617.6,2408.6,94.5
"6136","21074","2021",5,5,0,194200,1500.2,134.2
"6137","21075","2021",1,1,0,149800,1248,120
"6138","21076","2021",14,14,0,200362.142857143,2241.92857142857,101.785714285714
"6139","21078","2021",1,1,0,38800,808,48
"6140","21080","2021",10,10,0,135920,1441.9,95.4
"6141","21081","2021",1,1,0,40000,833,48
"6142","21083","2021",1,1,0,155000,1435,108
"6143","21084","2021",2,2,0,129470,1046.5,124.5
"6144","21086","2021",15,15,0,326711.666666667,2641.06666666667,118.6
"6145","21087","2021",12,10,2,112544.166666667,1271.41666666667,86.0833333333333
"6146","21088","2021",3,3,0,208503.333333333,2306.66666666667,90.3333333333333
"6147","21089","2021",8,8,0,182168.75,1621.875,112.25
"6148","21090","2021",2,2,0,68550,405.5,164
"6149","21091","2021",2,2,0,91000,1261,74.5
"6150","21092","2021",2,2,0,143700,1730.5,86.5
"6151","21093","2021",1,1,0,192000,1714,112
"6152","21094","2021",4,4,0,205750,1626.5,124.5
"6153","21095","2021",1,1,0,98000,933,105
"6154","21096","2021",2,2,0,103500,745,140.5
"6155","21098","2021",1,1,0,245000,1644,149
"6156","21100","2021",2,2,0,122500,1234,97.5
"6157","21101","2021",2,2,0,107000,1025,102.5
"6158","21102","2021",2,2,0,110000,1074,99
"6159","21103","2021",30,28,2,203443.3,2116.26666666667,105.3
"6160","21105","2021",15,15,0,253033.6,2200.8,117.8
"6161","21106","2021",8,8,0,262500,2653.625,100.25
"6162","21107","2021",6,5,1,261506.666666667,2798.16666666667,93.6666666666667
"6163","21109","2021",3,3,0,63333.3333333333,709.333333333333,85.6666666666667
"6164","21110","2021",10,10,0,270570,2812.3,93.3
"6165","21111","2021",3,3,0,260183.333333333,2000.66666666667,135.333333333333
"6166","21112","2021",9,9,0,192634.444444444,1943.22222222222,103.111111111111
"6167","21113","2021",2,2,0,701000,5391,123
"6168","21114","2021",1,1,0,140000,1867,75
"6169","21115","2021",6,6,0,89666.6666666667,1031.33333333333,89
"6170","21116","2021",1,1,0,45000,536,84
"6171","21117","2021",3,3,0,104400,1044,100
"6172","21120","2021",4,4,0,104200,1191.5,85.5
"6173","21121","2021",1,1,0,50000,1190,42
"6174","21122","2021",4,4,0,93287.5,848.5,120.5
"6175","21123","2021",1,1,0,170960,770,222
"6176","21124","2021",1,1,0,123000,992,124
"6177","21125","2021",2,2,0,106900,809.5,127.5
"6178","21126","2021",1,0,1,1e+05,1163,86
"6179","21127","2021",4,4,0,229916.25,1776.25,130
"6180","21128","2021",3,3,0,73000,845.666666666667,91
"6181","21130","2021",6,6,0,198416.666666667,1995.16666666667,99.8333333333333
"6182","21131","2021",5,5,0,158284,1422,112
"6183","21132","2021",6,6,0,245875,2272,113.333333333333
"6184","21133","2021",5,5,0,151880,1501.4,123.8
"6185","21134","2021",1,1,0,76000,905,84
"6186","21135","2021",4,4,0,121087.5,1344,86.25
"6187","21138","2021",4,4,0,148325,1665,86.25
"6188","21139","2021",5,5,0,115600,1115.8,123.4
"6189","21140","2021",3,3,0,151583.333333333,1414.66666666667,96.3333333333333
"6190","21141","2021",1,1,0,46830,1561,30
"6191","21143","2021",1,1,0,69000,1131,61
"6192","21145","2021",1,1,0,150000,1630,92
"6193","21146","2021",1,1,0,1e+05,1205,83
"6194","21148","2021",9,9,0,180588.888888889,1383.44444444444,137.444444444444
"6195","21149","2021",1,1,0,17000,447,38
"6196","21150","2021",7,7,0,202828.571428571,3285.71428571429,94.5714285714286
"6197","21151","2021",1,1,0,150000,1364,110
"6198","21152","2021",4,4,0,89975,993,86.5
"6199","21154","2021",68,34,34,84141.8970588235,1029.48529411765,77.7941176470588
"6200","21155","2021",1,1,0,238100,980,243
"6201","21156","2021",1,1,0,44225,2010,22
"6202","21157","2021",1,1,0,1e+05,862,116
"6203","21158","2021",2,2,0,241500,1732,128.5
"6204","21159","2021",2,2,0,116905,1095,108
"6205","21160","2021",2,2,0,174500,1397,135
"6206","21162","2021",3,3,0,170833.333333333,1685.33333333333,99.3333333333333
"6207","21163","2021",7,7,0,120685.714285714,1391.57142857143,82.7142857142857
"6208","21164","2021",2,2,0,213000,1433,146.5
"6209","21166","2021",201,50,151,128456.810945274,1678.98507462687,75.2587064676617
"6210","21167","2021",1,1,0,159800,1278,125
"6211","21169","2021",1,1,0,280000,1750,160
"6212","21170","2021",10,10,0,195485,1683.7,115.3
"6213","21171","2021",170,50,120,179025.058823529,2433.46470588235,74.6705882352941
"6214","21172","2021",6,6,0,167597.666666667,1095,157.5
"6215","21173","2021",3,3,0,141166.666666667,1433.66666666667,94.3333333333333
"6216","21175","2021",2,2,0,284450,2123,139.5
"6217","21176","2021",2,2,0,179022.5,1638,117
"6218","21177","2021",4,4,0,135250,1203.75,102.25
"6219","21178","2021",3,3,0,151683.333333333,2191.33333333333,67.3333333333333
"6220","21179","2021",8,8,0,403750,2544.75,167.75
"6221","21181","2021",1,1,0,69000,734,94
"6222","21182","2021",1,1,0,150000,1786,84
"6223","21183","2021",8,8,0,232681.25,2438.125,97.25
"6224","21185","2021",7,7,0,239440,2401,99.2857142857143
"6225","21186","2021",12,11,1,179495.833333333,2095.58333333333,83.75
"6226","21187","2021",1,1,0,104425,1392,75
"6227","21189","2021",6,6,0,196383.333333333,1793,123.666666666667
"6228","21190","2021",2,2,0,207650,2277.5,91
"6229","21191","2021",17,17,0,245026.470588235,2325.41176470588,116.411764705882
"6230","21192","2021",12,12,0,315579.166666667,2659.33333333333,117.416666666667
"6231","21193","2021",2,2,0,268485,2036,136
"6232","21194","2021",12,11,1,176086.083333333,1756.25,101.083333333333
"6233","21195","2021",4,4,0,150162.5,1211.25,115.5
"6234","21196","2021",12,12,0,187179.166666667,2149.91666666667,96
"6235","21198","2021",1,1,0,160500,1146,140
"6236","21200","2021",16,16,0,290075,2339.75,127.125
"6237","21201","2021",2,2,0,53500,605,90
"6238","21202","2021",3,3,0,63166.3333333333,552.333333333333,117.333333333333
"6239","21203","2021",8,8,0,105750,1171.5,92
"6240","21204","2021",1,1,0,36000,643,56
"6241","21205","2021",3,3,0,147233.333333333,1385.33333333333,107.666666666667
"6242","21207","2021",3,3,0,102450,753.333333333333,138.333333333333
"6243","21208","2021",2,2,0,250275,2504,100.5
"6244","21209","2021",20,19,1,319993.6,2513.95,129.45
"6245","21210","2021",7,7,0,113124.857142857,1264.42857142857,93.5714285714286
"6246","21212","2021",6,6,0,112050,1055.16666666667,108.166666666667
"6247","21214","2021",2,2,0,76000,1346.5,70.5
"6248","21215","2021",1,1,0,149000,1620,92
"6249","21216","2021",2,2,0,77975,1009,106.5
"6250","21217","2021",1,1,0,250000,3012,83
"6251","21219","2021",5,5,0,165444,1961.6,90.4
"6252","21220","2021",6,6,0,94738.3333333333,941,103.166666666667
"6253","21221","2021",1,0,1,190000,1180,161
"6254","21222","2021",2,2,0,89750,1106,87.5
"6255","21223","2021",15,8,7,472856.666666667,4130.73333333333,115.8
"6256","21226","2021",6,6,0,173050,1402.66666666667,127.166666666667
"6257","21227","2021",4,4,0,312625,2528.5,127.25
"6258","21228","2021",2,2,0,158820,1553,101
"6259","21229","2021",1,1,0,230000,1608,143
"6260","21230","2021",4,4,0,195275,1605.75,125.5
"6261","21231","2021",3570,467,3103,164984.796638655,2646.78263305322,62.3859943977591
"6262","21232","2021",1,1,0,26500,697,38
"6263","21233","2021",4,4,0,151075,1051,143.75
"6264","21234","2021",2,2,0,109500,1171.5,86.5
"6265","21236","2021",2,2,0,199500,2451,82
"6266","21237","2021",1,1,0,115000,1075,107
"6267","21238","2021",3,3,0,246056.333333333,1555.66666666667,170.666666666667
"6268","21239","2021",9,9,0,189124,1660.11111111111,120.444444444444
"6269","21240","2021",3,2,1,151483.333333333,1649.66666666667,88.3333333333333
"6270","21241","2021",1,1,0,366000,1839,199
"6271","21242","2021",7,7,0,145333.714285714,1740.28571428571,86
"6272","21243","2021",3,3,0,164333.333333333,1147.33333333333,120
"6273","21245","2021",5,5,0,308660,2367,137.2
"6274","21246","2021",1,1,0,344000,1703,202
"6275","21247","2021",11,10,1,109489,1152.18181818182,98.1818181818182
"6276","21248","2021",1,1,0,120000,902,133
"6277","21249","2021",8,7,1,169875,1662.5,100.25
"6278","21251","2021",12,10,2,147770.833333333,1417.25,103.583333333333
"6279","21252","2021",2,2,0,128500,1289.5,101.5
"6280","21254","2021",2,2,0,185125,1957,94.5
"6281","21256","2021",2,2,0,256315,1071.5,212
"6282","21257","2021",3,3,0,91333.3333333333,982.666666666667,92
"6283","21258","2021",1,1,0,161500,1262,128
"6284","21259","2021",1,1,0,199000,1970,101
"6285","21261","2021",4,4,0,291537.5,2373,122.75
"6286","21263","2021",12,12,0,322417.5,2404.16666666667,133.416666666667
"6287","21265","2021",6,6,0,297883.333333333,2735.5,110
"6288","21266","2021",4,4,0,233162.5,1445,159.25
"6289","21267","2021",2,2,0,253680,1727,145.5
"6290","21268","2021",4,4,0,201000,1487.75,140.75
"6291","21269","2021",9,9,0,189562.222222222,1439.77777777778,128.222222222222
"6292","21270","2021",3,3,0,373366.666666667,2540,158.333333333333
"6293","21271","2021",8,8,0,120212.5,1286.375,114
"6294","21272","2021",7,7,0,148857.142857143,1035.28571428571,132.285714285714
"6295","21273","2021",15,15,0,287496.666666667,2747.53333333333,111.133333333333
"6296","21275","2021",2,2,0,247000,1437.5,170
"6297","21276","2021",2,2,0,69500,761,86.5
"6298","21277","2021",10,10,0,128994,1376.1,99.2
"6299","21278","2021",142,73,69,285891.028169014,2985.64788732394,93.7253521126761
"6300","21279","2021",2,2,0,40750,450,87
"6301","21281","2021",2,2,0,200775,1573.5,145.5
"6302","21282","2021",2,2,0,160000,1021,155
"6303","21283","2021",1,1,0,125480,697,180
"6304","21284","2021",4,4,0,207680,1791.75,121.5
"6305","21285","2021",1,1,0,125000,1838,68
"6306","21286","2021",2,2,0,272100,1934,136.5
"6307","21287","2021",2,2,0,92760.5,841.5,94.5
"6308","21288","2021",3,3,0,121866.666666667,1089.33333333333,96
"6309","21289","2021",5,5,0,128800,1488,88.4
"6310","21290","2021",24,21,3,191260.625,1972.70833333333,97.5833333333333
"6311","21291","2021",7,7,0,111976.428571429,1192,93.7142857142857
"6312","21292","2021",68,49,19,177651.029411765,2012.05882352941,88.25
"6313","21293","2021",1,1,0,165000,1755,94
"6314","21294","2021",9,9,0,235229,1992.22222222222,118.888888888889
"6315","21295","2021",38,23,15,212314.973684211,2548.39473684211,84.0526315789474
"6316","21296","2021",3,3,0,55250,474.666666666667,110.333333333333
"6317","21297","2021",3,2,1,329700,2778,120.333333333333
"6318","21299","2021",2,2,0,91000,1250,70.5
"6319","21300","2021",8,8,0,144412.5,1395.75,103.125
"6320","21301","2021",5,5,0,175400,1622.8,105.2
"6321","21302","2021",1,1,0,115750,1135,102
"6322","21305","2021",1,1,0,80000,580,138
"6323","21306","2021",1,1,0,50000,909,55
"6324","21307","2021",2,2,0,154625,1146.5,134
"6325","21308","2021",1,1,0,260000,1733,150
"6326","21310","2021",3,3,0,123333.333333333,1034.66666666667,112
"6327","21314","2021",1,1,0,105000,1105,95
"6328","21315","2021",14,14,0,423262.5,3120.21428571429,139.5
"6329","21316","2021",7,7,0,116117.857142857,1363.28571428571,80.4285714285714
"6330","21317","2021",46,40,6,234677.543478261,1987.26086956522,121.739130434783
"6331","21319","2021",8,8,0,233239.375,2379.375,109.75
"6332","21320","2021",7,7,0,266184.285714286,2964.57142857143,113.714285714286
"6333","21322","2021",3,3,0,97900,971,99
"6334","21323","2021",1,1,0,235300,1176,200
"6335","21325","2021",4,4,0,112830,1235,97.5
"6336","21326","2021",1,1,0,80000,559,143
"6337","21327","2021",5,5,0,172530,1355.8,130.2
"6338","21328","2021",1,1,0,86500,786,110
"6339","21330","2021",1,1,0,188850,2222,85
"6340","21331","2021",5,5,0,112998.6,1307.2,83.2
"6341","21332","2021",10,10,0,167064,1470.5,121.8
"6342","21333","2021",4,4,0,185001.25,1684.75,112.5
"6343","21334","2021",2,2,0,36500,553.5,66
"6344","21335","2021",1,1,0,83000,1221,68
"6345","21336","2021",7,7,0,75300,620,125.857142857143
"6346","21337","2021",30,29,1,147313.1,1660.63333333333,98.0666666666667
"6347","21338","2021",2,2,0,135300,906,140
"6348","21339","2021",5,5,0,234600,2133,118.8
"6349","21340","2021",2,2,0,106500,841,122.5
"6350","21341","2021",1,1,0,140000,1167,120
"6351","21342","2021",5,5,0,136360,1044.6,138.6
"6352","21343","2021",3,3,0,83333.3333333333,1135,75.6666666666667
"6353","21344","2021",5,5,0,114500,1248.6,88.8
"6354","21345","2021",6,6,0,82223.3333333333,1045.16666666667,78.6666666666667
"6355","21346","2021",2,2,0,107500,833,119
"6356","21347","2021",1,1,0,250000,2577,97
"6357","21348","2021",1,1,0,70500,1762,40
"6358","21349","2021",4,4,0,103979.25,1099.5,103.5
"6359","21350","2021",1,1,0,150000,1364,110
"6360","21351","2021",11,11,0,186247.272727273,1813.63636363636,100.545454545455
"6361","21352","2021",21,21,0,231089.285714286,1997.42857142857,122.952380952381
"6362","21353","2021",14,14,0,252088.928571429,2442.5,104.357142857143
"6363","21354","2021",1,1,0,305000,2007,152
"6364","21355","2021",131,47,84,178809.351145038,2360.58778625954,75.0534351145038
"6365","21356","2021",28,26,2,160855.392857143,1561.25,105.857142857143
"6366","21358","2021",2,2,0,82500,745,106.5
"6367","21359","2021",1,1,0,50000,388,129
"6368","21360","2021",3,3,0,109166.666666667,1100.33333333333,99.6666666666667
"6369","21361","2021",8,8,0,198987.5,1454.375,149.25
"6370","21363","2021",5,5,0,114030,1162.2,104
"6371","21364","2021",2,2,0,72000,641.5,108.5
"6372","21365","2021",3,3,0,127549.333333333,1339.33333333333,104.666666666667
"6373","21366","2021",3,3,0,227966.666666667,1844.66666666667,125.333333333333
"6374","21367","2021",5,5,0,164240,1905.6,88.6
"6375","21368","2021",1,1,0,196670,2210,89
"6376","21369","2021",4,4,0,181617.5,1717.25,121
"6377","21370","2021",6,6,0,227041.666666667,2122.66666666667,108.333333333333
"6378","21371","2021",6,6,0,127783.333333333,1241.5,100.333333333333
"6379","21372","2021",1,1,0,60000,612,98
"6380","21373","2021",9,9,0,255445.555555556,2415.11111111111,109.222222222222
"6381","21374","2021",3,3,0,133415,1408.66666666667,100.666666666667
"6382","21375","2021",6,6,0,74250,901.5,83.3333333333333
"6383","21377","2021",1,1,0,80000,741,108
"6384","21378","2021",1,1,0,90000,703,128
"6385","21379","2021",5,5,0,103420,938.8,122.2
"6386","21380","2021",2,2,0,55000,590,100.5
"6387","21381","2021",3,3,0,129166.666666667,895.333333333333,135
"6388","21382","2021",3,3,0,146000,2502.66666666667,81
"6389","21383","2021",20,19,1,191602.5,1858.4,101.05
"6390","21384","2021",1,1,0,135000,1107,122
"6391","21385","2021",2,2,0,125500,1164,110
"6392","21386","2021",3,3,0,195333.333333333,1246.33333333333,157.333333333333
"6393","21387","2021",2,2,0,430000,2736,135
"6394","21388","2021",3,2,1,194425.333333333,2017.66666666667,102.666666666667
"6395","21389","2021",2,2,0,99700,1075,114
"6396","21390","2021",91,87,4,231517.241758242,2539.43956043956,90.3406593406593
"6397","21391","2021",8,8,0,382467.5,2591.625,149.5
"6398","21393","2021",1,1,0,96000,384,250
"6399","21394","2021",2,2,0,125800,1428,95.5
"6400","21395","2021",2,2,0,181000,1060.5,147
"6401","21398","2021",5,5,0,159080,1560,101.8
"6402","21401","2021",1,1,0,119000,1700,70
"6403","21403","2021",2,2,0,126887.5,1093.5,113.5
"6404","21404","2021",1,1,0,16776,419,40
"6405","21407","2021",6,6,0,151715.333333333,1061.33333333333,136.5
"6406","21408","2021",25,21,4,389735.4,2976.48,129.32
"6407","21409","2021",7,7,0,260285.714285714,1938.28571428571,140.857142857143
"6408","21411","2021",5,5,0,279550,2473.2,110.6
"6409","21412","2021",17,15,2,243010,2273.58823529412,109.117647058824
"6410","21413","2021",5,5,0,167800,1860.8,94.4
"6411","21414","2021",4,4,0,146372.5,1264,118.75
"6412","21415","2021",4,4,0,82550,831.5,86.75
"6413","21416","2021",18,15,3,192306,1790.33333333333,102.555555555556
"6414","21417","2021",1,1,0,163000,652,250
"6415","21418","2021",1,1,0,85000,607,140
"6416","21419","2021",3,3,0,109466.666666667,1314.33333333333,82
"6417","21420","2021",7,7,0,77083.8571428571,1021.42857142857,78.7142857142857
"6418","21421","2021",6,6,0,161048.333333333,1427.33333333333,136.5
"6419","21422","2021",1,1,0,57500,625,92
"6420","21423","2021",6,6,0,265045,2299.66666666667,120.666666666667
"6421","21424","2021",2,2,0,153975,1089,142.5
"6422","21425","2021",73,64,9,106629.753424658,1093.83561643836,93.8219178082192
"6423","21426","2021",3,2,1,63000,621.666666666667,90.3333333333333
"6424","21427","2021",4,4,0,143487.5,1078.75,124.5
"6425","21429","2021",2,2,0,147500,1380.5,98.5
"6426","21430","2021",2,2,0,142500,1435,103
"6427","21431","2021",4,4,0,137137.5,953.75,149
"6428","21432","2021",2,2,0,75070,541,138.5
"6429","21433","2021",3,3,0,101500,1396.33333333333,75.3333333333333
"6430","21434","2021",4,4,0,163572.5,1414.5,117.75
"6431","21435","2021",1,1,0,178000,748,238
"6432","21436","2021",1,1,0,154000,1453,106
"6433","21437","2021",2,2,0,263892.5,2549,103
"6434","21438","2021",1,1,0,70000,387,181
"6435","21439","2021",2,2,0,151500,779.5,210
"6436","21440","2021",2,2,0,104000,900,129
"6437","21441","2021",6,6,0,183140,1878.66666666667,105.833333333333
"6438","21442","2021",10,9,1,258880,2383.3,103.9
"6439","21444","2021",3,3,0,93400,1042.66666666667,87.3333333333333
"6440","21445","2021",7,7,0,131285.714285714,1304.28571428571,106.857142857143
"6441","21446","2021",5,5,0,115800,1338.6,90
"6442","21449","2021",1,1,0,88000,1100,80
"6443","21450","2021",3,3,0,231333.333333333,1620,143.666666666667
"6444","21451","2021",2,2,0,24500,532.5,45
"6445","21452","2021",42,32,10,246992.380952381,2563.21428571429,97.7142857142857
"6446","21454","2021",1,1,0,1e+05,781,128
"6447","21455","2021",1,1,0,75000,1000,75
"6448","21456","2021",4,4,0,111500,1322,80.75
"6449","21457","2021",3,3,0,81000,903.666666666667,97
"6450","21458","2021",15,15,0,266930,2444.4,115.8
"6451","21459","2021",4,4,0,210437.5,1868.75,112.75
"6452","21460","2021",2,2,0,61500,945,77
"6453","21461","2021",28,27,1,138006.142857143,1474.21428571429,97.5714285714286
"6454","21462","2021",18,13,5,336829.111111111,2553.61111111111,128.722222222222
"6455","21464","2021",88,47,41,183488.420454545,2071.84090909091,87.2386363636364
"6456","21466","2021",1,1,0,102500,707,145
"6457","21467","2021",1,1,0,150000,2143,70
"6458","21468","2021",3,3,0,139963.333333333,1390,100.666666666667
"6459","21469","2021",6,6,0,239980.833333333,2276.16666666667,104.833333333333
"6460","21471","2021",1,1,0,65000,619,105
"6461","21472","2021",3,3,0,158333.333333333,1080.66666666667,151
"6462","21473","2021",12,12,0,242010.416666667,2226,118.5
"6463","21474","2021",8,8,0,107087.5,1378.25,78.625
"6464","21475","2021",4,4,0,172250,1686.5,96.75
"6465","21476","2021",5,5,0,82700,1182.2,70.4
"6466","21478","2021",5,5,0,391600,2960,134.6
"6467","21479","2021",2,2,0,126000,2130,75
"6468","21481","2021",25,21,4,316192.8,3049.36,109.48
"6469","21482","2021",9,9,0,149672.222222222,1636.66666666667,102.111111111111
"6470","21483","2021",4,4,0,201570,1675,125.25
"6471","21485","2021",36,30,6,212515.694444444,2416.27777777778,89.6944444444444
"6472","21487","2021",5,5,0,275440,1709.2,162
"6473","21488","2021",1,1,0,155000,1550,100
"6474","21489","2021",2,2,0,205725,2514.5,84
"6475","21490","2021",1,1,0,62500,893,70
"6476","21492","2021",6,4,2,183850,2189.33333333333,88.3333333333333
"6477","21493","2021",7,7,0,165075.714285714,1852.28571428571,90.8571428571429
"6478","21495","2021",1,1,0,135000,1627,83
"6479","21496","2021",27,24,3,124098.148148148,1703.11111111111,80.4444444444444
"6480","21497","2021",4,4,0,185750,1342.75,138.5
"6481","21498","2021",1,1,0,74000,860,86
"6482","21499","2021",1,1,0,50500,777,65
"6483","21500","2021",12,12,0,156268.75,1397.41666666667,110.583333333333
"6484","21501","2021",18,16,2,185537.222222222,1737.27777777778,107.111111111111
"6485","21502","2021",18,17,1,120990.388888889,1185.44444444444,105
"6486","21503","2021",1,1,0,105000,1050,100
"6487","21504","2021",3,3,0,194380,1843,105.666666666667
"6488","21505","2021",9,8,1,78588.8888888889,1108.77777777778,79.2222222222222
"6489","21506","2021",6,6,0,223233.333333333,1858,126
"6490","21508","2021",2,2,0,189440,2039.5,85.5
"6491","21510","2021",2,2,0,112850,1066,98
"6492","21511","2021",2,2,0,73500,731.5,97.5
"6493","21512","2021",4,4,0,198582.5,2271,87.75
"6494","21514","2021",2,2,0,59750,773,85.5
"6495","21515","2021",81,31,50,166334.395061728,2114.85185185185,78.1111111111111
"6496","21517","2021",7,5,2,227221.428571429,2439.28571428571,93.1428571428571
"6497","21518","2021",5,5,0,115000,1076.4,103
"6498","21519","2021",3,3,0,73666.6666666667,992.333333333333,76.3333333333333
"6499","21520","2021",1,1,0,175401,1703,103
"6500","21521","2021",14,14,0,249193.571428571,2170.42857142857,118.071428571429
"6501","21522","2021",7,7,0,154975.714285714,1503.14285714286,103.857142857143
"6502","21523","2021",1,1,0,220000,1705,129
"6503","21524","2021",1,1,0,139450,1245,112
"6504","21525","2021",11,11,0,125450,892.090909090909,128.363636363636
"6505","21526","2021",2,2,0,77022.5,705.5,104
"6506","21527","2021",6,5,1,164883.333333333,1560,99.6666666666667
"6507","21528","2021",2,2,0,138500,1500,95
"6508","21530","2021",2,2,0,65750,1024.5,59.5
"6509","21531","2021",10,10,0,96787,1039.9,93.6
"6510","21532","2021",17,16,1,273602.941176471,2313,125.705882352941
"6511","21534","2021",7,7,0,329485.714285714,2428.85714285714,139.428571428571
"6512","21535","2021",13,13,0,310663.076923077,3038.15384615385,110.846153846154
"6513","21536","2021",3,3,0,86366.6666666667,824.333333333333,113
"6514","21537","2021",3,3,0,48333.3333333333,791,66
"6515","21538","2021",1,1,0,150000,909,165
"6516","21539","2021",1,1,0,227000,1861,122
"6517","21540","2021",104,46,58,208132.653846154,2866.15384615385,73.5769230769231
"6518","21541","2021",2,2,0,275000,2184.5,125
"6519","21542","2021",3,3,0,213666.666666667,2206.33333333333,95
"6520","21543","2021",1,1,0,35000,574,61
"6521","21545","2021",14,14,0,113585,930.357142857143,129.5
"6522","21546","2021",3,3,0,148666.666666667,1426,119
"6523","21547","2021",5,5,0,105800,938,128.8
"6524","21548","2021",6,6,0,121283.333333333,1149.5,103.333333333333
"6525","21550","2021",2,2,0,193500,1541,114.5
"6526","21553","2021",1,1,0,118400,1480,80
"6527","21554","2021",25,13,12,84580,1000.88,85.76
"6528","21555","2021",27,27,0,326253.962962963,2749.11111111111,119.296296296296
"6529","21556","2021",3,3,0,147000,1053,136.666666666667
"6530","21557","2021",1,1,0,181000,2207,82
"6531","21558","2021",5,5,0,305340,2950.4,101.8
"6532","21559","2021",13,12,1,216183.076923077,1825.30769230769,117.384615384615
"6533","21560","2021",1,1,0,82900,1275,65
"6534","21561","2021",8,8,0,176862.5,2052.5,110
"6535","21562","2021",2,2,0,104000,765.5,126
"6536","21563","2021",2,2,0,201000,1935,108
"6537","21564","2021",2,2,0,145750,1634,89
"6538","21565","2021",5,5,0,221800,2617,80.8
"6539","21567","2021",2,2,0,107510,1139,94
"6540","21568","2021",11,11,0,109981.818181818,1239.90909090909,85.8181818181818
"6541","21569","2021",6,6,0,175975,1235,120.5
"6542","21570","2021",2,2,0,113695,1109,105.5
"6543","21571","2021",6,6,0,152600,1710.66666666667,83.1666666666667
"6544","21572","2021",5,5,0,189510,1675.4,103
"6545","21573","2021",7,7,0,115182.857142857,1383.71428571429,84.7142857142857
"6546","21574","2021",9,9,0,137926.777777778,1076.33333333333,133.555555555556
"6547","21575","2021",10,10,0,175715,1421,137.5
"6548","21577","2021",19,19,0,183844.736842105,1758,103.684210526316
"6549","21578","2021",7,7,0,270900,2108.57142857143,129
"6550","21579","2021",4,4,0,209425,1208.75,181.75
"6551","21580","2021",1,1,0,40000,833,48
"6552","21581","2021",1,1,0,226000,2000,113
"6553","21582","2021",4,4,0,348644,2805.25,110
"6554","21583","2021",1,1,0,98000,1508,65
"6555","21584","2021",25,21,4,101624,1080.88,99.84
"6556","21585","2021",7,6,1,171691.428571429,1866.42857142857,91.2857142857143
"6557","21586","2021",9,9,0,271022.222222222,2425.55555555556,108.222222222222
"6558","21587","2021",7,7,0,221832.142857143,1736.57142857143,140.857142857143
"6559","21589","2021",1,1,0,245000,1738,141
"6560","21590","2021",18,18,0,325360,2416.5,124.666666666667
"6561","21591","2021",13,13,0,299890,2532.76923076923,124.230769230769
"6562","21592","2021",1,1,0,75000,1071,70
"6563","21593","2021",1,1,0,97780,1504,65
"6564","21594","2021",2,2,0,108750,810,134
"6565","21596","2021",4,4,0,185720,1500.25,112.75
"6566","21597","2021",2,2,0,110000,1111,106.5
"6567","21598","2021",4,4,0,79655,1025.25,78
"6568","21599","2021",44,38,6,158677.954545455,1429.54545454545,114.704545454545
"6569","21600","2021",1,1,0,515300,3221,160
"6570","21601","2021",3,3,0,327666.666666667,2218,146
"6571","21603","2021",39,24,15,135900.769230769,1809.74358974359,89.3589743589744
"6572","21604","2021",1,1,0,74270,624,119
"6573","21605","2021",18,18,0,274621.222222222,2466.88888888889,111
"6574","21606","2021",10,10,0,255528,2398.8,105.6
"6575","21607","2021",45,40,5,120304.444444444,1319.51111111111,94.8666666666667
"6576","21608","2021",2,2,0,81000,1198.5,66
"6577","21609","2021",8,8,0,230387.5,2042.625,109.875
"6578","21610","2021",4,4,0,150691,1553,101.5
"6579","21611","2021",19,18,1,211207.894736842,1764.63157894737,119.473684210526
"6580","21613","2021",2,2,0,26500,639.5,49
"6581","21614","2021",3,3,0,234500,2778,87
"6582","21615","2021",4,4,0,90500,934.75,107.75
"6583","21616","2021",1,1,0,315000,1270,248
"6584","21617","2021",186,76,110,210992.290322581,2425.59139784946,85.1881720430108
"6585","21618","2021",12,11,1,97785,956.833333333333,107
"6586","21619","2021",3,3,0,173000,1189.66666666667,144.333333333333
"6587","21620","2021",6,6,0,131115,1431,84.5
"6588","21622","2021",1,1,0,414700,2330,178
"6589","21623","2021",17,17,0,225848.294117647,2155.52941176471,106
"6590","21624","2021",1,1,0,90800,804,113
"6591","21625","2021",3,3,0,131408.666666667,1716,83.6666666666667
"6592","21626","2021",1,1,0,58000,472,123
"6593","21628","2021",2,2,0,101500,1153.5,86
"6594","21629","2021",9,9,0,71222.2222222222,973.555555555556,81.7777777777778
"6595","21630","2021",2,2,0,37500,627.5,63.5
"6596","21632","2021",14,13,1,272141.428571429,2276,120
"6597","21633","2021",1,1,0,130000,1140,114
"6598","21634","2021",4,4,0,82000,970,79.75
"6599","21635","2021",1,1,0,240730,1563,154
"6600","21636","2021",8,8,0,100903.125,992.5,112.375
"6601","21637","2021",5,4,1,167640,1656.2,115.4
"6602","21638","2021",17,15,2,165785.882352941,1593.58823529412,104.705882352941
"6603","21639","2021",8,8,0,176443.25,1687.25,110.5
"6604","21641","2021",8,8,0,101125,993.5,109.375
"6605","21642","2021",3,3,0,1e+05,1076.33333333333,102.666666666667
"6606","21643","2021",3,3,0,161734.333333333,1369.33333333333,112.666666666667
"6607","21644","2021",2,2,0,183500,1775,99
"6608","21645","2021",10,10,0,169208,1678.6,104.9
"6609","21646","2021",2,2,0,140000,836.5,159.5
"6610","21647","2021",1,1,0,149000,1490,100
"6611","21648","2021",3,3,0,246651.666666667,3538,88
"6612","21649","2021",1,1,0,40000,444,90
"6613","21650","2021",2,2,0,178500,1861,101
"6614","21651","2021",3,3,0,322500,2053.66666666667,160.666666666667
"6615","21652","2021",2,2,0,163830,1606.5,106
"6616","21655","2021",4,4,0,82662.5,660,118.5
"6617","21656","2021",6,5,1,234975,2547.5,90.5
"6618","21657","2021",30,27,3,364581.133333333,2947.76666666667,126.666666666667
"6619","21659","2021",2,2,0,93142.5,685.5,147
"6620","21661","2021",38,28,10,231293.105263158,2474.44736842105,94.5
"6621","21662","2021",1,1,0,59429,1025,58
"6622","21663","2021",13,13,0,128807.692307692,1437.76923076923,88.6923076923077
"6623","21664","2021",3,3,0,65233.6666666667,865.666666666667,86
"6624","21666","2021",1,1,0,190000,1863,102
"6625","21667","2021",2,2,0,205400,1754,120
"6626","21670","2021",6,4,2,115258.333333333,995.833333333333,116.333333333333
"6627","21671","2021",1,1,0,65000,631,103
"6628","21673","2021",5,5,0,133514,1161.4,117.2
"6629","21674","2021",4,4,0,79375,723.75,113.5
"6630","21675","2021",2,2,0,161500,1259,142.5
"6631","21676","2021",2,2,0,106500,982,101.5
"6632","21677","2021",5,5,0,190900,1253.2,148.8
"6633","21678","2021",1,1,0,45000,562,80
"6634","21679","2021",5,5,0,179260,2228.4,87.4
"6635","21680","2021",8,8,0,162813,1307.375,124.125
"6636","21681","2021",3,3,0,33000,596,55
"6637","21682","2021",5,5,0,275324,2062.4,135.4
"6638","21683","2021",5,5,0,79009,1089,68
"6639","21684","2021",6,6,0,294468.333333333,2142,138.5
"6640","21685","2021",3,3,0,42333.3333333333,584.333333333333,69
"6641","21687","2021",2,2,0,1e+05,796.5,126
"6642","21688","2021",4,4,0,363400,1857,193.75
"6643","21689","2021",4,4,0,220500,1807.5,123.5
"6644","21690","2021",2,2,0,156000,1570.5,99.5
"6645","21691","2021",2,2,0,190000,1796,105
"6646","21692","2021",3,3,0,186366.666666667,1968,99
"6647","21693","2021",6,6,0,40833.3333333333,1750.5,31.5
"6648","21694","2021",1,1,0,159600,1834,87
"6649","21696","2021",1,1,0,155000,587,264
"6650","21698","2021",3,3,0,167000,1846,84.3333333333333
"6651","21699","2021",17,16,1,160455.882352941,1592,103.411764705882
"6652","21700","2021",1,1,0,95000,1131,84
"6653","21701","2021",3,3,0,246000,1810.33333333333,137.666666666667
"6654","21702","2021",5,5,0,154520,1205.4,131.2
"6655","21703","2021",3,3,0,39833.3333333333,989.666666666667,40.6666666666667
"6656","21704","2021",2,2,0,105500,1012.5,119
"6657","21705","2021",1,1,0,64000,1280,50
"6658","21706","2021",1,1,0,115000,1278,90
"6659","21707","2021",3,3,0,108969.666666667,2854,86
"6660","21708","2021",3,3,0,208000,2035.33333333333,93.6666666666667
"6661","21709","2021",3,3,0,62666.6666666667,1167.33333333333,55.3333333333333
"6662","21710","2021",14,14,0,96335.7142857143,899.285714285714,106.285714285714
"6663","21711","2021",2,2,0,146750,943,154.5
"6664","21712","2021",8,8,0,334697.5,2304.625,143.125
"6665","21713","2021",9,9,0,141594.444444444,1635.33333333333,83.2222222222222
"6666","21714","2021",3,3,0,195050,1985.66666666667,105.666666666667
"6667","21715","2021",8,8,0,102675,1499.5,85.75
"6668","21716","2021",1,1,0,215000,1822,118
"6669","21717","2021",1,1,0,65000,903,72
"6670","22001","2021",4,4,0,112343,1082.5,104
"6671","22002","2021",18,18,0,246855,2103.88888888889,122
"6672","22003","2021",13,13,0,226519.230769231,2033.15384615385,114.230769230769
"6673","22004","2021",108,102,6,129208.222222222,1399.10185185185,96.4444444444444
"6674","22005","2021",29,29,0,91662.0689655172,1038.55172413793,90.3793103448276
"6675","22006","2021",8,8,0,121798.75,1160.375,103.625
"6676","22008","2021",23,22,1,176620.652173913,1744,97.695652173913
"6677","22009","2021",5,5,0,66550,890.6,69
"6678","22011","2021",14,14,0,175066.214285714,1549.14285714286,118.071428571429
"6679","22012","2021",9,9,0,189222.222222222,1980.77777777778,97.7777777777778
"6680","22013","2021",43,40,3,103094.395348837,1196.39534883721,86.9069767441861
"6681","22014","2021",17,17,0,180264.705882353,1598.88235294118,117
"6682","22015","2021",28,28,0,142967.071428571,1510.67857142857,95.6071428571429
"6683","22016","2021",15,14,1,502136,5424.33333333333,96.9333333333333
"6684","22018","2021",9,9,0,110761.111111111,1387.77777777778,83.4444444444444
"6685","22019","2021",9,9,0,172217.222222222,1253.22222222222,135.444444444444
"6686","22020","2021",37,36,1,117152.702702703,1177.21621621622,99.4594594594595
"6687","22021","2021",22,22,0,165169.818181818,1583.45454545455,106.045454545455
"6688","22023","2021",7,7,0,109953.571428571,1107.28571428571,105
"6689","22024","2021",3,3,0,79666.6666666667,1010.66666666667,76
"6690","22025","2021",70,70,0,92076.7714285714,1029.12857142857,91.1285714285714
"6691","22026","2021",17,17,0,159469.705882353,1695,92.5294117647059
"6692","22027","2021",10,10,0,80100,894.5,90.4
"6693","22028","2021",15,14,1,168396.666666667,1607.93333333333,102.2
"6694","22029","2021",8,8,0,100437.5,1132.625,113.25
"6695","22030","2021",12,12,0,187008.333333333,1887.41666666667,102.333333333333
"6696","22031","2021",24,23,1,83726.75,985.125,91.125
"6697","22032","2021",35,30,5,110959.571428571,1329.6,91.1428571428571
"6698","22033","2021",16,16,0,95646.25,1271.375,77.4375
"6699","22034","2021",23,23,0,191028.260869565,1859.17391304348,100.217391304348
"6700","22035","2021",23,23,0,142151.304347826,1876.39130434783,80.0869565217391
"6701","22036","2021",1,1,0,187500,1705,110
"6702","22037","2021",13,13,0,72239.2307692308,965.230769230769,78.5384615384615
"6703","22039","2021",12,12,0,114758.75,959.25,117.083333333333
"6704","22040","2021",12,12,0,129506.666666667,1320.08333333333,95.25
"6705","22041","2021",5,5,0,155000,1342.6,118.8
"6706","22042","2021",8,8,0,214045,1748.375,118.75
"6707","22043","2021",5,5,0,122799.8,981.6,128.4
"6708","22044","2021",15,15,0,224617.333333333,2075.6,107.866666666667
"6709","22045","2021",10,10,0,136650,1493.6,87.2
"6710","22046","2021",145,144,1,109432.027586207,1059.64827586207,107.220689655172
"6711","22047","2021",38,38,0,101618.157894737,1135.76315789474,92.9473684210526
"6712","22048","2021",49,49,0,194948.755102041,1763.71428571429,112.183673469388
"6713","22049","2021",41,41,0,224035.56097561,2125.9512195122,106.19512195122
"6714","22050","2021",337,127,210,191514.459940653,2451.57270029674,78.7833827893175
"6715","22052","2021",11,11,0,78478.6363636364,1150.72727272727,83.6363636363636
"6716","22053","2021",15,15,0,94896,1354.33333333333,80.5333333333333
"6717","22054","2021",122,92,30,257435.590163934,3291.66393442623,85.3114754098361
"6718","22055","2021",170,138,32,254733.223529412,2792.35882352941,93.1058823529412
"6719","22056","2021",28,28,0,140679.642857143,1485.03571428571,93.5
"6720","22057","2021",6,6,0,166500,1750.66666666667,96.3333333333333
"6721","22059","2021",17,17,0,155311.764705882,1448.35294117647,112.823529411765
"6722","22060","2021",12,12,0,82383.3333333333,1004.58333333333,79.5833333333333
"6723","22061","2021",42,42,0,82452.9761904762,1033.85714285714,82.8809523809524
"6724","22062","2021",18,18,0,96249.9444444444,1213.88888888889,89.5555555555556
"6725","22063","2021",13,13,0,131933.076923077,1314.61538461538,98.5384615384615
"6726","22064","2021",18,18,0,108246.111111111,940.5,117.166666666667
"6727","22065","2021",34,34,0,140245.735294118,1434.55882352941,99.5882352941177
"6728","22067","2021",54,54,0,130409.814814815,1370.92592592593,97.5185185185185
"6729","22068","2021",9,9,0,131111.111111111,1063,120.111111111111
"6730","22069","2021",5,5,0,174900,1384,128.4
"6731","22070","2021",175,115,60,104981.971428571,1405.42857142857,77.6514285714286
"6732","22071","2021",4,4,0,101750,1176.5,79.5
"6733","22072","2021",10,10,0,83900,1345.3,70.9
"6734","22073","2021",10,10,0,158185,1406.9,116
"6735","22074","2021",17,17,0,113519.117647059,1124.52941176471,104.470588235294
"6736","22075","2021",6,6,0,113833.333333333,1276.5,90.8333333333333
"6737","22076","2021",28,28,0,175700.928571429,1735.85714285714,108.571428571429
"6738","22077","2021",24,24,0,176598.75,1711.79166666667,104.041666666667
"6739","22079","2021",14,14,0,147317.857142857,1381,109.571428571429
"6740","22081","2021",60,57,3,181259.05,1915.55,94.8333333333333
"6741","22082","2021",14,13,1,212512.285714286,1894.14285714286,117.571428571429
"6742","22083","2021",7,7,0,82494.2857142857,914.714285714286,87.4285714285714
"6743","22084","2021",53,48,5,164750.320754717,1895.79245283019,96.3962264150943
"6744","22085","2021",7,7,0,336102.857142857,2871.85714285714,105.714285714286
"6745","22086","2021",13,13,0,217346.153846154,1782,124.153846153846
"6746","22087","2021",18,18,0,99227.5,1040.61111111111,89.3888888888889
"6747","22088","2021",7,7,0,103902.142857143,1218.57142857143,88.7142857142857
"6748","22090","2021",20,20,0,176617.8,1985.4,100.45
"6749","22091","2021",14,14,0,133805,1424.85714285714,94.3571428571429
"6750","22092","2021",12,12,0,79108.3333333333,868.833333333333,98.9166666666667
"6751","22093","2021",288,224,64,187230.559027778,2075.28819444444,93.6041666666667
"6752","22094","2021",50,38,12,456143.16,4113.44,108.46
"6753","22095","2021",2,2,0,70000,673,104.5
"6754","22096","2021",10,10,0,145850,1528.2,96.3
"6755","22097","2021",10,10,0,177840,1695.8,109.8
"6756","22098","2021",12,12,0,173622.5,1539.41666666667,122.75
"6757","22099","2021",19,19,0,132324.263157895,1238.94736842105,105.473684210526
"6758","22101","2021",25,25,0,151738.72,1326.68,119.84
"6759","22103","2021",22,22,0,232632.227272727,2192.40909090909,108.863636363636
"6760","22104","2021",13,13,0,159129.230769231,1518.07692307692,88.2307692307692
"6761","22105","2021",17,17,0,198364.705882353,1988.94117647059,101.764705882353
"6762","22106","2021",127,103,24,183072.070866142,2033.63779527559,91.2992125984252
"6763","22107","2021",41,41,0,115447.658536585,1214.21951219512,91.9024390243902
"6764","22108","2021",3,3,0,112833.333333333,1499.33333333333,75.3333333333333
"6765","22109","2021",12,12,0,178936.666666667,1959,98.4166666666667
"6766","22110","2021",3,3,0,133333.333333333,1510,98
"6767","22111","2021",9,9,0,300667.777777778,2770.77777777778,95.1111111111111
"6768","22112","2021",2,2,0,160000,1574.5,101
"6769","22113","2021",381,262,119,161727.312335958,1865.57480314961,87.7742782152231
"6770","22114","2021",23,23,0,96807.6086956522,982.478260869565,102.347826086957
"6771","22115","2021",13,13,0,85849.6153846154,957.384615384615,93.6153846153846
"6772","22116","2021",17,17,0,126941.176470588,1273.52941176471,96.2941176470588
"6773","22117","2021",23,23,0,212908.695652174,1993.5652173913,108.391304347826
"6774","22118","2021",102,86,16,201196.37254902,2260.73529411765,91.7549019607843
"6775","22119","2021",14,14,0,115205,1663.14285714286,72.7857142857143
"6776","22121","2021",38,34,4,170805.526315789,1689.84210526316,105.921052631579
"6777","22122","2021",25,25,0,113311.36,1030.24,108.72
"6778","22124","2021",4,4,0,95500,817.25,108.75
"6779","22126","2021",2,2,0,131928.5,1113.5,103
"6780","22127","2021",40,38,2,197477.55,1900.675,106.3
"6781","22128","2021",18,18,0,87860.7222222222,986.277777777778,90.1666666666667
"6782","22129","2021",5,5,0,86420,1007.2,95.4
"6783","22131","2021",36,36,0,83995.25,1029.36111111111,82.6944444444444
"6784","22132","2021",5,5,0,103400,1154.6,87.2
"6785","22133","2021",12,12,0,108983.333333333,1218.33333333333,92.25
"6786","22134","2021",44,44,0,318746.227272727,2655.02272727273,121.022727272727
"6787","22135","2021",59,59,0,131177.457627119,1335.79661016949,100.64406779661
"6788","22136","2021",164,118,46,119232.012195122,1446.24390243902,88.0426829268293
"6789","22137","2021",33,33,0,100962.212121212,1157.9696969697,93.7878787878788
"6790","22138","2021",14,14,0,82944.6428571429,999.714285714286,80.6428571428571
"6791","22139","2021",2,2,0,68500,748.5,94
"6792","22140","2021",10,9,1,172250,1630.6,109.2
"6793","22141","2021",1,1,0,85000,1417,60
"6794","22143","2021",36,29,7,232508.333333333,2350.47222222222,98.3055555555556
"6795","22144","2021",11,11,0,246283.181818182,1936.27272727273,131
"6796","22145","2021",21,21,0,159604.761904762,1643.47619047619,100.904761904762
"6797","22146","2021",21,21,0,105016.19047619,1229.52380952381,85.5714285714286
"6798","22147","2021",45,43,2,109755.555555556,1139.57777777778,97.2888888888889
"6799","22148","2021",5,5,0,106487.2,951.6,111.4
"6800","22149","2021",10,9,1,102030.7,1284,82.2
"6801","22150","2021",14,14,0,157768.571428571,1443.85714285714,109.928571428571
"6802","22152","2021",17,17,0,224622.941176471,2198.76470588235,106.411764705882
"6803","22153","2021",21,21,0,94659.5238095238,1092.14285714286,91.6190476190476
"6804","22155","2021",17,16,1,122147.647058824,1405.58823529412,92
"6805","22156","2021",9,9,0,138666.666666667,1527.55555555556,87.2222222222222
"6806","22157","2021",18,18,0,126006.666666667,1199.88888888889,96.5
"6807","22158","2021",66,66,0,108522.681818182,1180.9696969697,93.3484848484848
"6808","22160","2021",8,8,0,183390,1854.5,110.125
"6809","22161","2021",61,61,0,133727.327868852,1432.40983606557,94.6229508196721
"6810","22162","2021",180,121,59,221045.355555556,2707.4,84.2722222222222
"6811","22163","2021",18,18,0,107776.222222222,1102,94.3333333333333
"6812","22164","2021",39,39,0,117314.102564103,1211.05128205128,97.5641025641026
"6813","22165","2021",7,7,0,145937.142857143,1494.28571428571,100.285714285714
"6814","22166","2021",61,60,1,320627.163934426,3123.44262295082,104.852459016393
"6815","22168","2021",236,145,91,259398.533898305,3209.10169491525,83.0889830508475
"6816","22169","2021",4,4,0,107325,949.75,110.25
"6817","22170","2021",26,26,0,162268.346153846,1604.84615384615,102.5
"6818","22171","2021",59,58,1,185533.389830508,1795.10169491525,106.457627118644
"6819","22172","2021",66,42,24,141020.984848485,1704.80303030303,88.6060606060606
"6820","22174","2021",14,14,0,193202.857142857,1866.92857142857,95.4285714285714
"6821","22175","2021",30,30,0,183650.666666667,1681.6,110.233333333333
"6822","22176","2021",101,96,5,176686.871287129,1673.0198019802,105.663366336634
"6823","22177","2021",22,22,0,158279.090909091,1559.90909090909,102.590909090909
"6824","22178","2021",23,23,0,166457.043478261,1574.47826086957,105.869565217391
"6825","22179","2021",60,44,16,226290.233333333,2785.43333333333,89.0833333333333
"6826","22180","2021",28,26,2,174553.214285714,1722.17857142857,99.0357142857143
"6827","22181","2021",10,10,0,110872.5,1184.5,95.5
"6828","22182","2021",29,29,0,195738.965517241,1671.55172413793,116.827586206897
"6829","22183","2021",66,65,1,116249.575757576,1299.92424242424,94.8030303030303
"6830","22184","2021",43,43,0,106214.279069767,1139.51162790698,97.8139534883721
"6831","22185","2021",42,40,2,128884.523809524,1305.33333333333,104.738095238095
"6832","22186","2021",155,89,66,322296.825806452,3978.38709677419,83.5290322580645
"6833","22187","2021",248,197,51,225423.524193548,2402.76612903226,95.1411290322581
"6834","22188","2021",12,12,0,197194.916666667,1734.83333333333,116
"6835","22189","2021",21,21,0,126688.428571429,1443.14285714286,90.0952380952381
"6836","22190","2021",90,89,1,202870.477777778,2129.24444444444,96.2333333333333
"6837","22193","2021",30,21,9,123432.8,1426.13333333333,87.3666666666667
"6838","22194","2021",85,74,11,183560.541176471,2059.82352941176,93.2823529411765
"6839","22195","2021",70,68,2,206405.642857143,2101.85714285714,98.6571428571429
"6840","22196","2021",18,17,1,195183.833333333,1905.44444444444,109.777777777778
"6841","22197","2021",50,50,0,257558.84,2723.08,96.42
"6842","22198","2021",73,66,7,255208.410958904,2606.86301369863,103.972602739726
"6843","22199","2021",33,33,0,129278.212121212,1533.21212121212,98.6666666666667
"6844","22200","2021",11,11,0,176772.727272727,1724.18181818182,108.454545454545
"6845","22201","2021",11,11,0,206181.818181818,2563.18181818182,82.8181818181818
"6846","22202","2021",16,16,0,81428.25,927.4375,89
"6847","22203","2021",71,70,1,122623.352112676,1303.80281690141,98.6056338028169
"6848","22204","2021",30,29,1,166496.333333333,1586.2,105.533333333333
"6849","22205","2021",10,10,0,140365,1390.7,109
"6850","22206","2021",50,48,2,137978,1447.42,97.92
"6851","22207","2021",62,62,0,130675.919354839,1446.58064516129,93.5
"6852","22208","2021",35,33,2,136750.285714286,1440.14285714286,95.8571428571429
"6853","22209","2021",81,62,19,219254.950617284,2614.85185185185,85.8518518518518
"6854","22210","2021",72,72,0,274382.944444444,2929.43055555556,95.0833333333333
"6855","22211","2021",75,63,12,190236.413333333,1827.61333333333,106.666666666667
"6856","22212","2021",22,22,0,153002.272727273,1566.31818181818,102.136363636364
"6857","22213","2021",72,67,5,285857.458333333,2681.88888888889,106.736111111111
"6858","22214","2021",90,87,3,199394,2063.02222222222,94.1333333333333
"6859","22215","2021",183,160,23,165210.071038251,1700.33333333333,98.7103825136612
"6860","22216","2021",26,26,0,105217.038461538,1181.5,87.6538461538462
"6861","22217","2021",7,7,0,108571.428571429,995.857142857143,114.714285714286
"6862","22218","2021",28,28,0,240092.321428571,2370.96428571429,106.535714285714
"6863","22219","2021",62,62,0,125407.403225806,1141.14516129032,115.177419354839
"6864","22220","2021",36,36,0,111756.694444444,1084.11111111111,106.611111111111
"6865","22221","2021",35,35,0,218304.285714286,2199.94285714286,96.1142857142857
"6866","22222","2021",134,114,20,189715.805970149,2177.01492537313,91.9925373134328
"6867","22223","2021",41,41,0,147014.487804878,1603.9756097561,92.4634146341463
"6868","22224","2021",28,28,0,197159.464285714,1863.25,107.857142857143
"6869","22225","2021",93,87,6,136145.903225806,1498.03225806452,92.5376344086021
"6870","22226","2021",47,47,0,199759.29787234,1872.21276595745,112.191489361702
"6871","22227","2021",12,12,0,105651.666666667,1121.16666666667,100.666666666667
"6872","22228","2021",33,33,0,89346.6363636364,1071.78787878788,84.6060606060606
"6873","22229","2021",26,26,0,71878.0769230769,912.730769230769,77.5
"6874","22231","2021",14,14,0,73677.1428571429,1078.28571428571,72.7142857142857
"6875","22232","2021",30,30,0,230415.2,2073.8,113.733333333333
"6876","22233","2021",49,48,1,192765.714285714,2006.16326530612,96.1428571428571
"6877","22234","2021",15,15,0,152550,1594.66666666667,98.5333333333333
"6878","22235","2021",9,9,0,181517.666666667,1672.55555555556,95.3333333333333
"6879","22236","2021",14,13,1,159008.285714286,1432.71428571429,106.214285714286
"6880","22237","2021",41,41,0,195582.926829268,1976.70731707317,101.170731707317
"6881","22238","2021",11,11,0,132545.454545455,1560,88.5454545454545
"6882","22239","2021",28,28,0,126166.25,1387.32142857143,93.6071428571429
"6883","22240","2021",27,26,1,96114.3333333333,1002.88888888889,94.8518518518518
"6884","22241","2021",21,21,0,120328.523809524,1168.7619047619,100.666666666667
"6885","22242","2021",32,32,0,274056.03125,2707.53125,101.78125
"6886","22243","2021",17,17,0,96012.0588235294,1049.58823529412,102.588235294118
"6887","22244","2021",14,14,0,88908.9285714286,1022.14285714286,85.7857142857143
"6888","22245","2021",24,24,0,116914.666666667,1239.75,98.75
"6889","22246","2021",29,29,0,179466.206896552,1806.75862068966,101.103448275862
"6890","22248","2021",49,48,1,147057.346938776,1428.44897959184,108.040816326531
"6891","22249","2021",17,17,0,76800.1764705882,1077.41176470588,72.5294117647059
"6892","22250","2021",27,20,7,135932.407407407,1423.51851851852,92.9259259259259
"6893","22251","2021",107,99,8,232622,2242.70093457944,104.280373831776
"6894","22254","2021",21,21,0,167653.571428571,1441.04761904762,116.571428571429
"6895","22255","2021",17,17,0,122141.294117647,1186,105.529411764706
"6896","22256","2021",30,30,0,129781,1366.1,95.8666666666667
"6897","22257","2021",2,2,0,127500,1126.5,102
"6898","22258","2021",61,60,1,180146.704918033,1758.04918032787,104.754098360656
"6899","22259","2021",76,71,5,190549.434210526,2043.05263157895,98.9868421052632
"6900","22260","2021",8,8,0,64000,796.125,88.5
"6901","22261","2021",4,4,0,271250,1474.25,167.25
"6902","22262","2021",43,37,6,140802.558139535,1584.6976744186,97.0930232558139
"6903","22263","2021",8,8,0,170239.375,1756.125,97.25
"6904","22264","2021",50,50,0,163719.48,1526.38,108.5
"6905","22265","2021",33,33,0,185747.575757576,1742.36363636364,106.060606060606
"6906","22266","2021",96,96,0,96525.5104166667,1031.6875,95.6041666666667
"6907","22267","2021",9,9,0,97288.8888888889,1191.11111111111,86.5555555555556
"6908","22268","2021",13,13,0,156980,1483.15384615385,106.307692307692
"6909","22269","2021",6,6,0,112133.333333333,1090.66666666667,94.5
"6910","22271","2021",8,8,0,112550,1236,86.5
"6911","22272","2021",40,35,5,128395.55,1511,89.55
"6912","22273","2021",40,40,0,261136,2386.375,110.9
"6913","22274","2021",4,4,0,115875,1263.25,98
"6914","22275","2021",19,19,0,111340.894736842,1225.31578947368,97.7894736842105
"6915","22276","2021",7,7,0,129285.714285714,1252,98.5714285714286
"6916","22277","2021",36,36,0,143750.694444444,1440.27777777778,99.2222222222222
"6917","22278","2021",1243,525,718,129653.26307321,1621.3185840708,78.8688656476267
"6918","22279","2021",20,20,0,118255.75,1279.75,96.45
"6919","22280","2021",16,16,0,184646.9375,1775.875,102.375
"6920","22281","2021",16,16,0,133223.1875,1233.875,106.25
"6921","22282","2021",145,90,55,294582.179310345,3493.3724137931,85.2344827586207
"6922","22283","2021",23,23,0,106014.913043478,1275.30434782609,83.9565217391304
"6923","22284","2021",14,14,0,85587.1428571429,1064.42857142857,83.5714285714286
"6924","22285","2021",10,10,0,90963,1167.8,84.3
"6925","22286","2021",5,5,0,187161,1769,105.2
"6926","22287","2021",21,21,0,151561.428571429,1466.33333333333,104.190476190476
"6927","22288","2021",11,11,0,120986.272727273,1021.27272727273,114.909090909091
"6928","22289","2021",2,2,0,86000,1079.5,75.5
"6929","22291","2021",3,3,0,85833.3333333333,1016.33333333333,90.6666666666667
"6930","22293","2021",7,7,0,128921.428571429,1018.57142857143,125.571428571429
"6931","22294","2021",16,16,0,54506.875,750.875,72.6875
"6932","22295","2021",12,12,0,84104.9166666667,936.083333333333,91.1666666666667
"6933","22296","2021",17,17,0,102846.470588235,1129.52941176471,92.1176470588235
"6934","22299","2021",24,24,0,209702.083333333,2030.33333333333,108.041666666667
"6935","22300","2021",6,6,0,101749.166666667,1547,78.5
"6936","22302","2021",29,27,2,388362.068965517,4373.03448275862,99.1034482758621
"6937","22304","2021",6,6,0,175166.666666667,1542,112
"6938","22305","2021",6,6,0,144433.333333333,1403.33333333333,104.666666666667
"6939","22306","2021",14,14,0,149750,1502.14285714286,105.714285714286
"6940","22307","2021",23,21,2,167483.304347826,1699.91304347826,100.869565217391
"6941","22308","2021",15,15,0,131563.333333333,1236,102.466666666667
"6942","22309","2021",2,2,0,143000,1218.5,134
"6943","22310","2021",11,11,0,134350,1207.27272727273,115.090909090909
"6944","22311","2021",28,28,0,210796,2068,107.892857142857
"6945","22312","2021",1,1,0,352500,4147,85
"6946","22313","2021",7,7,0,127284.285714286,1086.71428571429,131
"6947","22314","2021",7,7,0,123551,1218.85714285714,98.4285714285714
"6948","22315","2021",9,9,0,158677.777777778,1856.44444444444,84.2222222222222
"6949","22316","2021",20,20,0,83015.95,1031.25,81.05
"6950","22317","2021",13,13,0,222876.538461538,1629.61538461538,124
"6951","22318","2021",7,7,0,140136.428571429,1698.42857142857,92.1428571428571
"6952","22319","2021",9,9,0,237243.888888889,2350.55555555556,105
"6953","22320","2021",6,6,0,115033.333333333,885.166666666667,125.833333333333
"6954","22321","2021",31,31,0,94319.3548387097,1109.61290322581,93.7096774193548
"6955","22322","2021",7,7,0,82071.4285714286,1037.42857142857,89.8571428571429
"6956","22323","2021",14,14,0,191112.857142857,2245.14285714286,88.7142857142857
"6957","22324","2021",18,18,0,228113.388888889,2254.77777777778,103.666666666667
"6958","22325","2021",125,71,54,234766.904,3285.872,75.264
"6959","22326","2021",8,8,0,189525,1843.75,104.5
"6960","22327","2021",24,24,0,220887.166666667,2229.875,101.166666666667
"6961","22328","2021",4,4,0,90500,1229.5,74
"6962","22330","2021",11,11,0,126211.363636364,1132.81818181818,116.545454545455
"6963","22331","2021",9,9,0,64544.4444444444,815.111111111111,83.5555555555556
"6964","22332","2021",2,2,0,177000,2089,82.5
"6965","22333","2021",20,20,0,95886,1072.05,93.9
"6966","22334","2021",4,4,0,106750,1506.5,87.5
"6967","22335","2021",15,15,0,106536.666666667,1044.26666666667,100.266666666667
"6968","22337","2021",24,24,0,136497.291666667,1471.16666666667,96.0416666666667
"6969","22338","2021",12,12,0,141666.666666667,1323.66666666667,105.666666666667
"6970","22339","2021",52,43,9,186284.634615385,1989.96153846154,91.7115384615385
"6971","22340","2021",17,17,0,145858.823529412,1558.11764705882,97.5882352941177
"6972","22341","2021",13,13,0,127702.769230769,1471.76923076923,99.9230769230769
"6973","22342","2021",10,10,0,189493.2,1623.4,124
"6974","22343","2021",122,85,37,246664.770491803,2738.44262295082,94.2704918032787
"6975","22344","2021",20,20,0,81248,896.9,83.85
"6976","22345","2021",15,15,0,106388.333333333,1357.13333333333,84.2
"6977","22346","2021",10,10,0,208572,1560,130.1
"6978","22347","2021",25,25,0,159952.52,1660.04,99.2
"6979","22348","2021",13,13,0,109365.384615385,1020.92307692308,105.846153846154
"6980","22349","2021",39,36,3,223740.666666667,2144.87179487179,108.410256410256
"6981","22350","2021",3,3,0,240333.333333333,1905.66666666667,125.333333333333
"6982","22351","2021",8,8,0,154676.25,1270.625,121.5
"6983","22352","2021",3,3,0,172666.666666667,1200.66666666667,148.333333333333
"6984","22353","2021",63,49,14,330632.126984127,3836.30158730159,90.2857142857143
"6985","22354","2021",17,17,0,114170.588235294,1552.52941176471,82
"6986","22356","2021",7,7,0,177285.714285714,1750.28571428571,110.428571428571
"6987","22358","2021",10,10,0,129410,1277.1,102.1
"6988","22359","2021",14,14,0,97469.7857142857,1167.28571428571,87.4285714285714
"6989","22360","2021",151,122,29,170416.139072848,1913.70860927152,90.046357615894
"6990","22361","2021",10,10,0,186618.1,1423.6,130.4
"6991","22362","2021",71,41,30,146557.887323944,1647.52112676056,87.6619718309859
"6992","22363","2021",27,26,1,264014.074074074,2678.85185185185,103.777777777778
"6993","22364","2021",62,55,7,181120.338709677,1991.25806451613,90.9354838709677
"6994","22365","2021",4,4,0,103750,973.25,105.25
"6995","22366","2021",8,8,0,90291.875,1317.375,74.625
"6996","22368","2021",21,21,0,212297.19047619,2177.09523809524,106.571428571429
"6997","22369","2021",17,17,0,140585.294117647,1278.05882352941,112.647058823529
"6998","22370","2021",6,6,0,160570,1425.83333333333,118.5
"6999","22371","2021",12,12,0,143789.416666667,1278.83333333333,101.75
"7000","22372","2021",34,34,0,169962.911764706,1750.44117647059,97.1764705882353
"7001","22373","2021",6,6,0,73681.6666666667,999.666666666667,67.5
"7002","22375","2021",12,11,1,153916.666666667,1550,99.5
"7003","22376","2021",21,21,0,103837.523809524,1070.28571428571,97.2380952380952
"7004","22377","2021",20,20,0,210770.8,2221.25,90.7
"7005","22378","2021",8,8,0,137425,1414,91.125
"7006","22379","2021",35,32,3,264695.114285714,2805.05714285714,97.8571428571429
"7007","22380","2021",16,15,1,150459.375,1913.625,87.0625
"7008","22381","2021",10,10,0,134638,1379.2,97.3
"7009","22383","2021",6,6,0,119775,1055,96.3333333333333
"7010","22384","2021",23,23,0,111274.782608696,1077,104.826086956522
"7011","22385","2021",14,14,0,296023.357142857,2386.21428571429,115
"7012","22386","2021",9,9,0,118846.666666667,1124.33333333333,103.777777777778
"7013","22387","2021",33,33,0,157645.454545455,1433.15151515152,113.30303030303
"7014","22388","2021",19,19,0,181200,1684.15789473684,107.894736842105
"7015","22389","2021",82,62,20,166773.402439024,1885.68292682927,91
"7016","22390","2021",12,12,0,184546.416666667,1594.41666666667,112
"7017","22391","2021",30,30,0,144487.966666667,1286.03333333333,106
"7018","23001","2021",25,24,1,77675.2,940.04,82.44
"7019","23002","2021",8,8,0,157533.5,1336.875,115.75
"7020","23003","2021",5,5,0,138400,1379,109.2
"7021","23004","2021",10,10,0,50067.9,731.8,70
"7022","23005","2021",1,1,0,74640,515,145
"7023","23006","2021",7,7,0,75800,800.428571428571,87.1428571428571
"7024","23007","2021",5,5,0,74860,668,109.8
"7025","23008","2021",41,27,14,69049.5121951219,887.243902439024,77.8292682926829
"7026","23010","2021",2,2,0,37450,442,89
"7027","23011","2021",3,3,0,48556.6666666667,683.333333333333,68
"7028","23012","2021",1,1,0,109000,1135,96
"7029","23013","2021",15,15,0,77309.2666666667,717.866666666667,112.466666666667
"7030","23014","2021",2,2,0,65000,841,79.5
"7031","23015","2021",9,9,0,100233.333333333,1009,98.7777777777778
"7032","23016","2021",1,1,0,91000,506,180
"7033","23017","2021",2,2,0,71500,712.5,104.5
"7034","23018","2021",5,5,0,58639.6,916.2,68.6
"7035","23019","2021",1,1,0,48000,522,92
"7036","23020","2021",5,5,0,50900,710.2,72.8
"7037","23021","2021",13,13,0,57193.0769230769,580.230769230769,94.9230769230769
"7038","23022","2021",9,9,0,105383.888888889,1040.55555555556,114
"7039","23023","2021",2,2,0,112500,1393.5,77
"7040","23024","2021",11,11,0,111563.636363636,1012.18181818182,118.909090909091
"7041","23025","2021",23,23,0,77614.6956521739,901.434782608696,89.5652173913043
"7042","23026","2021",10,10,0,127552,1330.8,95.3
"7043","23027","2021",5,5,0,169779.8,1278.2,142.8
"7044","23028","2021",1,1,0,50000,342,146
"7045","23029","2021",6,6,0,56675,780.166666666667,79
"7046","23030","2021",34,32,2,80275,775.294117647059,101.676470588235
"7047","23031","2021",17,15,2,96830,1065.70588235294,92.3529411764706
"7048","23032","2021",13,13,0,132134.615384615,1199.69230769231,107.307692307692
"7049","23033","2021",5,5,0,114460,966,117
"7050","23035","2021",5,5,0,72640,881.2,89
"7051","23036","2021",23,23,0,93680,1153.21739130435,83.4782608695652
"7052","23037","2021",2,2,0,57500,703.5,85
"7053","23038","2021",8,8,0,82271.875,892.375,106.75
"7054","23039","2021",18,18,0,90479.4444444444,903.166666666667,99.7777777777778
"7055","23040","2021",1,1,0,220000,2444,90
"7056","23041","2021",4,4,0,79375,783.75,110.25
"7057","23043","2021",1,1,0,65000,812,80
"7058","23044","2021",1,1,0,96500,910,106
"7059","23045","2021",12,10,2,87099.0833333333,1606.58333333333,84.5
"7060","23046","2021",2,2,0,66136,626.5,123.5
"7061","23047","2021",4,4,0,81625,907.75,81.5
"7062","23048","2021",5,5,0,74400,686.4,113.8
"7063","23049","2021",4,4,0,82250,740,105
"7064","23050","2021",5,5,0,93889,927.6,98.8
"7065","23051","2021",1,1,0,56000,836,67
"7066","23052","2021",6,6,0,146440,1126.16666666667,127.833333333333
"7067","23054","2021",7,7,0,104538.285714286,1096.71428571429,102.857142857143
"7068","23056","2021",13,13,0,78600,834.461538461538,90.2307692307692
"7069","23057","2021",7,7,0,48357.1428571429,727.714285714286,79.5714285714286
"7070","23058","2021",3,3,0,26083.3333333333,473,56
"7071","23059","2021",1,1,0,45000,464,97
"7072","23060","2021",6,6,0,66333.3333333333,772,90.8333333333333
"7073","23061","2021",8,8,0,72037.5,658.125,115.875
"7074","23062","2021",17,17,0,74882.3529411765,1115.23529411765,75.1176470588235
"7075","23063","2021",3,3,0,61833.3333333333,703,97.6666666666667
"7076","23064","2021",22,22,0,70806.3636363636,869.727272727273,87.8636363636364
"7077","23065","2021",4,4,0,62000,1022.25,61.75
"7078","23066","2021",1,1,0,32000,571,56
"7079","23067","2021",5,5,0,108230,905.4,111.6
"7080","23068","2021",10,10,0,63956.5,644.5,97.6
"7081","23069","2021",7,6,1,74312.5714285714,704.857142857143,94.1428571428571
"7082","23070","2021",14,13,1,86511.9285714286,994.571428571429,86.2142857142857
"7083","23071","2021",3,3,0,138100,956.333333333333,150
"7084","23072","2021",1,1,0,29000,763,38
"7085","23073","2021",5,5,0,113740,1083,99.4
"7086","23074","2021",2,2,0,102000,1018,104.5
"7087","23075","2021",21,21,0,90937.1428571429,858.904761904762,112.52380952381
"7088","23076","2021",19,18,1,65087.1052631579,792.947368421053,89.3684210526316
"7089","23077","2021",7,7,0,70785.7142857143,687.857142857143,97.8571428571429
"7090","23078","2021",4,4,0,73837.5,763,90.5
"7091","23079","2021",28,27,1,73894.6428571429,857.892857142857,92.5357142857143
"7092","23080","2021",1,1,0,60000,732,82
"7093","23081","2021",6,6,0,90333.3333333333,1022.66666666667,93.6666666666667
"7094","23082","2021",7,7,0,90442.8571428571,892.428571428571,117.285714285714
"7095","23083","2021",4,4,0,52375,604,83.75
"7096","23084","2021",2,2,0,87500,1111.5,77
"7097","23086","2021",7,7,0,76357.1428571429,1044.57142857143,86.1428571428571
"7098","23087","2021",16,16,0,56313.0625,750.6875,79.5
"7099","23088","2021",3,3,0,101916.666666667,741.333333333333,137.333333333333
"7100","23089","2021",15,15,0,86054.2,848.133333333333,100.866666666667
"7101","23090","2021",14,14,0,67323.2142857143,738.285714285714,89.8571428571429
"7102","23091","2021",1,1,0,135000,2045,66
"7103","23092","2021",14,14,0,111182.5,1151.57142857143,110.214285714286
"7104","23093","2021",20,20,0,104574,1014.25,102.1
"7105","23095","2021",17,16,1,84082.3529411765,930.058823529412,94.1176470588235
"7106","23096","2021",189,115,74,91299.1746031746,1063.42328042328,86.1216931216931
"7107","23097","2021",6,6,0,101833.333333333,909.166666666667,145.666666666667
"7108","23098","2021",1,1,0,223300,1618,138
"7109","23099","2021",13,13,0,76923.4615384615,893.538461538462,87.3846153846154
"7110","23100","2021",8,8,0,59788.125,655.125,93.875
"7111","23101","2021",9,9,0,105961.111111111,790.555555555556,107.333333333333
"7112","23102","2021",9,9,0,44122.2222222222,855.222222222222,61.6666666666667
"7113","23103","2021",8,8,0,66675,817.25,90.625
"7114","23104","2021",7,7,0,102250,1017.42857142857,107.285714285714
"7115","23105","2021",12,12,0,63602.5,729.833333333333,85.5
"7116","23106","2021",6,6,0,57741.6666666667,688.166666666667,92.1666666666667
"7117","23107","2021",8,8,0,53812.5,778.75,72
"7118","23108","2021",3,3,0,54166.6666666667,602.666666666667,95
"7119","23109","2021",2,2,0,44500,670,67.5
"7120","23110","2021",2,2,0,108000,698.5,147
"7121","23111","2021",8,8,0,102937.5,950.875,108.5
"7122","23112","2021",21,21,0,71604.1904761905,1192.61904761905,67
"7123","23113","2021",2,2,0,72000,874,82
"7124","23114","2021",6,6,0,107916.666666667,920.833333333333,97.8333333333333
"7125","23115","2021",6,6,0,65169.1666666667,785.5,78.3333333333333
"7126","23116","2021",11,11,0,94461.5454545455,798.181818181818,118.090909090909
"7127","23117","2021",5,5,0,59600,710,85.4
"7128","23118","2021",5,5,0,81200,852.8,87
"7129","23120","2021",6,6,0,150400,1440.83333333333,99.3333333333333
"7130","23122","2021",1,1,0,43450,381,114
"7131","23124","2021",17,17,0,78720,976.058823529412,85.8823529411765
"7132","23125","2021",2,2,0,76000,538.5,141.5
"7133","23127","2021",6,6,0,76833.3333333333,702.333333333333,108.5
"7134","23128","2021",1,1,0,162000,750,216
"7135","23129","2021",1,1,0,81500,755,108
"7136","23130","2021",15,15,0,66045.6,763.6,91.2666666666667
"7137","23131","2021",19,17,2,66017.1052631579,759.210526315789,90.2631578947368
"7138","23132","2021",6,6,0,105333.333333333,1153,91.6666666666667
"7139","23133","2021",3,3,0,87701.6666666667,975.666666666667,91.3333333333333
"7140","23134","2021",5,5,0,57404,802.4,72.6
"7141","23136","2021",12,12,0,74100,896.083333333333,84.5
"7142","23137","2021",21,20,1,73452.3809523809,811.047619047619,95.8095238095238
"7143","23138","2021",3,3,0,42666.6666666667,890,44.6666666666667
"7144","23139","2021",10,10,0,87502.2,866.2,106.2
"7145","23140","2021",7,7,0,70785.7142857143,823.571428571429,87.5714285714286
"7146","23141","2021",10,10,0,68265,882.2,78.1
"7147","23142","2021",6,6,0,106500,812.833333333333,130.166666666667
"7148","23143","2021",5,5,0,54200,779.6,68.6
"7149","23144","2021",9,9,0,75175,783.333333333333,81.5555555555556
"7150","23145","2021",3,3,0,54500,721,81.6666666666667
"7151","23146","2021",10,10,0,64700,778.5,87
"7152","23147","2021",2,2,0,93675,777,117.5
"7153","23148","2021",7,7,0,62630.1428571429,1078,59.7142857142857
"7154","23149","2021",15,15,0,98805.6666666667,966.2,96.1333333333333
"7155","23150","2021",1,1,0,108000,947,114
"7156","23151","2021",8,8,0,54327.5,752,79.625
"7157","23154","2021",10,10,0,117920,1149.7,109.2
"7158","23155","2021",7,7,0,51250,634.571428571429,78
"7159","23156","2021",4,4,0,55250,628.5,97.5
"7160","23157","2021",5,5,0,61500,920.6,74.8
"7161","23158","2021",4,4,0,89675,1291.5,81.25
"7162","23159","2021",1,1,0,202255,982,206
"7163","23160","2021",4,4,0,47437.5,749.25,63.5
"7164","23162","2021",11,11,0,63318.1818181818,982.454545454545,68.1818181818182
"7165","23164","2021",8,8,0,87812.5,787.625,112.125
"7166","23165","2021",20,20,0,79210.7,1483.4,61.9
"7167","23166","2021",5,5,0,49400,586.6,84.8
"7168","23167","2021",7,7,0,68552.1428571429,643.714285714286,101.714285714286
"7169","23168","2021",15,15,0,89135.6,899.866666666667,99.8
"7170","23169","2021",3,3,0,99333.3333333333,707,143.666666666667
"7171","23170","2021",7,6,1,109464.285714286,939.142857142857,117.285714285714
"7172","23171","2021",4,4,0,85261.5,1165.25,82
"7173","23172","2021",5,5,0,147000,1526.6,109.8
"7174","23173","2021",4,4,0,53875,620.25,84.25
"7175","23174","2021",14,14,0,54535.7142857143,783.142857142857,75.0714285714286
"7176","23175","2021",4,4,0,84000,807.75,106.75
"7177","23176","2021",61,55,6,97211.0655737705,1059.24590163934,95
"7178","23177","2021",25,25,0,98823.84,1064.32,92.96
"7179","23178","2021",5,5,0,87785.2,889.8,98.6
"7180","23179","2021",5,5,0,72800,941.8,77.6
"7181","23180","2021",3,3,0,130000,1049.33333333333,116.666666666667
"7182","23181","2021",2,1,1,117500,2196.5,67
"7183","23182","2021",5,5,0,46914.4,593.2,81.2
"7184","23184","2021",2,2,0,348000,2651,137.5
"7185","23185","2021",6,6,0,71561.6666666667,863.666666666667,82.6666666666667
"7186","23186","2021",3,3,0,181666.666666667,1448,130.666666666667
"7187","23187","2021",2,2,0,67000,857.5,80.5
"7188","23188","2021",3,3,0,108413.333333333,855,141.333333333333
"7189","23189","2021",23,23,0,86100.4782608696,891,96.2173913043478
"7190","23190","2021",5,5,0,73800,735,104.6
"7191","23191","2021",4,4,0,124425,1056.5,135.75
"7192","23192","2021",32,32,0,111307.53125,1066.84375,101.25
"7193","23193","2021",22,22,0,96171.5,1051.22727272727,90.9545454545455
"7194","23194","2021",1,1,0,128400,1297,99
"7195","23195","2021",7,7,0,131003.428571429,1468.42857142857,90
"7196","23196","2021",3,3,0,61833.3333333333,776.333333333333,79.6666666666667
"7197","23197","2021",8,8,0,90812.5,746.875,119.5
"7198","23198","2021",4,4,0,124750,1147,106.25
"7199","23199","2021",7,7,0,55442.8571428571,820.285714285714,72.8571428571429
"7200","23200","2021",4,4,0,88875,855,110.5
"7201","23201","2021",4,4,0,65750,809.25,100
"7202","23202","2021",8,8,0,62825,674.125,89.875
"7203","23203","2021",4,4,0,67700,690.5,87.25
"7204","23204","2021",5,5,0,112075,1079.2,105.2
"7205","23205","2021",6,6,0,76527.1666666667,904.166666666667,86.5
"7206","23206","2021",7,7,0,197657.142857143,1434,126.714285714286
"7207","23207","2021",3,3,0,30333.3333333333,451.333333333333,68
"7208","23208","2021",6,6,0,93333.3333333333,1001.33333333333,85.5
"7209","23209","2021",3,3,0,62566.6666666667,835,74.6666666666667
"7210","23210","2021",4,4,0,83500,950.25,106.25
"7211","23211","2021",10,10,0,85503,992.1,86.3
"7212","23212","2021",4,4,0,76592.5,1001.75,74
"7213","23213","2021",6,6,0,62416.6666666667,925,67.6666666666667
"7214","23214","2021",9,9,0,66211.1111111111,710.777777777778,95.8888888888889
"7215","23215","2021",2,2,0,85000,805.5,105
"7216","23216","2021",7,7,0,92211.4285714286,1240.42857142857,62.5714285714286
"7217","23217","2021",5,5,0,107805,1146.8,96.2
"7218","23218","2021",3,3,0,54666.6666666667,390.666666666667,139.666666666667
"7219","23219","2021",19,19,0,116506.315789474,1031.26315789474,110.684210526316
"7220","23220","2021",10,10,0,61560,607.9,102.8
"7221","23221","2021",3,3,0,70933.3333333333,976.333333333333,106
"7222","23222","2021",4,4,0,109375,994,108.5
"7223","23223","2021",13,13,0,131681.076923077,1150.23076923077,110.846153846154
"7224","23224","2021",2,2,0,82650,1543.5,69
"7225","23225","2021",3,3,0,166133.333333333,1129,142.333333333333
"7226","23226","2021",2,2,0,64500,788,100.5
"7227","23227","2021",5,5,0,61200,918.6,67.6
"7228","23228","2021",2,2,0,88500,1080.5,80
"7229","23229","2021",9,9,0,76194.6666666667,761.555555555556,103.333333333333
"7230","23230","2021",5,5,0,117600,1254.6,96.8
"7231","23232","2021",7,7,0,84985,979.857142857143,88.4285714285714
"7232","23233","2021",4,4,0,86427.5,909.75,95.5
"7233","23234","2021",6,6,0,54400.8333333333,722.666666666667,85.3333333333333
"7234","23235","2021",13,13,0,87860.3846153846,884.153846153846,95.2307692307692
"7235","23236","2021",4,4,0,69850,596.75,116.75
"7236","23238","2021",9,9,0,74000,893.444444444444,85.3333333333333
"7237","23239","2021",16,16,0,97946.875,1004.375,98.8125
"7238","23240","2021",7,7,0,84142.8571428571,1289.57142857143,68.2857142857143
"7239","23241","2021",4,4,0,104250,871.5,114.5
"7240","23242","2021",1,1,0,30000,625,48
"7241","23243","2021",6,6,0,97411.6666666667,1051.16666666667,99.3333333333333
"7242","23244","2021",13,13,0,71826.3076923077,815.461538461538,88.9230769230769
"7243","23245","2021",19,19,0,135470.368421053,1253.52631578947,106.368421052632
"7244","23246","2021",11,11,0,94204.2727272727,1053.18181818182,88.1818181818182
"7245","23247","2021",24,24,0,73479.7916666667,810.708333333333,90.375
"7246","23248","2021",5,5,0,145790,935.8,143.4
"7247","23249","2021",4,4,0,103462.5,803,120
"7248","23250","2021",7,7,0,60891.4285714286,851.428571428571,73.4285714285714
"7249","23251","2021",1,1,0,60000,465,129
"7250","23252","2021",5,5,0,91600,881.8,98.2
"7251","23253","2021",3,3,0,60666.6666666667,1265,48
"7252","23254","2021",5,5,0,98140,801.2,126.6
"7253","23255","2021",2,2,0,86000,1069.5,87.5
"7254","23257","2021",13,13,0,89423.0769230769,828.538461538462,107.153846153846
"7255","23258","2021",7,7,0,65121.4285714286,740.857142857143,90
"7256","23259","2021",2,2,0,77500,754.5,102.5
"7257","23260","2021",3,3,0,55400,733.666666666667,86.6666666666667
"7258","23261","2021",4,4,0,59625,755.25,74.5
"7259","23263","2021",3,3,0,47300,768.666666666667,64.6666666666667
"7260","23264","2021",2,2,0,51683.5,648.5,85
"7261","23266","2021",3,3,0,86609.6666666667,789.333333333333,107.333333333333
"7262","24001","2021",16,16,0,114604.25,1138.5,111.6875
"7263","24002","2021",23,23,0,159673.913043478,1402.21739130435,110.304347826087
"7264","24004","2021",10,10,0,153813.5,1698.4,96.9
"7265","24005","2021",7,7,0,194068.571428571,1812.71428571429,109.571428571429
"7266","24006","2021",5,5,0,135400,1469.2,91.2
"7267","24007","2021",9,9,0,179114.444444444,1383.66666666667,137.777777777778
"7268","24008","2021",15,15,0,100744.666666667,1206.53333333333,91.9333333333333
"7269","24009","2021",8,8,0,143675.625,1510.25,92.25
"7270","24010","2021",16,16,0,157981.25,1688.125,95
"7271","24011","2021",21,20,1,164367.142857143,2170.95238095238,93.0952380952381
"7272","24012","2021",7,7,0,243159.428571429,1849.71428571429,122.428571428571
"7273","24014","2021",6,6,0,162741.666666667,1362.16666666667,114.5
"7274","24015","2021",5,5,0,224100,1805,124.2
"7275","24016","2021",11,11,0,140705.454545455,1173.18181818182,113.181818181818
"7276","24018","2021",8,8,0,205199.375,1673.625,124.625
"7277","24019","2021",11,11,0,156876.363636364,1331,113.363636363636
"7278","24020","2021",19,18,1,168982.421052632,1337.15789473684,129
"7279","24021","2021",5,5,0,116770,1206.4,104.4
"7280","24022","2021",8,8,0,228725.625,1932.875,123.625
"7281","24023","2021",3,3,0,176166.666666667,1637,111
"7282","24024","2021",1,1,0,215000,1463,147
"7283","24025","2021",5,5,0,140662,1481.2,101.2
"7284","24026","2021",54,54,0,169995,1570.62962962963,110.574074074074
"7285","24027","2021",6,6,0,198839.666666667,1336,142.333333333333
"7286","24028","2021",43,42,1,170057.209302326,1763.37209302326,108.488372093023
"7287","24029","2021",10,10,0,156133.5,1569.9,118.2
"7288","24030","2021",17,17,0,139515.882352941,1537.70588235294,92.3529411764706
"7289","24031","2021",3,3,0,138000,1566,117
"7290","24032","2021",10,10,0,125857.8,1374.9,102.7
"7291","24034","2021",5,5,0,146600,1364.8,94.6
"7292","24035","2021",38,35,3,142378.236842105,1325.26315789474,110.447368421053
"7293","24036","2021",4,4,0,230625,2103.5,113.5
"7294","24037","2021",647,463,184,144401.950540958,1596.01854714065,90.5085007727975
"7295","24038","2021",4,4,0,222652.75,1698.75,149
"7296","24039","2021",5,5,0,222412,2265.4,106.2
"7297","24040","2021",13,12,1,201167.307692308,1880.46153846154,104
"7298","24042","2021",9,9,0,142833.333333333,1553,96.1111111111111
"7299","24043","2021",2,2,0,112695,1391,79.5
"7300","24045","2021",2,2,0,178250,1479.5,130
"7301","24046","2021",2,2,0,149700,1460,84
"7302","24048","2021",5,5,0,205030,1827.6,111.2
"7303","24050","2021",1,1,0,101630,1452,70
"7304","24051","2021",4,4,0,150950,1429,113.75
"7305","24052","2021",1,1,0,108000,1800,60
"7306","24053","2021",110,86,24,166731.3,1764.63636363636,93.8727272727273
"7307","24054","2021",10,10,0,190219,1439.3,122.4
"7308","24055","2021",11,11,0,206159.090909091,1569.54545454545,132.181818181818
"7309","24056","2021",8,8,0,123031.25,1311.375,92.5
"7310","24058","2021",4,4,0,132727.5,1089.25,118.25
"7311","24059","2021",7,7,0,191035.714285714,1464.28571428571,136.142857142857
"7312","24060","2021",1,1,0,389350,2264,172
"7313","24061","2021",4,4,0,173662.5,1333.75,115.75
"7314","24062","2021",12,12,0,144880.083333333,1376.41666666667,108.833333333333
"7315","24063","2021",4,4,0,210000,2460.5,86.25
"7316","24064","2021",70,69,1,138865.242857143,1442.82857142857,100.542857142857
"7317","24066","2021",10,10,0,158675,1730.1,95.9
"7318","24067","2021",69,68,1,167439.507246377,1519.13043478261,108.188405797101
"7319","24068","2021",37,35,2,204156.027027027,1749.67567567568,118.135135135135
"7320","24069","2021",6,6,0,204000,1959.16666666667,117.333333333333
"7321","24070","2021",17,17,0,141697.647058824,1385.94117647059,101.823529411765
"7322","24071","2021",16,16,0,85045.625,1019.875,83.5
"7323","24073","2021",11,11,0,130326.363636364,1439.72727272727,103.181818181818
"7324","24074","2021",7,7,0,223928.571428571,1553,126.714285714286
"7325","24075","2021",8,8,0,205640.625,1481,139.5
"7326","24076","2021",5,5,0,210120.2,1685.4,124.2
"7327","24077","2021",3,3,0,109330,1335.66666666667,76
"7328","24080","2021",6,6,0,223006.833333333,1737.5,132.166666666667
"7329","24081","2021",8,6,2,166118,1844.75,97.5
"7330","24082","2021",35,35,0,175115.371428571,1873.08571428571,94.2571428571429
"7331","24083","2021",7,7,0,164271.428571429,1200.14285714286,133.285714285714
"7332","24084","2021",6,6,0,263615.333333333,1913.66666666667,136.166666666667
"7333","24085","2021",5,5,0,140805.2,1546.8,81.6
"7334","24086","2021",9,9,0,270281.111111111,2916.44444444444,96.4444444444444
"7335","24087","2021",20,20,0,240427.5,1717,130.9
"7336","24088","2021",9,9,0,326451.444444444,2558.11111111111,126.888888888889
"7337","24090","2021",9,9,0,151488.888888889,1443.55555555556,104.666666666667
"7338","24091","2021",34,34,0,241271.617647059,2272.73529411765,103.794117647059
"7339","24094","2021",3,3,0,196910,1477,130
"7340","24095","2021",13,12,1,108222.692307692,1365.84615384615,85.7692307692308
"7341","24096","2021",10,10,0,151294.7,1455.5,104.9
"7342","24097","2021",14,14,0,149807.142857143,1050.71428571429,135.5
"7343","24098","2021",57,41,16,165903.596491228,1962.89473684211,85.6491228070175
"7344","24100","2021",9,9,0,133357.777777778,1206.88888888889,122.333333333333
"7345","24101","2021",11,11,0,141160.545454545,1654.72727272727,87
"7346","24102","2021",90,85,5,168177.788888889,1752.31111111111,101.011111111111
"7347","24104","2021",11,11,0,143404.545454545,1288,103.909090909091
"7348","24105","2021",3,3,0,108333.333333333,754.333333333333,139.333333333333
"7349","24106","2021",12,12,0,168666.666666667,2085,87.1666666666667
"7350","24107","2021",8,8,0,189861.25,1394.875,127.75
"7351","24108","2021",16,16,0,214210.9375,1795.625,120.6875
"7352","24109","2021",3,3,0,138253.333333333,969.666666666667,126.666666666667
"7353","24110","2021",2,2,0,292250,1527.5,190
"7354","24111","2021",2,2,0,92550,812.5,105
"7355","24113","2021",1,1,0,80000,1600,50
"7356","24115","2021",34,33,1,199002.088235294,1997.52941176471,104.147058823529
"7357","24116","2021",3,3,0,201666.666666667,1554,118
"7358","24117","2021",6,6,0,127791.666666667,1399.83333333333,90.5
"7359","24119","2021",9,9,0,203576.666666667,1696.88888888889,132.555555555556
"7360","24120","2021",11,11,0,82681.8181818182,1014.63636363636,87.5454545454545
"7361","24122","2021",1,1,0,190000,1092,174
"7362","24123","2021",3,3,0,101666.666666667,1121.66666666667,89.3333333333333
"7363","24124","2021",7,7,0,186200,1710.14285714286,108.285714285714
"7364","24126","2021",1,1,0,145200,2135,68
"7365","24128","2021",2,2,0,148450,1438.5,103.5
"7366","24129","2021",7,7,0,129857.142857143,1258.42857142857,110.857142857143
"7367","24130","2021",10,10,0,116228,1322.2,88.5
"7368","24131","2021",4,4,0,107500,924.25,108
"7369","24132","2021",8,8,0,178712.5,1374.375,124.875
"7370","24133","2021",27,27,0,98195.3703703704,1064.7037037037,90.9259259259259
"7371","24134","2021",17,16,1,106003.235294118,1267.76470588235,87.6470588235294
"7372","24135","2021",5,5,0,196800,1556.4,119.8
"7373","24136","2021",5,5,0,185050,1513.4,134.2
"7374","24137","2021",12,12,0,160935.416666667,1257.91666666667,129.916666666667
"7375","24138","2021",163,139,24,151377.319018405,1675.17791411043,90.3435582822086
"7376","24139","2021",38,38,0,209753.421052632,1714.86842105263,122.605263157895
"7377","24140","2021",22,22,0,195630,1771.45454545455,112.090909090909
"7378","24141","2021",5,5,0,137305.6,1322.2,103.8
"7379","24142","2021",31,31,0,196723.967741935,1950.8064516129,101.483870967742
"7380","24143","2021",14,14,0,152541.857142857,1585.85714285714,93.7142857142857
"7381","24144","2021",2,2,0,151000,1191.5,121.5
"7382","24145","2021",24,24,0,149511.666666667,1503.875,109.916666666667
"7383","24146","2021",4,4,0,216750,1440.25,154.75
"7384","24147","2021",21,20,1,156063.666666667,1612.19047619048,99.5714285714286
"7385","24148","2021",14,14,0,165066.428571429,1589.07142857143,121.285714285714
"7386","24150","2021",21,21,0,215752.380952381,1927.33333333333,113.333333333333
"7387","24151","2021",4,4,0,252550,2730.5,96.5
"7388","24152","2021",27,26,1,267090.074074074,2522.81481481481,104.592592592593
"7389","24153","2021",6,6,0,213100,2079.66666666667,114
"7390","24154","2021",5,5,0,111470.6,939.6,125.6
"7391","24155","2021",10,10,0,221330,2569.7,96.8
"7392","24156","2021",19,19,0,147922.631578947,1580.05263157895,96.9473684210526
"7393","24157","2021",23,23,0,128035,1221.73913043478,102.04347826087
"7394","24158","2021",6,6,0,109975,1210.83333333333,96
"7395","24159","2021",7,7,0,123176.714285714,1247.14285714286,95.4285714285714
"7396","24160","2021",5,5,0,141428,1450.2,100.4
"7397","24161","2021",4,4,0,257152.5,2092,126.75
"7398","24162","2021",6,6,0,122766.666666667,1499,80.5
"7399","24163","2021",1,1,0,215000,863,249
"7400","24164","2021",21,20,1,101312.380952381,1007.90476190476,103.52380952381
"7401","24165","2021",8,8,0,136625,1324.5,97.875
"7402","24167","2021",58,55,3,181220.862068966,1530.24137931034,117.206896551724
"7403","24168","2021",10,10,0,181580,1474.1,123.5
"7404","24171","2021",8,8,0,162520,1414,106.625
"7405","24172","2021",32,27,5,200845.625,1982.125,100.46875
"7406","24174","2021",3,3,0,222833.333333333,2753.33333333333,79.3333333333333
"7407","24175","2021",8,8,0,176018.125,2028.375,92.75
"7408","24176","2021",1,1,0,260000,2476,105
"7409","24177","2021",13,13,0,148397.692307692,1446.23076923077,101.923076923077
"7410","24179","2021",12,12,0,171541.666666667,1472.41666666667,114.083333333333
"7411","24180","2021",10,10,0,107369.7,1220,99.7
"7412","24182","2021",22,22,0,171364.272727273,1356.86363636364,128.772727272727
"7413","24183","2021",3,3,0,352000,3180.33333333333,125
"7414","24184","2021",5,5,0,146190,1814.6,98.8
"7415","24186","2021",2,2,0,272250,1316.5,206
"7416","24188","2021",16,16,0,124672,1291.5,102.1875
"7417","24189","2021",8,8,0,145993.75,1385,94.5
"7418","24190","2021",3,3,0,362016.666666667,1847,184.666666666667
"7419","24191","2021",4,4,0,53750,800.25,69
"7420","24192","2021",2,2,0,95525,1296.5,77.5
"7421","24193","2021",4,4,0,200130,1450.75,125.75
"7422","24194","2021",27,26,1,156311.851851852,1496.7037037037,102.703703703704
"7423","24195","2021",1,1,0,50000,1136,44
"7424","24196","2021",7,7,0,138035.714285714,1043,115.714285714286
"7425","24197","2021",16,16,0,172477.3125,1436.4375,127.125
"7426","24199","2021",8,8,0,93620,861.375,111.125
"7427","24200","2021",15,15,0,142781.2,1269.6,112.8
"7428","24202","2021",3,3,0,125000,1414.66666666667,87.6666666666667
"7429","24205","2021",6,6,0,185266.666666667,2271,80.5
"7430","24206","2021",4,4,0,81750,1262.25,67.5
"7431","24207","2021",13,13,0,153403.846153846,1853.61538461538,82.9230769230769
"7432","24208","2021",6,6,0,161433.333333333,1679.5,102.833333333333
"7433","24209","2021",2,2,0,71250,746.5,95
"7434","24210","2021",19,19,0,106502.631578947,928.473684210526,114.368421052632
"7435","24211","2021",11,11,0,166536.363636364,1354.90909090909,128.090909090909
"7436","24212","2021",14,13,1,182219.285714286,1594.71428571429,113.285714285714
"7437","24213","2021",4,4,0,194250,1444,130.5
"7438","24214","2021",19,19,0,84568.9473684211,972.947368421053,86.1578947368421
"7439","24215","2021",7,7,0,188595,1963.85714285714,93.7142857142857
"7440","24216","2021",2,2,0,70000,1841,42.5
"7441","24217","2021",4,4,0,183000,1913.25,96.5
"7442","24218","2021",42,42,0,138725.833333333,1518.2619047619,103.857142857143
"7443","24220","2021",10,10,0,156319,1741.6,85.1
"7444","24222","2021",48,47,1,165457.916666667,1604.97916666667,102.520833333333
"7445","24223","2021",64,64,0,155359.53125,1613,95.828125
"7446","24224","2021",18,18,0,229299.722222222,1839.16666666667,129.055555555556
"7447","24225","2021",51,51,0,170023.843137255,1616.3137254902,106.196078431373
"7448","24226","2021",25,25,0,134100,1320.76,103.32
"7449","24227","2021",19,19,0,122545.263157895,1598.52631578947,83.9473684210526
"7450","24228","2021",9,9,0,165881.111111111,1635.66666666667,106.222222222222
"7451","24229","2021",33,32,1,115865.393939394,1230.9696969697,96.1212121212121
"7452","24230","2021",2,2,0,147500,1110,135.5
"7453","24231","2021",4,4,0,165875,1539.75,106
"7454","24232","2021",1,1,0,45000,833,54
"7455","24234","2021",5,5,0,251170,1537.6,162
"7456","24236","2021",14,14,0,180255.642857143,1542.28571428571,125.714285714286
"7457","24237","2021",24,24,0,215832.583333333,1615.25,127.458333333333
"7458","24238","2021",2,2,0,265000,2666,115.5
"7459","24240","2021",7,7,0,233305.571428571,1800.14285714286,120.285714285714
"7460","24241","2021",13,13,0,143109.230769231,1332.61538461538,101
"7461","24242","2021",3,3,0,280916.666666667,2262.66666666667,129.666666666667
"7462","24243","2021",21,21,0,139916.666666667,1339.80952380952,107.142857142857
"7463","24244","2021",2,2,0,180000,3506.5,140
"7464","24245","2021",4,4,0,187964.5,3817,77.75
"7465","24246","2021",10,10,0,253954,1860.9,138.3
"7466","24247","2021",1,1,0,163551,1330,123
"7467","24248","2021",10,10,0,102555.4,990.8,94.2
"7468","24251","2021",5,5,0,130440,1153.6,110.2
"7469","24252","2021",12,12,0,299539.166666667,2352.33333333333,118.333333333333
"7470","24253","2021",49,48,1,164471.857142857,1304.87755102041,124.591836734694
"7471","24254","2021",4,4,0,194125,1581.75,133.75
"7472","24255","2021",6,6,0,210570.5,1900,121
"7473","24256","2021",71,35,36,118770.85915493,1547.39436619718,72.0845070422535
"7474","24257","2021",4,4,0,147481.25,1681.5,92.75
"7475","24259","2021",28,28,0,176486.428571429,1510.35714285714,112.25
"7476","24260","2021",10,10,0,205617.8,1639.4,124.3
"7477","24261","2021",6,6,0,228369.166666667,1995.16666666667,122.5
"7478","24262","2021",7,7,0,175125,1596.28571428571,109.857142857143
"7479","24263","2021",5,5,0,135600,1236.6,104.2
"7480","24264","2021",25,25,0,130270.4,1417.6,98.16
"7481","24266","2021",34,34,0,156462.941176471,1492.5,108.205882352941
"7482","24267","2021",6,6,0,196533.666666667,1747,113
"7483","24268","2021",17,17,0,211999.117647059,2131.70588235294,99.5882352941177
"7484","24269","2021",24,24,0,132262.958333333,1367.375,95.3333333333333
"7485","24271","2021",14,14,0,136658.571428571,1473.57142857143,92.5714285714286
"7486","24272","2021",8,8,0,132650,1635.5,93.875
"7487","24273","2021",7,7,0,246748.571428571,1703,161.571428571429
"7488","24274","2021",13,13,0,259780.769230769,1809.61538461538,140.153846153846
"7489","24276","2021",9,9,0,217051.111111111,1690.22222222222,133.888888888889
"7490","24277","2021",5,5,0,153580,1544.6,104.2
"7491","24278","2021",2,2,0,316250,1544.5,202.5
"7492","24279","2021",1,1,0,210000,1329,158
"7493","24280","2021",16,16,0,184134.1875,1714.125,112.375
"7494","24281","2021",3,3,0,285983.333333333,2398.66666666667,121.333333333333
"7495","24282","2021",3,3,0,238500,1311,186
"7496","24284","2021",1,1,0,187500,1242,151
"7497","24285","2021",3,3,0,263140,2114.66666666667,129.333333333333
"7498","24286","2021",10,10,0,170136.5,1507.3,115.9
"7499","24287","2021",6,6,0,293775,3521.5,92.1666666666667
"7500","24288","2021",9,9,0,178437.777777778,1477.55555555556,117.444444444444
"7501","24289","2021",34,34,0,194111.764705882,1605.20588235294,120.441176470588
"7502","24290","2021",6,6,0,252034,3782.33333333333,106.666666666667
"7503","24291","2021",84,80,4,147422.392857143,1571.25,94.1785714285714
"7504","24292","2021",14,14,0,202031.5,1834.07142857143,115.5
"7505","24293","2021",5,5,0,145930,1362.2,105
"7506","24294","2021",121,120,1,146325.338842975,1509.42975206612,104.677685950413
"7507","24295","2021",13,13,0,177526.923076923,1723.76923076923,101.923076923077
"7508","24296","2021",28,28,0,139447.142857143,1414.53571428571,100.5
"7509","24297","2021",21,18,3,125328.571428571,1373.90476190476,93.9047619047619
"7510","24299","2021",80,73,7,114489.925,1170.475,100.7375
"7511","24300","2021",6,6,0,273670,1727.83333333333,161.5
"7512","24301","2021",5,5,0,83510,1060.4,92.4
"7513","24302","2021",10,10,0,158053,1838.4,89
"7514","24303","2021",7,7,0,169995,1411.57142857143,120.571428571429
"7515","24304","2021",18,18,0,154627.777777778,1546.88888888889,99.6666666666667
"7516","24305","2021",6,6,0,164818.166666667,1415.33333333333,114
"7517","24306","2021",1,1,0,280000,1842,152
"7518","24307","2021",3,3,0,247050,1549.66666666667,175
"7519","24308","2021",15,15,0,116316.333333333,1162.46666666667,112.666666666667
"7520","24309","2021",52,52,0,145337.807692308,1432.80769230769,105.211538461538
"7521","24311","2021",53,50,3,112081.188679245,1202.96226415094,98.8301886792453
"7522","24312","2021",69,64,5,193030.31884058,1905.13043478261,102.492753623188
"7523","24316","2021",18,18,0,112347.5,1181.11111111111,96.6666666666667
"7524","24317","2021",5,5,0,261445,1860,134.2
"7525","24318","2021",10,10,0,188500,2029.9,92.4
"7526","24319","2021",16,16,0,188513.125,1773.125,116.5
"7527","24320","2021",25,24,1,118590.72,1400.32,93
"7528","24321","2021",14,11,3,151700,2119.21428571429,81.3571428571429
"7529","24322","2021",683,263,420,140158.651537335,1842.13323572474,76.0688140556369
"7530","24323","2021",4,4,0,115732.5,812.75,126.5
"7531","24324","2021",2,2,0,92850,1148,67
"7532","24325","2021",10,10,0,136850,1261,110.6
"7533","24326","2021",1,1,0,85000,773,110
"7534","24327","2021",1,1,0,315700,2105,150
"7535","24328","2021",38,34,4,116681.552631579,1134.65789473684,103.526315789474
"7536","24329","2021",31,31,0,143829.451612903,1471.35483870968,99.5806451612903
"7537","24330","2021",13,13,0,214962.692307692,1732.30769230769,123.153846153846
"7538","24331","2021",10,10,0,249709,2013,118.2
"7539","24334","2021",5,5,0,165000,1210.2,138
"7540","24335","2021",63,56,7,149012.587301587,1389.44444444444,104.111111111111
"7541","24336","2021",5,5,0,294302,2244.4,128.4
"7542","24337","2021",5,5,0,146100,2111.2,69.8
"7543","24338","2021",11,11,0,177563.636363636,1394.27272727273,124.909090909091
"7544","24339","2021",5,5,0,137569,1321.4,110.2
"7545","24340","2021",73,72,1,171552.739726027,1653.24657534247,105.849315068493
"7546","24341","2021",18,18,0,330381,2424.22222222222,146.555555555556
"7547","24345","2021",7,7,0,198944.857142857,1775.28571428571,112.571428571429
"7548","24346","2021",10,10,0,149644,1107.9,125.6
"7549","24348","2021",4,4,0,118113.5,917.75,123.5
"7550","24349","2021",3,3,0,206296.666666667,1599,120
"7551","24350","2021",35,33,2,148935.514285714,1493.57142857143,103.371428571429
"7552","24351","2021",4,4,0,296057.75,2365.75,116.75
"7553","24352","2021",82,77,5,125600.56097561,1341.51219512195,101.780487804878
"7554","24353","2021",10,10,0,141949.7,991.8,132.4
"7555","24354","2021",54,53,1,129596.12962963,1348.98148148148,98.8148148148148
"7556","24355","2021",11,11,0,210385,1868.18181818182,118.727272727273
"7557","24356","2021",27,27,0,165454.814814815,1652.62962962963,98.8518518518518
"7558","24357","2021",7,7,0,114528.857142857,1194.28571428571,101.571428571429
"7559","24359","2021",5,5,0,242625.2,1933.8,123.4
"7560","24360","2021",2,2,0,85700,1680,64
"7561","24361","2021",6,6,0,221568.333333333,1960,115.166666666667
"7562","24362","2021",48,40,8,200815.854166667,2113.16666666667,101.8125
"7563","24364","2021",14,14,0,213566.357142857,1808.07142857143,115.785714285714
"7564","24365","2021",5,5,0,240860,2518.4,102.4
"7565","24366","2021",10,10,0,238266,2138.8,109.4
"7566","24367","2021",2,2,0,66000,1021,68
"7567","24370","2021",23,23,0,135477.043478261,1146.73913043478,118.304347826087
"7568","24371","2021",10,9,1,146044.2,1363.8,109.9
"7569","24372","2021",103,89,14,138220.252427184,1467.96116504854,94.5728155339806
"7570","24373","2021",7,7,0,204532.285714286,1481.71428571429,130.857142857143
"7571","24374","2021",9,9,0,169800,1763.22222222222,93.7777777777778
"7572","24376","2021",26,26,0,119698.807692308,1252.65384615385,94.2307692307692
"7573","24377","2021",2,2,0,243500,1479.5,153.5
"7574","24378","2021",3,3,0,215000,2166.33333333333,99
"7575","24379","2021",11,11,0,195943.909090909,1757.81818181818,140.272727272727
"7576","24380","2021",11,11,0,180302.727272727,1408.09090909091,124.272727272727
"7577","24381","2021",4,4,0,120600,1953.5,59.5
"7578","24382","2021",16,16,0,112756.25,1218.8125,92.1875
"7579","24383","2021",2,2,0,201250,1657,110
"7580","24384","2021",1,1,0,286000,1810,158
"7581","24385","2021",5,5,0,170000,1602,113.2
"7582","24386","2021",6,6,0,118481.666666667,1169.66666666667,104
"7583","24388","2021",14,14,0,231733.928571429,1805.71428571429,130
"7584","24390","2021",3,3,0,145733.333333333,1338.66666666667,116.666666666667
"7585","24392","2021",11,11,0,239343.636363636,2127.45454545455,110.272727272727
"7586","24393","2021",3,3,0,279666.666666667,2017,147.666666666667
"7587","24394","2021",4,4,0,213250,1350.25,148.5
"7588","24395","2021",10,10,0,220037,2003.7,110.6
"7589","24396","2021",42,39,3,174840.238095238,1628.2619047619,103
"7590","24397","2021",8,8,0,153655.125,1327.25,111.875
"7591","24398","2021",10,10,0,165066,1312.6,117.4
"7592","24399","2021",2,2,0,91750,855.5,120.5
"7593","24401","2021",11,11,0,129545.454545455,1022.09090909091,118.545454545455
"7594","24403","2021",2,2,0,52500,536,101.5
"7595","24404","2021",3,3,0,184180.333333333,2492,74
"7596","24405","2021",4,4,0,181586.25,1294.5,162.25
"7597","24406","2021",1,1,0,195000,1625,120
"7598","24407","2021",5,5,0,226870,2116.4,110
"7599","24408","2021",4,4,0,117187.5,879.75,129.5
"7600","24409","2021",17,17,0,130778.588235294,1216.52941176471,108.294117647059
"7601","24410","2021",8,8,0,117268.875,1144.625,104.875
"7602","24411","2021",1,1,0,275812,932,296
"7603","24412","2021",11,7,4,205908.636363636,1665.27272727273,111.272727272727
"7604","24413","2021",5,5,0,174911.6,1483,112.4
"7605","24414","2021",3,3,0,271533.333333333,2237,132.333333333333
"7606","24415","2021",3,3,0,246261.666666667,1926,155
"7607","24416","2021",4,4,0,268250,2022,119.75
"7608","24417","2021",10,10,0,158911.4,1370.7,118
"7609","24418","2021",16,16,0,183763.125,1444.625,123.25
"7610","24419","2021",16,16,0,159886.875,1403.3125,116.125
"7611","24420","2021",1,1,0,116000,682,170
"7612","24421","2021",6,6,0,188416.666666667,2225.16666666667,92.5
"7613","24422","2021",2,2,0,130500,1230,104.5
"7614","24423","2021",8,8,0,266739.375,1801.5,164
"7615","24424","2021",3,3,0,157833.333333333,1803,90.3333333333333
"7616","24425","2021",8,8,0,252768.75,1966.5,127
"7617","24426","2021",4,4,0,216993.75,1784,124.25
"7618","24428","2021",11,11,0,190959.818181818,1160.27272727273,145.363636363636
"7619","24429","2021",8,8,0,138918.75,1203.625,116.875
"7620","24432","2021",18,18,0,208630.555555556,1657.83333333333,121
"7621","24434","2021",1,1,0,50000,1250,40
"7622","24436","2021",16,16,0,151333.4375,1629.5,109.5
"7623","24437","2021",12,12,0,211633.333333333,1860.5,116.25
"7624","24438","2021",6,6,0,228430,1717.16666666667,138.5
"7625","24441","2021",5,5,0,141868,1892.2,103.8
"7626","24442","2021",29,29,0,120531.75862069,1350.10344827586,91.1379310344828
"7627","24443","2021",8,8,0,282633.75,2339.25,123.375
"7628","24444","2021",2,2,0,74000,1041,76.5
"7629","24445","2021",4,4,0,292800,1972.25,135.25
"7630","24446","2021",1,1,0,385000,3056,126
"7631","24448","2021",8,8,0,170954.375,1490,115
"7632","24449","2021",20,20,0,149705.4,1452.6,107.1
"7633","24450","2021",20,20,0,159079.35,1533.6,101.05
"7634","24451","2021",15,15,0,141953.333333333,1543.4,89.8666666666667
"7635","24452","2021",5,5,0,168376,1285.2,140
"7636","24453","2021",7,7,0,195742.857142857,1335.57142857143,137.285714285714
"7637","24454","2021",12,12,0,162341.666666667,1247.33333333333,135.583333333333
"7638","24455","2021",10,10,0,132807.5,1311.2,101
"7639","24456","2021",3,3,0,202000,1637.33333333333,124.333333333333
"7640","24457","2021",4,4,0,81125,815.5,96.25
"7641","24458","2021",6,6,0,138691.666666667,1121.33333333333,126
"7642","24459","2021",6,5,1,96185.1666666667,1145,98.8333333333333
"7643","24460","2021",12,12,0,159135.5,1305.75,129.416666666667
"7644","24461","2021",13,13,0,184065.384615385,1311.92307692308,134.461538461538
"7645","24462","2021",22,22,0,120922.227272727,1338.63636363636,91.2272727272727
"7646","24463","2021",18,18,0,139156.666666667,1607.27777777778,89.8888888888889
"7647","24464","2021",7,7,0,122964.285714286,1238,102.857142857143
"7648","24465","2021",3,3,0,198850,2703.33333333333,72
"7649","24466","2021",4,4,0,318762.5,2301.25,130.5
"7650","24468","2021",2,2,0,163300,2006,73.5
"7651","24470","2021",5,5,0,184000,1518.6,121.2
"7652","24471","2021",4,4,0,211500,1861,116.25
"7653","24472","2021",23,23,0,209052.173913043,1663.21739130435,121.347826086957
"7654","24473","2021",12,12,0,154432.916666667,1608.83333333333,94.5833333333333
"7655","24476","2021",4,4,0,194968.75,1620,112.5
"7656","24477","2021",3,3,0,383766.666666667,1442.33333333333,237.333333333333
"7657","24478","2021",5,5,0,163000,2176.2,79
"7658","24479","2021",27,27,0,120188.888888889,1111.07407407407,103.740740740741
"7659","24480","2021",3,3,0,222214.666666667,1500,145.333333333333
"7660","24481","2021",13,13,0,96448.4615384615,914.461538461538,106.307692307692
"7661","24482","2021",7,7,0,202976.428571429,2120.42857142857,95.2857142857143
"7662","24483","2021",2,2,0,256000,2014.5,139
"7663","24484","2021",10,10,0,150420,1739.6,91.4
"7664","24485","2021",7,7,0,132278,977.428571428571,133.571428571429
"7665","24486","2021",13,13,0,135560.846153846,1050.92307692308,108.538461538462
"7666","24487","2021",27,26,1,155162.777777778,1581.11111111111,96.5555555555556
"7667","24488","2021",9,9,0,173655.555555556,1741.66666666667,106.333333333333
"7668","24489","2021",3,3,0,108406.666666667,1293.66666666667,96.6666666666667
"7669","24490","2021",24,24,0,129818.416666667,1196.91666666667,114.291666666667
"7670","24491","2021",15,15,0,148957.333333333,1578.46666666667,94.8666666666667
"7671","24492","2021",4,4,0,137687.5,1405,99.25
"7672","24493","2021",5,5,0,52564,1041.2,53.8
"7673","24494","2021",4,4,0,148717.5,1303.5,112.75
"7674","24495","2021",1,1,0,266000,4433,60
"7675","24496","2021",4,4,0,121875,1537.5,74
"7676","24498","2021",26,26,0,117316.807692308,1386.42307692308,94.1153846153846
"7677","24499","2021",16,16,0,194197.5,1619.4375,118.1875
"7678","24500","2021",3,3,0,69000,982,63.6666666666667
"7679","24501","2021",16,16,0,162062.8125,1612.0625,108.3125
"7680","24502","2021",1,1,0,70000,493,142
"7681","24504","2021",4,4,0,90350,1125.25,71.25
"7682","24505","2021",8,8,0,89437.5,835.25,105.125
"7683","24507","2021",3,3,0,147600,1450,98
"7684","24508","2021",1,1,0,208320,1947,107
"7685","24509","2021",11,11,0,119590.909090909,1273.81818181818,92.5454545454545
"7686","24510","2021",8,8,0,172350,1663.875,104.125
"7687","24511","2021",2,2,0,197550,1563.5,124
"7688","24512","2021",4,4,0,299045,2099.25,129.25
"7689","24513","2021",5,5,0,202400,1396.8,128.6
"7690","24514","2021",6,6,0,73333.3333333333,954.666666666667,83.6666666666667
"7691","24515","2021",1,1,0,85000,1574,54
"7692","24516","2021",28,28,0,178960.178571429,1495,121.892857142857
"7693","24517","2021",2,2,0,161000,1271,131.5
"7694","24518","2021",1,1,0,186500,2096,89
"7695","24519","2021",9,9,0,97311.1111111111,1123.77777777778,78.2222222222222
"7696","24520","2021",202,112,90,164810.653465347,1980.38118811881,87.8267326732673
"7697","24521","2021",16,16,0,160875,1547.1875,107.5625
"7698","24522","2021",7,7,0,127357.142857143,1445.28571428571,84.5714285714286
"7699","24523","2021",14,14,0,217320.571428571,1500.57142857143,145.071428571429
"7700","24524","2021",3,3,0,85666.6666666667,1110.33333333333,73
"7701","24525","2021",5,5,0,112020,1325.4,90.4
"7702","24526","2021",20,20,0,165278.45,1673.2,108.6
"7703","24527","2021",22,22,0,149419.545454545,1552.77272727273,104.545454545455
"7704","24528","2021",2,2,0,145000,1664.5,87.5
"7705","24529","2021",1,1,0,90000,818,110
"7706","24531","2021",1,1,0,160000,1600,100
"7707","24532","2021",4,4,0,335239,2088,162.5
"7708","24533","2021",2,2,0,148704,2346.5,78
"7709","24534","2021",25,25,0,153865.2,1500.76,104.28
"7710","24535","2021",3,3,0,206606.666666667,1868.33333333333,110.666666666667
"7711","24536","2021",7,7,0,204277.142857143,1974,107.428571428571
"7712","24537","2021",4,4,0,128000,1041.5,133
"7713","24538","2021",30,30,0,176545.166666667,1462.83333333333,120.533333333333
"7714","24540","2021",27,27,0,160865.851851852,1544.44444444444,107.62962962963
"7715","24541","2021",2,2,0,109250,961.5,89
"7716","24542","2021",1,1,0,150000,1111,135
"7717","24543","2021",24,24,0,152163.083333333,1393.625,111.5
"7718","24544","2021",6,6,0,195585.666666667,1393.83333333333,124.333333333333
"7719","24545","2021",2,2,0,194250,1555.5,128
"7720","24547","2021",121,83,38,111954.537190083,1485.04958677686,78.2148760330578
"7721","24548","2021",3,3,0,253376.666666667,2652.66666666667,96.3333333333333
"7722","24549","2021",8,8,0,390005.875,2113,188.375
"7723","24550","2021",19,19,0,106218.421052632,1279.42105263158,82
"7724","24551","2021",59,57,2,123257.440677966,1103.83050847458,112
"7725","24552","2021",6,6,0,160166.666666667,2310.33333333333,67.5
"7726","24553","2021",24,24,0,146072.5,1343.25,113.416666666667
"7727","24554","2021",14,14,0,122258.785714286,1259.28571428571,94.9285714285714
"7728","24555","2021",23,23,0,107254.347826087,1166.47826086957,91.9130434782609
"7729","24557","2021",163,104,59,156868.098159509,1693.93251533742,91.5705521472393
"7730","24558","2021",21,21,0,225389.714285714,1743.57142857143,132.52380952381
"7731","24559","2021",11,11,0,194117.727272727,1639.27272727273,126.090909090909
"7732","24560","2021",3,3,0,146163.333333333,1382.33333333333,110
"7733","24562","2021",4,4,0,189605,1382.75,128
"7734","24563","2021",5,5,0,206340,1893.8,101
"7735","24564","2021",14,14,0,112323.714285714,1217,99.6428571428571
"7736","24565","2021",12,12,0,90584.8333333333,1013.33333333333,94.9166666666667
"7737","24566","2021",8,8,0,136525,1271,107
"7738","24567","2021",6,6,0,156666.666666667,1113.33333333333,128.166666666667
"7739","24568","2021",18,18,0,149561.166666667,1348.5,113.111111111111
"7740","24569","2021",6,6,0,126233.333333333,1149,99.8333333333333
"7741","24571","2021",23,23,0,131125.47826087,1252.69565217391,105.913043478261
"7742","24572","2021",8,8,0,229371.25,1993,118.875
"7743","24573","2021",15,15,0,171532.6,1355.26666666667,133.6
"7744","24574","2021",5,5,0,270418,2178,126.8
"7745","24575","2021",6,6,0,268776.666666667,1742.16666666667,148.333333333333
"7746","24576","2021",4,4,0,268250,2126.75,120.5
"7747","24577","2021",13,13,0,257044.076923077,2667.15384615385,111.461538461538
"7748","24580","2021",4,4,0,133750,1142.75,124.75
"7749","24581","2021",12,12,0,101048.333333333,1052.25,98.6666666666667
"7750","24582","2021",10,10,0,102960,1040.5,95.3
"7751","24584","2021",17,16,1,153369.705882353,1712,103.117647058824
"7752","24585","2021",18,18,0,117276,1165.72222222222,95.3333333333333
"7753","24586","2021",14,14,0,163023.928571429,1269.92857142857,141.928571428571
"7754","24587","2021",14,14,0,252648.714285714,2321.5,111.714285714286
"7755","25001","2021",3,3,0,224000,1959.66666666667,119.666666666667
"7756","25002","2021",3,3,0,112766.666666667,1664.33333333333,76.6666666666667
"7757","25003","2021",3,2,1,74000,1478.33333333333,51.3333333333333
"7758","25004","2021",14,5,9,123871.428571429,1430.57142857143,82.3571428571429
"7759","25005","2021",1,1,0,63500,538,118
"7760","25006","2021",2,1,1,127500,1616.5,85
"7761","25008","2021",5,5,0,171080,1644.2,105.8
"7762","25009","2021",1,1,0,223500,2213,101
"7763","25011","2021",12,11,1,157362.75,1535.75,104
"7764","25013","2021",4,1,3,318055,1473.25,155
"7765","25014","2021",6,6,0,229941.666666667,2444.33333333333,97.3333333333333
"7766","25015","2021",5,5,0,187400,1748.4,109.6
"7767","25016","2021",3,3,0,127400,905.666666666667,141
"7768","25017","2021",1,1,0,240000,2222,108
"7769","25018","2021",6,5,1,119228.333333333,1143.33333333333,111.833333333333
"7770","25019","2021",1,1,0,85000,649,131
"7771","25020","2021",17,12,5,116111.470588235,1418.94117647059,80.5294117647059
"7772","25021","2021",10,10,0,159391,1281.4,136.8
"7773","25022","2021",10,9,1,152610,1565.1,104
"7774","25024","2021",3,1,2,222523.666666667,3343.66666666667,70.6666666666667
"7775","25025","2021",8,8,0,197757.5,2234.75,107.75
"7776","25026","2021",4,4,0,146083.5,1218,125.75
"7777","25029","2021",5,5,0,241600,1878,130.4
"7778","25030","2021",4,4,0,182475,2134.5,86.25
"7779","25031","2021",169,98,71,115058.171597633,1463.97633136095,82.8934911242604
"7780","25032","2021",2,2,0,193000,2158,90
"7781","25033","2021",10,10,0,196573,1743.7,117.8
"7782","25035","2021",26,16,10,222740.769230769,2392.88461538462,96.3846153846154
"7783","25036","2021",24,21,3,199461.458333333,1971.95833333333,102.833333333333
"7784","25038","2021",3,3,0,162466.666666667,1630.66666666667,99.3333333333333
"7785","25039","2021",10,9,1,222914,2450.8,107.5
"7786","25040","2021",9,8,1,151594.444444444,1643.11111111111,100.888888888889
"7787","25041","2021",3,3,0,201728.333333333,1530.33333333333,147
"7788","25042","2021",1,1,0,248600,2645,94
"7789","25043","2021",20,15,5,157833.25,1707.65,95.45
"7790","25044","2021",3,3,0,77666.6666666667,908.333333333333,88.3333333333333
"7791","25045","2021",1,0,1,195000,2786,70
"7792","25047","2021",73,33,40,119450.410958904,1434.83561643836,81.3698630136986
"7793","25048","2021",48,38,10,146100.208333333,1649.5625,93.125
"7794","25049","2021",2,2,0,233350,2633.5,91
"7795","25050","2021",2,2,0,201935,2457.5,92
"7796","25051","2021",6,6,0,185105,1949.33333333333,102.666666666667
"7797","25052","2021",1,1,0,30000,667,45
"7798","25053","2021",2,2,0,145612.5,1285,98
"7799","25054","2021",5,3,2,155542,1581.8,95
"7800","25055","2021",6,6,0,205510,2032.33333333333,95.6666666666667
"7801","25056","2021",2050,239,1811,145474.793170732,2167.06975609756,68.0858536585366
"7802","25057","2021",41,34,7,122926.146341463,1369.31707317073,89.1463414634146
"7803","25058","2021",20,13,7,182800,1983.35,86.55
"7804","25059","2021",3,3,0,139333.333333333,1208,115
"7805","25060","2021",13,10,3,206830.076923077,2046.53846153846,105.461538461538
"7806","25061","2021",2,2,0,102750,2154,56
"7807","25062","2021",2,1,1,168000,2000,84
"7808","25063","2021",14,9,5,216057.142857143,2351.92857142857,96
"7809","25066","2021",1,1,0,325000,1912,170
"7810","25067","2021",2,2,0,112675,1587,71
"7811","25070","2021",4,4,0,166625,1953.75,92.5
"7812","25071","2021",6,4,2,138816.666666667,1595,86
"7813","25073","2021",8,7,1,225412.5,2168.75,103.5
"7814","25074","2021",7,7,0,240710,2193,106.428571428571
"7815","25075","2021",4,4,0,238007.5,2242.75,96.75
"7816","25078","2021",5,5,0,172110,1634.4,102.6
"7817","25079","2021",6,6,0,249503.5,1900.66666666667,134.833333333333
"7818","25082","2021",8,7,1,198750,1794.25,101.75
"7819","25083","2021",4,4,0,128037.5,1713.75,71
"7820","25084","2021",14,12,2,220153.571428571,2279.5,96.2857142857143
"7821","25085","2021",9,5,4,223106.666666667,2285.88888888889,101.777777777778
"7822","25086","2021",1,1,0,260820,2532,103
"7823","25087","2021",1,1,0,187000,1417,132
"7824","25088","2021",1,1,0,120000,615,195
"7825","25091","2021",6,6,0,219408.333333333,1666.16666666667,128.5
"7826","25092","2021",1,1,0,111000,1291,86
"7827","25093","2021",1,1,0,399780,2173,184
"7828","25095","2021",6,6,0,131916.666666667,1173.33333333333,120.166666666667
"7829","25097","2021",2,2,0,245000,2230,111.5
"7830","25098","2021",2,2,0,70000,980.5,89
"7831","25099","2021",1,1,0,307000,3301,93
"7832","25100","2021",4,2,2,309800,2934.75,108
"7833","25101","2021",6,6,0,179138.333333333,1500.83333333333,123.333333333333
"7834","25103","2021",6,6,0,198541.666666667,2122.16666666667,96.6666666666667
"7835","25105","2021",6,6,0,180533.333333333,1863,96
"7836","25107","2021",6,6,0,155766.666666667,1423.83333333333,113.833333333333
"7837","25108","2021",6,4,2,247477.5,2448.83333333333,104.833333333333
"7838","25109","2021",4,3,1,176070,1664,109.5
"7839","25110","2021",19,11,8,307993.421052632,2846.31578947368,107.736842105263
"7840","25111","2021",3,3,0,172152.333333333,1607.66666666667,100.666666666667
"7841","25112","2021",22,9,13,180658.181818182,2128.13636363636,79.4545454545455
"7842","25114","2021",5,5,0,95838,1459.8,75
"7843","25115","2021",4,3,1,237187.5,2105.25,116.5
"7844","25116","2021",1,1,0,194000,1940,100
"7845","25117","2021",1,1,0,195000,1364,143
"7846","25119","2021",3,3,0,257823.333333333,2521.33333333333,101
"7847","25120","2021",2,2,0,184975,2039.5,91.5
"7848","25122","2021",6,4,2,171255,1374.33333333333,139.333333333333
"7849","25124","2021",2,2,0,202500,1164,171.5
"7850","25125","2021",4,3,1,159025,1501.75,100
"7851","25126","2021",7,7,0,228357.142857143,1876,130.142857142857
"7852","25127","2021",64,35,29,185337.59375,2055.5,87.71875
"7853","25129","2021",1,1,0,222780,1526,146
"7854","25131","2021",1,1,0,299000,2875,104
"7855","25133","2021",29,26,3,293251.827586207,2469,119.172413793103
"7856","25136","2021",5,5,0,155100,1588.2,113
"7857","25138","2021",2,2,0,137125,1814,83
"7858","25139","2021",5,5,0,294758,2368.2,124.2
"7859","25142","2021",8,7,1,255112.5,2869.75,89.625
"7860","25143","2021",3,3,0,158566.666666667,1601.66666666667,92
"7861","25145","2021",4,4,0,162850,1429.5,123.75
"7862","25147","2021",19,16,3,278161.578947368,2342.21052631579,125.052631578947
"7863","25148","2021",7,4,3,324326.714285714,2857.28571428571,113.714285714286
"7864","25149","2021",5,5,0,262230,1984,152.4
"7865","25150","2021",3,3,0,216750,2280,94
"7866","25151","2021",1,1,0,315000,2386,132
"7867","25153","2021",4,4,0,171375,1635.5,111.5
"7868","25154","2021",1,1,0,166000,1566,106
"7869","25155","2021",4,3,1,126250,1151.25,115.75
"7870","25156","2021",14,13,1,109214.285714286,1376.35714285714,88.8571428571429
"7871","25157","2021",21,13,8,253557.714285714,2641.33333333333,97.3809523809524
"7872","25159","2021",18,11,7,133094.444444444,1346.27777777778,95.3888888888889
"7873","25160","2021",4,4,0,314175,2789.75,111.5
"7874","25162","2021",5,5,0,205290,1818.4,120
"7875","25164","2021",1,1,0,258000,1955,132
"7876","25166","2021",3,3,0,157722.666666667,1171.66666666667,145.333333333333
"7877","25170","2021",11,8,3,169127.272727273,1579.90909090909,105.636363636364
"7878","25172","2021",2,2,0,290500,2041.5,142.5
"7879","25173","2021",4,4,0,194750,1474.5,142
"7880","25174","2021",5,5,0,162003.6,1761.2,97
"7881","25175","2021",2,2,0,156500,1420,114.5
"7882","25176","2021",6,6,0,194216.666666667,2093.83333333333,113.333333333333
"7883","25178","2021",1,1,0,70000,579,121
"7884","25180","2021",4,3,1,141712.5,2068.25,70.75
"7885","25181","2021",2,2,0,154500,1339.5,117.5
"7886","25182","2021",1,1,0,146950,1547,95
"7887","25183","2021",3,3,0,130333.333333333,1898,78.6666666666667
"7888","25184","2021",1,1,0,30000,566,53
"7889","25186","2021",9,6,3,214300.555555556,2149.77777777778,102.777777777778
"7890","25187","2021",10,10,0,147680,1323.9,114.4
"7891","25188","2021",14,10,4,207450.357142857,1998.85714285714,106.357142857143
"7892","25190","2021",21,15,6,124843.80952381,1427.85714285714,83.8095238095238
"7893","25191","2021",4,3,1,135375,1418.5,86.25
"7894","25193","2021",37,24,13,194404.189189189,1967.48648648649,101.540540540541
"7895","25195","2021",18,17,1,246528.888888889,2237.55555555556,116.444444444444
"7896","25196","2021",21,18,3,173301.333333333,1649.90476190476,104.285714285714
"7897","25197","2021",6,3,3,141626.666666667,1645,82.6666666666667
"7898","25198","2021",7,6,1,146565.857142857,1630.71428571429,103.714285714286
"7899","25199","2021",4,2,2,131250,1117,128.75
"7900","25200","2021",14,9,5,220964.285714286,1870.92857142857,112.071428571429
"7901","25201","2021",9,4,5,260688.888888889,3420.11111111111,76.6666666666667
"7902","25202","2021",4,3,1,231873.75,2362.5,116.75
"7903","25203","2021",4,4,0,101625,914.25,122.5
"7904","25204","2021",41,18,23,254897.146341463,2754.21951219512,93.4146341463415
"7905","25207","2021",5,5,0,134800,1564.2,88.8
"7906","25208","2021",2,2,0,234200,1804.5,131
"7907","25209","2021",1,1,0,150000,1316,114
"7908","25210","2021",1,1,0,239400,1469,163
"7909","25211","2021",1,1,0,155000,503,308
"7910","25212","2021",42,28,14,230160.523809524,2263.2380952381,100.309523809524
"7911","25213","2021",7,7,0,297467.285714286,2124.14285714286,136.571428571429
"7912","25214","2021",7,6,1,117357.142857143,1294.57142857143,93.7142857142857
"7913","25216","2021",2,2,0,229625,1844.5,122.5
"7914","25217","2021",8,6,2,176886.25,1884.75,96.5
"7915","25219","2021",6,6,0,243406.666666667,2307.66666666667,107.333333333333
"7916","25220","2021",3,3,0,270226.666666667,2211.33333333333,128
"7917","25222","2021",12,10,2,149937.5,1672.58333333333,106.75
"7918","25223","2021",5,5,0,176660,1381.4,131.2
"7919","25224","2021",5,4,1,168260,2033.4,91.6
"7920","25225","2021",2,2,0,220810,1854,118.5
"7921","25226","2021",4,4,0,207000,1615,128
"7922","25227","2021",3,3,0,138600,1181.33333333333,108.333333333333
"7923","25228","2021",48,35,13,160649.166666667,1741.66666666667,94.7083333333333
"7924","25229","2021",4,3,1,190250,1641.25,126.25
"7925","25230","2021",36,31,5,171085.277777778,1754.44444444444,100.083333333333
"7926","25231","2021",2,2,0,222750,1607,137
"7927","25232","2021",3,0,3,46783.3333333333,684.333333333333,68.3333333333333
"7928","25233","2021",2,2,0,172000,1733,99.5
"7929","25235","2021",4,3,1,250200,2122.25,122.25
"7930","25236","2021",2,2,0,299000,2079.5,145
"7931","25237","2021",41,23,18,120584.951219512,1345.73170731707,91.4390243902439
"7932","25238","2021",3,3,0,163333.333333333,2281.33333333333,113.333333333333
"7933","25239","2021",2,2,0,163900,2216,73.5
"7934","25240","2021",34,20,14,250208.705882353,2768.26470588235,96.2058823529412
"7935","25241","2021",2,2,0,170000,1433.5,124.5
"7936","25242","2021",2,2,0,123540,1499.5,90
"7937","25243","2021",12,8,4,238939.166666667,2486,101.833333333333
"7938","25245","2021",10,9,1,234139,1991.2,122.9
"7939","25246","2021",4,4,0,134400,1356.75,105.25
"7940","25247","2021",2,2,0,73000,1283.5,89
"7941","25248","2021",10,10,0,189825,1753.8,140.5
"7942","25251","2021",3,3,0,70000,993.333333333333,72.6666666666667
"7943","25253","2021",4,4,0,176087.5,1841.5,96.75
"7944","25254","2021",22,8,14,201760.909090909,2500.59090909091,81.7272727272727
"7945","25255","2021",7,4,3,245035.714285714,2255.42857142857,101.857142857143
"7946","25256","2021",15,13,2,203935.666666667,1995.93333333333,107.266666666667
"7947","25257","2021",1,1,0,97500,1434,68
"7948","25258","2021",15,12,3,228143.333333333,2211.86666666667,104.466666666667
"7949","25259","2021",35,16,19,162547.885714286,1973.88571428571,85.3714285714286
"7950","25261","2021",1,1,0,125000,1420,88
"7951","25262","2021",4,4,0,294777.5,2191.25,135.5
"7952","25263","2021",3,3,0,330933.333333333,2589,122.333333333333
"7953","25264","2021",2,2,0,130225,1104,126.5
"7954","25265","2021",21,14,7,212927,2023.90476190476,104.190476190476
"7955","25267","2021",3,3,0,204200,1575.66666666667,125.333333333333
"7956","25268","2021",1,1,0,130000,915,142
"7957","25269","2021",1,1,0,100300,1003,100
"7958","25270","2021",2,2,0,252758,2016.5,126.5
"7959","25271","2021",25,14,11,196006.88,2327.88,85.2
"7960","25273","2021",3,3,0,128906.333333333,1501,93.3333333333333
"7961","25274","2021",8,2,6,88167.5,959.625,90.125
"7962","25275","2021",4,4,0,72000,1036.5,72
"7963","25276","2021",1,1,0,110000,821,134
"7964","25279","2021",2,1,1,85625,814.5,115.5
"7965","25280","2021",6,6,0,152899.333333333,2903,62.3333333333333
"7966","25281","2021",1,1,0,147000,1413,104
"7967","25282","2021",4,4,0,189600,2671,77.75
"7968","25283","2021",1,1,0,107000,1672,64
"7969","25284","2021",68,41,27,127013.897058824,1487.85294117647,84.8529411764706
"7970","25285","2021",13,9,4,255412.307692308,2728.61538461538,101.615384615385
"7971","25287","2021",23,20,3,266563.043478261,2292.95652173913,122.347826086957
"7972","25288","2021",7,7,0,258778.571428571,2022.42857142857,151.571428571429
"7973","25293","2021",19,8,11,283968.368421053,2905.26315789474,98.8947368421053
"7974","25295","2021",3,1,2,207633.333333333,2951,65.6666666666667
"7975","25296","2021",9,5,4,257442.222222222,2574.88888888889,106.777777777778
"7976","25297","2021",1,1,0,211500,1823,116
"7977","25298","2021",1,1,0,189000,1750,108
"7978","25299","2021",2,2,0,71600,746,96
"7979","25301","2021",6,6,0,253451.666666667,2260.16666666667,115.333333333333
"7980","25304","2021",52,39,13,114515.153846154,1300.71153846154,87.4615384615385
"7981","25305","2021",4,3,1,233675,1812,130.5
"7982","25306","2021",3,3,0,150000,1459.33333333333,104.333333333333
"7983","25307","2021",35,18,17,249202.885714286,3374.97142857143,72.6285714285714
"7984","25308","2021",3,2,1,268333.333333333,2693,117
"7985","25309","2021",12,9,3,303703.333333333,3813.25,86.8333333333333
"7986","25310","2021",2,1,1,351325,1719,181
"7987","25311","2021",2,2,0,198000,1145,171
"7988","25312","2021",2,2,0,49250,1024.5,61
"7989","25314","2021",2,2,0,209700,2452.5,122
"7990","25315","2021",52,41,11,106185.519230769,1186.36538461538,93.2884615384615
"7991","25317","2021",1,1,0,238200,2978,80
"7992","25318","2021",40,24,16,227648.225,3139.5,71.95
"7993","25320","2021",27,11,16,258959.925925926,3007.14814814815,86
"7994","25321","2021",92,40,52,225254.02173913,2655.46739130435,85.6413043478261
"7995","25322","2021",4,4,0,230625,1745,132
"7996","25323","2021",9,8,1,128284.444444444,1403.33333333333,98.6666666666667
"7997","25324","2021",1,1,0,130000,1646,79
"7998","25325","2021",2,2,0,126450,1574.5,80
"7999","25326","2021",6,6,0,225708.333333333,1544.66666666667,146.166666666667
"8000","25327","2021",1,1,0,134530,1583,85
"8001","25328","2021",7,4,3,242122.857142857,2538.85714285714,91.7142857142857
"8002","25329","2021",1,1,0,110000,671,164
"8003","25330","2021",4,4,0,269875,1387.5,178.25
"8004","25331","2021",1,1,0,145000,2302,63
"8005","25332","2021",8,5,3,193284.375,1865.875,100.625
"8006","25333","2021",3,2,1,222166.666666667,1782,128
"8007","25334","2021",26,19,7,210985.5,2078.03846153846,102.384615384615
"8008","25335","2021",2,2,0,157400,1534.5,96
"8009","25336","2021",6,6,0,169235,1367,126.166666666667
"8010","25339","2021",7,4,3,222200,1640.57142857143,127.857142857143
"8011","25340","2021",3,3,0,226370,1512.66666666667,146.333333333333
"8012","25342","2021",2,2,0,116900,946.5,122.5
"8013","25343","2021",1,1,0,165000,3511,47
"8014","25344","2021",1,1,0,182500,2028,90
"8015","25345","2021",8,8,0,132987.5,1396.375,93.5
"8016","25346","2021",2,2,0,189184,2066.5,89.5
"8017","25347","2021",3,3,0,321666.666666667,2462.66666666667,128.666666666667
"8018","25348","2021",5,2,3,273576,2844.4,90.2
"8019","25349","2021",4,4,0,223125,1730.5,127.25
"8020","25350","2021",7,7,0,155357.142857143,1657.42857142857,94.8571428571429
"8021","25351","2021",4,3,1,190007.5,2138,81
"8022","25355","2021",2,2,0,227210,2053.5,108.5
"8023","25356","2021",68,38,30,180079.294117647,2113.25,86.6323529411765
"8024","25357","2021",3,2,1,276183.333333333,1617,175.666666666667
"8025","25360","2021",1,1,0,163000,1811,90
"8026","25361","2021",25,7,18,205537.36,3564.64,60.76
"8027","25362","2021",1,1,0,371400,928,400
"8028","25364","2021",14,13,1,235406.428571429,2290.28571428571,104.642857142857
"8029","25365","2021",3,3,0,94043.3333333333,1259.66666666667,71.3333333333333
"8030","25367","2021",50,29,21,110479.32,1213.06,86.58
"8031","25368","2021",21,18,3,206698.571428571,2297.28571428571,94.6190476190476
"8032","25370","2021",14,14,0,186610.714285714,1980,98.4285714285714
"8033","25371","2021",3,3,0,230166.666666667,2127.33333333333,102.666666666667
"8034","25372","2021",7,7,0,120778.571428571,1289.28571428571,93.4285714285714
"8035","25373","2021",2,2,0,272875,3040,109
"8036","25374","2021",7,7,0,169928.571428571,1643.57142857143,109
"8037","25375","2021",2,2,0,295288.5,2731,108
"8038","25376","2021",3,3,0,249666.666666667,2401.66666666667,103.666666666667
"8039","25377","2021",1,1,0,175750,1569,112
"8040","25378","2021",4,3,1,84550,1143.5,90.75
"8041","25379","2021",1,1,0,46500,1550,30
"8042","25380","2021",98,25,73,144011.632653061,3168.62244897959,45.9285714285714
"8043","25381","2021",37,25,12,255111.945945946,2468.54054054054,103.540540540541
"8044","25382","2021",3,3,0,181000,1464.33333333333,122
"8045","25383","2021",5,5,0,188940,2393.2,102.4
"8046","25385","2021",1,1,0,55000,591,93
"8047","25386","2021",2,2,0,38500,756,72
"8048","25387","2021",3,3,0,204786.666666667,2264,90.6666666666667
"8049","25388","2021",339,80,259,97029.3775811209,1161.85250737463,80.8702064896755
"8050","25389","2021",1,1,0,234800,2421,97
"8051","25390","2021",7,1,6,147857.142857143,1799,79
"8052","25391","2021",1,1,0,155000,2583,60
"8053","25392","2021",2,2,0,209500.5,1757.5,130
"8054","25393","2021",10,10,0,114922.5,1038,124.2
"8055","25394","2021",15,15,0,175684,1717.2,101.333333333333
"8056","25395","2021",21,16,5,274626.857142857,2416,112.666666666667
"8057","25397","2021",24,16,8,194555.833333333,2146.83333333333,90.2916666666667
"8058","25398","2021",2,2,0,309550,3563.5,90.5
"8059","25400","2021",7,5,2,140742.857142857,1472.28571428571,102.714285714286
"8060","25403","2021",26,11,15,282940.769230769,2809.84615384615,101.884615384615
"8061","25404","2021",4,4,0,218650,1603.75,169.5
"8062","25405","2021",11,9,2,359711.363636364,3421,108.363636363636
"8063","25406","2021",7,7,0,198352.857142857,1679.28571428571,123.142857142857
"8064","25408","2021",1,1,0,247350,1481,167
"8065","25410","2021",23,20,3,252157.956521739,2269.91304347826,111.391304347826
"8066","25411","2021",141,29,112,193091.574468085,2601.17021276596,74.8368794326241
"8067","25413","2021",25,14,11,178082.44,1952.96,94.8
"8068","25414","2021",1,1,0,181000,1472,123
"8069","25415","2021",3,3,0,234870,2724.33333333333,94.3333333333333
"8070","25416","2021",5,5,0,119920,1456.2,84.2
"8071","25417","2021",4,4,0,278862.5,2127.25,133.75
"8072","25418","2021",11,9,2,227100,1962.90909090909,112.090909090909
"8073","25420","2021",3,2,1,99846,1543,74.6666666666667
"8074","25422","2021",1,1,0,162000,1929,84
"8075","25424","2021",13,13,0,231579.307692308,1937.46153846154,129.692307692308
"8076","25425","2021",10,10,0,291482,2764,117.6
"8077","25426","2021",4,3,1,144250,1716.25,83.25
"8078","25427","2021",4,4,0,217580,1717.75,127
"8079","25428","2021",26,24,2,161220.307692308,1667.42307692308,99.7307692307692
"8080","25429","2021",14,8,6,174201.071428571,1956.57142857143,88.8571428571429
"8081","25430","2021",1,1,0,114500,1041,110
"8082","25431","2021",1,1,0,89000,890,100
"8083","25432","2021",28,21,7,203642.178571429,2271.21428571429,99
"8084","25434","2021",62,37,25,163691.048387097,1862.53225806452,90
"8085","25435","2021",1,1,0,138000,687,201
"8086","25437","2021",4,4,0,231300,2097.5,112.25
"8087","25438","2021",9,6,3,175216.666666667,1843.22222222222,99.6666666666667
"8088","25439","2021",8,7,1,192812.5,2027.125,106.25
"8089","25440","2021",6,5,1,204500,2422.83333333333,84.6666666666667
"8090","25442","2021",13,5,8,234377.307692308,2595.84615384615,95.3846153846154
"8091","25444","2021",1,1,0,177000,2011,88
"8092","25446","2021",5,5,0,165000,1402,139.8
"8093","25447","2021",3,3,0,151833.333333333,1506.33333333333,100.666666666667
"8094","25448","2021",24,21,3,221752.458333333,2178.79166666667,102.375
"8095","25449","2021",2,2,0,105000,824.5,127.5
"8096","25450","2021",1,1,0,215700,2319,93
"8097","25451","2021",2,1,1,245500,2799.5,93.5
"8098","25452","2021",7,7,0,142905.428571429,1513.57142857143,95
"8099","25453","2021",28,24,4,194812.142857143,1854.07142857143,113.928571428571
"8100","25454","2021",21,14,7,241492.380952381,2154.28571428571,116.190476190476
"8101","25455","2021",3,3,0,280516.666666667,2402.66666666667,116.666666666667
"8102","25456","2021",3,3,0,267666.666666667,2155.33333333333,125
"8103","25457","2021",1,1,0,150000,1136,132
"8104","25458","2021",1,1,0,141000,1880,75
"8105","25459","2021",9,4,5,272392.222222222,2557.33333333333,108.111111111111
"8106","25460","2021",2,2,0,244350,2088,120
"8107","25461","2021",2,2,0,101450,837.5,114
"8108","25462","2021",333,59,274,189482.039039039,2472.76276276276,77.3453453453454
"8109","25463","2021",54,33,21,111634.185185185,1278.62962962963,85.9259259259259
"8110","25465","2021",1,1,0,220000,1419,155
"8111","25466","2021",5,4,1,214514,2171.6,98
"8112","25467","2021",20,18,2,270506.05,2684.75,102.5
"8113","25468","2021",8,6,2,194196.875,1543.625,127.375
"8114","25469","2021",4,4,0,141750,1254,112.75
"8115","25471","2021",1,1,0,67500,558,121
"8116","25472","2021",2,2,0,99700,738,120
"8117","25473","2021",4,4,0,242250,2376,108
"8118","25474","2021",1,1,0,194900,886,220
"8119","25475","2021",6,5,1,180478.333333333,1526.16666666667,117.166666666667
"8120","25476","2021",1,1,0,187500,1453,129
"8121","25477","2021",7,5,2,239928.571428571,2583.14285714286,95.2857142857143
"8122","25478","2021",1,1,0,153000,1133,135
"8123","25479","2021",6,6,0,101366.666666667,1061.5,101.5
"8124","25481","2021",4,4,0,129487.5,1410.25,89.5
"8125","25482","2021",13,10,3,194761.538461538,1666.53846153846,121.384615384615
"8126","25483","2021",3,3,0,239516.666666667,1901.33333333333,133
"8127","25486","2021",1,1,0,3e+05,3030,99
"8128","25487","2021",1,1,0,50000,1000,50
"8129","25488","2021",1,1,0,184000,868,212
"8130","25489","2021",3,3,0,192166.666666667,2339.33333333333,81
"8131","25490","2021",2,1,1,135001.5,1414.5,96.5
"8132","25491","2021",1,1,0,90000,750,120
"8133","25493","2021",10,7,3,208729.8,2423.2,96.5
"8134","25494","2021",19,3,16,174914.473684211,2740.89473684211,64.8947368421053
"8135","25495","2021",27,18,9,178693.925925926,1967.07407407407,91.8518518518518
"8136","25497","2021",4,4,0,155750,1861,86
"8137","25498","2021",1,1,0,40000,342,117
"8138","25502","2021",4,4,0,161725,1605.25,105.25
"8139","25504","2021",3,3,0,160513.333333333,2138,80.3333333333333
"8140","25505","2021",9,8,1,88822.2222222222,987.333333333333,92.2222222222222
"8141","25506","2021",3,3,0,158366.666666667,1399,109.333333333333
"8142","25508","2021",6,6,0,199158.333333333,1981,106.166666666667
"8143","25510","2021",8,8,0,229402.5,2054.5,110.5
"8144","25511","2021",2,2,0,134000,1514.5,92.5
"8145","25512","2021",45,26,19,200571.444444444,2044.22222222222,98.4444444444444
"8146","25513","2021",1,1,0,213400,1642,130
"8147","25514","2021",2,1,1,92500,1231.5,72
"8148","25515","2021",11,6,5,224389.090909091,2512.36363636364,88.4545454545455
"8149","25518","2021",2,2,0,163350,1902,86
"8150","25519","2021",9,6,3,110911.111111111,1215.22222222222,91.2222222222222
"8151","25520","2021",1,1,0,140000,1400,100
"8152","25521","2021",3,3,0,192333.333333333,1604,118.333333333333
"8153","25523","2021",8,8,0,149074.375,1310.625,116.875
"8154","25524","2021",11,11,0,140756.818181818,1609.54545454545,87.0909090909091
"8155","25525","2021",8,2,6,267437.5,4567.5,56.625
"8156","25526","2021",16,10,6,136381.25,1519.9375,91.1875
"8157","25527","2021",55,34,21,200162.218181818,2119.01818181818,97.5090909090909
"8158","25528","2021",1,1,0,164500,1219,135
"8159","25529","2021",23,20,3,140439.391304348,1298.08695652174,112.260869565217
"8160","25532","2021",45,33,12,221751.155555556,2372.86666666667,97.9777777777778
"8161","25534","2021",7,7,0,277428.571428571,2212.85714285714,138
"8162","25535","2021",1,1,0,240000,2927,82
"8163","25536","2021",1,1,0,140000,1944,72
"8164","25537","2021",5,5,0,225900,3391.8,115.2
"8165","25538","2021",2,2,0,252250,1800,145.5
"8166","25539","2021",93,55,38,127047.301075269,1448.29032258065,87.5268817204301
"8167","25540","2021",3,3,0,173100,1855.33333333333,94.6666666666667
"8168","25541","2021",3,3,0,248833.333333333,1751,149.333333333333
"8169","25542","2021",23,21,2,247576.52173913,2347.08695652174,107
"8170","25544","2021",4,4,0,136550,1384.25,99.75
"8171","25545","2021",1,1,0,225900,1526,148
"8172","25547","2021",32,6,26,81616.5625,1236.6875,79.8125
"8173","25548","2021",2,2,0,114750,1627.5,70
"8174","25549","2021",4,3,1,371382.5,2675.25,143.5
"8175","25550","2021",2,1,1,158400,1399.5,115
"8176","25551","2021",1,1,0,135000,1286,105
"8177","25552","2021",1,1,0,171000,1315,130
"8178","25553","2021",3,3,0,123333.333333333,1512.66666666667,77.6666666666667
"8179","25555","2021",14,8,6,184120.357142857,1857.71428571429,95.8571428571429
"8180","25557","2021",3,3,0,269733.333333333,2590.66666666667,104.333333333333
"8181","25558","2021",20,18,2,235776.5,2071.9,116.55
"8182","25559","2021",2,2,0,319619.5,1982,161.5
"8183","25560","2021",40,36,4,232574.75,2169.35,108.4
"8184","25561","2021",6,4,2,145008.333333333,1656.16666666667,80
"8185","25562","2021",2,2,0,179950,2124,83
"8186","25564","2021",9,6,3,176282.222222222,1645.88888888889,103.333333333333
"8187","25566","2021",1,1,0,139000,1086,128
"8188","25569","2021",3,3,0,217833.333333333,2125.66666666667,102.666666666667
"8189","25571","2021",1,1,0,232000,2667,87
"8190","25572","2021",1,1,0,1e+05,1124,89
"8191","25574","2021",5,5,0,188836,1638.2,123.6
"8192","25575","2021",9,7,2,162900,1704.33333333333,92.4444444444444
"8193","25578","2021",76,33,43,194247.973684211,2215.78947368421,92.5131578947368
"8194","25580","2021",113,70,43,112566.539823009,1289.61061946903,84.9646017699115
"8195","25582","2021",1,1,0,269000,2514,107
"8196","25583","2021",4,4,0,114975,935.75,120.75
"8197","25584","2021",1,1,0,190860,1373,139
"8198","25586","2021",9,9,0,189498.333333333,1854.22222222222,111.888888888889
"8199","25588","2021",1,1,0,97500,920,106
"8200","25589","2021",2,2,0,160000,1364,118
"8201","25591","2021",5,5,0,93560,1001.2,104
"8202","25592","2021",10,5,5,243733,2670.1,91
"8203","25594","2021",1,1,0,96500,737,131
"8204","25595","2021",2,2,0,123400,1122.5,114.5
"8205","25597","2021",2,2,0,157350,1268,115
"8206","25598","2021",1,1,0,2e+05,4082,49
"8207","25599","2021",4,2,2,161155,1947.25,83.25
"8208","25600","2021",1,1,0,222500,2225,100
"8209","25601","2021",22,15,7,193653.181818182,1855.36363636364,108.045454545455
"8210","25604","2021",1,0,1,29480,368,80
"8211","25605","2021",4,4,0,230250,1683.75,138.25
"8212","25607","2021",2,2,0,123500,1017,121
"8213","25609","2021",2,2,0,312000,3057.5,112.5
"8214","25611","2021",1,1,0,212000,1536,138
"8215","25612","2021",6,6,0,155358.333333333,1453.5,110.666666666667
"8216","25613","2021",2,2,0,98250,847,112
"8217","25614","2021",45,33,12,132299.688888889,1451.42222222222,92.7555555555556
"8218","25615","2021",4,4,0,208212.5,1383.5,157.25
"8219","25616","2021",2,2,0,228150,1896.5,118.5
"8220","25617","2021",1,1,0,171500,1805,95
"8221","25618","2021",1,1,0,135000,1500,90
"8222","25619","2021",3,1,2,143640,2798,44.6666666666667
"8223","25621","2021",3,3,0,115333.333333333,999.666666666667,115.666666666667
"8224","25622","2021",5,5,0,213131,1741.4,122.4
"8225","25623","2021",3,3,0,160293.333333333,1707,92
"8226","25624","2021",1,1,0,180000,1800,100
"8227","25625","2021",1,1,0,302000,1841,164
"8228","25627","2021",3,2,1,123533.333333333,1214.33333333333,101
"8229","25629","2021",4,4,0,82500,911.75,94
"8230","25630","2021",2,2,0,282087.5,1784.5,160
"8231","25631","2021",8,8,0,173752.5,1703.125,99.625
"8232","25632","2021",36,28,8,132968.888888889,1678.33333333333,82.6944444444444
"8233","25633","2021",7,5,2,174071.428571429,1542.28571428571,117.714285714286
"8234","25634","2021",8,6,2,275756.25,2921.5,104.5
"8235","25635","2021",4,4,0,170975,1900,96.25
"8236","26001","2021",6,6,0,244566.666666667,2409.16666666667,105.833333333333
"8237","26002","2021",23,22,1,215921.739130435,1977.91304347826,110.391304347826
"8238","26004","2021",38,36,2,262523.157894737,2423.39473684211,113.763157894737
"8239","26005","2021",38,37,1,323215.947368421,2464.36842105263,131.552631578947
"8240","26006","2021",27,27,0,248470.740740741,2613.81481481481,95.5925925925926
"8241","26008","2021",19,17,2,180210.526315789,2002.94736842105,92.6842105263158
"8242","26009","2021",15,14,1,267868.733333333,2224.73333333333,115.4
"8243","26010","2021",49,45,4,207104.265306122,2159.28571428571,96.7755102040816
"8244","26011","2021",42,41,1,227369.880952381,2436.88095238095,90.5476190476191
"8245","26013","2021",4,4,0,255320,2077,123.5
"8246","26014","2021",3,3,0,236506,2231,106.666666666667
"8247","26015","2021",1,1,0,295000,2438,121
"8248","26016","2021",6,6,0,217208.333333333,2194.16666666667,102.166666666667
"8249","26017","2021",1,1,0,1e+05,1000,100
"8250","26019","2021",3,3,0,193737.333333333,1562,106.333333333333
"8251","26020","2021",3,3,0,460333.333333333,3164,157.666666666667
"8252","26022","2021",1,1,0,43000,878,49
"8253","26023","2021",13,12,1,221401.538461538,2528.07692307692,99.1538461538462
"8254","26024","2021",6,6,0,203133.333333333,2800.83333333333,73
"8255","26025","2021",4,4,0,173250,2193,100.75
"8256","26026","2021",2,2,0,267500,3335,107
"8257","26027","2021",4,4,0,201250,1805,116.25
"8258","26028","2021",3,3,0,199666.666666667,1903,108
"8259","26031","2021",24,20,4,265979.583333333,2196.41666666667,117.333333333333
"8260","26032","2021",3,2,1,232666.666666667,2706.66666666667,81
"8261","26033","2021",21,21,0,260480.952380952,2678.61904761905,102.857142857143
"8262","26034","2021",4,3,1,274038.75,1790.25,169
"8263","26035","2021",6,6,0,288333.333333333,2230.5,145.166666666667
"8264","26037","2021",54,54,0,275703.611111111,2568.7962962963,107.407407407407
"8265","26038","2021",17,17,0,232514.529411765,2376.11764705882,96.3529411764706
"8266","26039","2021",8,8,0,243857.5,2173.625,111.5
"8267","26040","2021",3,3,0,117333.333333333,1143.66666666667,104.666666666667
"8268","26041","2021",10,10,0,202095,2028.3,102.8
"8269","26042","2021",18,17,1,240056.944444444,2454.05555555556,99.3333333333333
"8270","26043","2021",3,3,0,303480,3344.33333333333,98
"8271","26045","2021",29,25,4,330710.689655172,2676.51724137931,123.448275862069
"8272","26046","2021",1,1,0,138000,2379,58
"8273","26047","2021",5,5,0,150300,1481.8,129.4
"8274","26048","2021",1,1,0,280000,2800,100
"8275","26049","2021",9,8,1,233042.555555556,2252.55555555556,103.777777777778
"8276","26051","2021",1,1,0,616500,5138,120
"8277","26052","2021",12,12,0,275725.833333333,2737.41666666667,101.75
"8278","26054","2021",29,29,0,309842.206896552,2521,124.689655172414
"8279","26055","2021",2,1,1,122500,2722.5,45
"8280","26056","2021",10,9,1,161110,1634.3,105.4
"8281","26057","2021",178,95,83,172095.550561798,2018.39887640449,83.4494382022472
"8282","26058","2021",343,144,199,167312.21574344,2039.91545189504,80.6909620991254
"8283","26059","2021",6,6,0,172934.166666667,1466.5,121
"8284","26060","2021",6,6,0,148833.333333333,1482.16666666667,100
"8285","26061","2021",6,6,0,257833.333333333,1944,136.5
"8286","26062","2021",1,1,0,75000,915,82
"8287","26063","2021",47,43,4,219430.425531915,2642.17021276596,83.2340425531915
"8288","26064","2021",96,89,7,276162.333333333,2580,105.739583333333
"8289","26065","2021",4,4,0,296137.5,3259.25,93
"8290","26066","2021",1,1,0,50000,357,140
"8291","26068","2021",1,1,0,364000,3193,114
"8292","26070","2021",8,8,0,274093.75,2386.75,112.5
"8293","26071","2021",14,14,0,250867.785714286,2077,125.071428571429
"8294","26072","2021",19,18,1,244222.368421053,2428.73684210526,107.052631578947
"8295","26073","2021",3,3,0,289400,2148.33333333333,135
"8296","26074","2021",9,7,2,160824.111111111,2180.33333333333,82
"8297","26075","2021",1,1,0,18000,900,20
"8298","26077","2021",10,10,0,275492.5,2718.2,106.3
"8299","26078","2021",17,17,0,254110.588235294,2215.52941176471,117.882352941176
"8300","26079","2021",10,10,0,193035,1785.3,112.2
"8301","26080","2021",1,1,0,286000,1144,250
"8302","26081","2021",2,2,0,210550,2210.5,75.5
"8303","26082","2021",2,2,0,117500,1038,103
"8304","26083","2021",18,15,3,183044.277777778,1849.72222222222,99.8888888888889
"8305","26084","2021",44,40,4,249814.659090909,2208.59090909091,113.681818181818
"8306","26085","2021",41,36,5,214897.926829268,2028.09756097561,105.414634146341
"8307","26086","2021",11,7,4,153868.181818182,1697.18181818182,87.2727272727273
"8308","26087","2021",20,19,1,239734.1,2033.5,115.6
"8309","26088","2021",61,57,4,261633.409836066,2599.77049180328,101.868852459016
"8310","26089","2021",1,1,0,119000,1725,69
"8311","26091","2021",1,1,0,86000,1654,52
"8312","26092","2021",9,9,0,232611.111111111,2239.66666666667,104.111111111111
"8313","26093","2021",2,1,1,410547.5,3608.5,120.5
"8314","26094","2021",8,8,0,265300,2233.5,116.875
"8315","26095","2021",14,14,0,257008.428571429,2065.71428571429,128.928571428571
"8316","26096","2021",37,37,0,201838.108108108,2206.81081081081,92.3513513513514
"8317","26097","2021",7,7,0,296842.857142857,3117.28571428571,119.285714285714
"8318","26099","2021",10,10,0,295822,2568,121.8
"8319","26100","2021",7,7,0,233114.285714286,2857,87.4285714285714
"8320","26101","2021",1,1,0,530000,5464,97
"8321","26103","2021",8,8,0,345652.5,2584.375,151.5
"8322","26104","2021",1,1,0,2e+05,2532,79
"8323","26105","2021",2,2,0,185987.5,4476.5,42.5
"8324","26106","2021",19,18,1,214333.157894737,1927.47368421053,105.631578947368
"8325","26107","2021",4,4,0,211875,1565.5,138
"8326","26108","2021",117,75,42,214354.948717949,2230.69230769231,97.4871794871795
"8327","26110","2021",8,7,1,206531.25,2344.5,88.5
"8328","26111","2021",1,1,0,3e+05,2083,144
"8329","26112","2021",3,3,0,169500,1710.33333333333,92.6666666666667
"8330","26113","2021",84,54,30,182063.964285714,2126.45238095238,83.4642857142857
"8331","26114","2021",49,44,5,235679.489795918,2399.24489795918,95.8571428571429
"8332","26115","2021",8,7,1,334877.625,2375,133.875
"8333","26116","2021",75,57,18,173217.68,1874.65333333333,91.5733333333333
"8334","26117","2021",1,1,0,1e+05,1538,65
"8335","26118","2021",22,22,0,194333.772727273,1805.45454545455,111.454545454545
"8336","26119","2021",9,9,0,104522.222222222,1552.66666666667,68.5555555555556
"8337","26121","2021",12,12,0,243893.333333333,2230.33333333333,105.5
"8338","26122","2021",1,1,0,154500,1288,120
"8339","26123","2021",1,1,0,179015,2082,86
"8340","26124","2021",66,60,6,253426.181818182,2764.59090909091,99.6666666666667
"8341","26125","2021",14,14,0,261447.142857143,3084.5,95
"8342","26126","2021",3,3,0,140666.666666667,1445.66666666667,105
"8343","26127","2021",1,1,0,588210,3921,150
"8344","26129","2021",16,15,1,184234.375,1822.875,102.3125
"8345","26131","2021",3,3,0,239800,2615.66666666667,89.3333333333333
"8346","26133","2021",2,2,0,251945,2123.5,130
"8347","26135","2021",3,3,0,258166.666666667,2125.33333333333,90.6666666666667
"8348","26136","2021",3,3,0,197583.333333333,1752,111
"8349","26137","2021",3,2,1,981423.333333333,6416.33333333333,137.333333333333
"8350","26138","2021",16,16,0,264100,2050.875,133.1875
"8351","26139","2021",37,34,3,307929.621621622,2594.81081081081,118.756756756757
"8352","26140","2021",6,6,0,290294,2187.16666666667,135.666666666667
"8353","26141","2021",2,2,0,122183,1527.5,80
"8354","26142","2021",1,1,0,34000,1133,30
"8355","26143","2021",21,20,1,155485.714285714,1606.61904761905,99.6666666666667
"8356","26144","2021",29,23,6,222365,2121.68965517241,103.51724137931
"8357","26145","2021",4,4,0,175425,2294.5,75.75
"8358","26146","2021",25,25,0,309217.88,2650.16,118
"8359","26147","2021",2,2,0,264600,2922,93
"8360","26148","2021",24,20,4,193731.083333333,1713.83333333333,115.875
"8361","26149","2021",18,12,6,188207,2172.94444444444,88.4444444444444
"8362","26150","2021",2,2,0,283832.5,3024,172.5
"8363","26153","2021",3,3,0,90000,830.333333333333,108.666666666667
"8364","26154","2021",5,5,0,121222,2694.2,52.4
"8365","26155","2021",17,16,1,208624.705882353,2020.17647058824,102.941176470588
"8366","26156","2021",7,7,0,239028.571428571,2340.57142857143,104
"8367","26157","2021",8,8,0,345940,2400.5,134.875
"8368","26159","2021",2,2,0,122605,1872.5,54.5
"8369","26160","2021",14,12,2,179550,1815.42857142857,97
"8370","26161","2021",2,1,1,80115,1840.5,45.5
"8371","26162","2021",10,10,0,180195.8,2021.2,96.1
"8372","26165","2021",144,113,31,194602.875,2129.82638888889,93.7430555555556
"8373","26166","2021",96,89,7,214088.479166667,2127.52083333333,100.666666666667
"8374","26167","2021",6,5,1,156255,1974.33333333333,82.6666666666667
"8375","26168","2021",27,19,8,138858,1496.55555555556,89.2592592592593
"8376","26169","2021",31,31,0,244997.096774194,2297.32258064516,105
"8377","26170","2021",30,29,1,340983.166666667,2904.46666666667,119
"8378","26171","2021",4,4,0,212925,2029.25,91.25
"8379","26172","2021",9,9,0,187111.111111111,1631.77777777778,124.222222222222
"8380","26173","2021",9,9,0,269287.222222222,2524.33333333333,112.777777777778
"8381","26174","2021",9,9,0,265388.888888889,2457.77777777778,107
"8382","26175","2021",3,3,0,257595,2778.66666666667,100.333333333333
"8383","26176","2021",23,21,2,334501.434782609,2754.26086956522,125.782608695652
"8384","26177","2021",11,11,0,340426.363636364,2775,124.181818181818
"8385","26178","2021",4,4,0,229825,2042.5,116.5
"8386","26179","2021",29,27,2,302479.586206897,2510.27586206897,123.137931034483
"8387","26180","2021",4,4,0,556250,3881.75,145
"8388","26181","2021",4,4,0,292242.5,2724.5,104
"8389","26182","2021",24,23,1,302867.25,3226.41666666667,101.125
"8390","26183","2021",9,9,0,312058.555555556,2885.22222222222,115.888888888889
"8391","26185","2021",7,7,0,321100.857142857,2271.42857142857,146.428571428571
"8392","26186","2021",1,1,0,151228,2044,74
"8393","26188","2021",40,31,9,313152.325,2859.575,106.875
"8394","26189","2021",3,3,0,183400,2375.33333333333,78.3333333333333
"8395","26190","2021",1,1,0,3e+05,2632,114
"8396","26191","2021",45,34,11,256421,2416.42222222222,107.177777777778
"8397","26192","2021",2,2,0,574250,3697.5,161.5
"8398","26193","2021",21,14,7,176952.285714286,2097.38095238095,86.0952380952381
"8399","26194","2021",4,4,0,159050.75,1915.5,82.25
"8400","26195","2021",2,2,0,358000,2787,136
"8401","26196","2021",15,15,0,328737,2837.73333333333,116.333333333333
"8402","26197","2021",40,39,1,341920.25,2752.95,128.025
"8403","26198","2021",719,341,378,176626.35744089,2038.47566063978,84.125173852573
"8404","26199","2021",1,1,0,269710,2724,99
"8405","26200","2021",1,1,0,45000,1125,40
"8406","26201","2021",1,1,0,1e+05,1163,86
"8407","26202","2021",2,2,0,249000,2766.5,90
"8408","26203","2021",7,7,0,236000,1937.42857142857,119
"8409","26204","2021",1,1,0,130000,1300,100
"8410","26206","2021",33,30,3,341938.181818182,2729.18181818182,127.454545454545
"8411","26207","2021",3,3,0,211000,2304,83
"8412","26208","2021",15,15,0,285383.333333333,2467.13333333333,114.533333333333
"8413","26209","2021",1,1,0,130000,1970,66
"8414","26210","2021",19,19,0,240180.368421053,2109.63157894737,118.052631578947
"8415","26211","2021",22,19,3,289290.727272727,2469.09090909091,109.863636363636
"8416","26212","2021",7,7,0,263578.571428571,2180.57142857143,121.428571428571
"8417","26213","2021",16,16,0,190955,1794.5625,107.1875
"8418","26215","2021",12,11,1,157337.5,2045.41666666667,78.4166666666667
"8419","26216","2021",11,11,0,206250,2090,99.1818181818182
"8420","26217","2021",1,1,0,283030,2144,132
"8421","26218","2021",63,60,3,284535.349206349,2562.79365079365,111.174603174603
"8422","26220","2021",186,101,85,214292.252688172,2662.60215053763,80.5537634408602
"8423","26221","2021",2,2,0,83305,1183.5,70.5
"8424","26223","2021",6,6,0,164475,1746.16666666667,99
"8425","26224","2021",1,1,0,113000,1027,110
"8426","26225","2021",3,3,0,198333.333333333,1884.33333333333,102.333333333333
"8427","26226","2021",5,5,0,179366,2164.4,94.2
"8428","26231","2021",45,40,5,272489.133333333,2203.82222222222,121.844444444444
"8429","26232","2021",13,13,0,232353.076923077,2454.61538461538,107.384615384615
"8430","26233","2021",1,1,0,3e+05,3571,84
"8431","26234","2021",9,8,1,248672.222222222,2723.88888888889,92.3333333333333
"8432","26235","2021",188,142,46,171054.35106383,1880.51595744681,92.968085106383
"8433","26236","2021",4,4,0,227750,1959.75,132.75
"8434","26238","2021",3,3,0,180380,2275.33333333333,71.6666666666667
"8435","26239","2021",2,2,0,346000,3334,104
"8436","26240","2021",2,2,0,188500,2224,75
"8437","26241","2021",2,2,0,205000,2342.5,108
"8438","26242","2021",1,1,0,35000,427,82
"8439","26243","2021",18,16,2,289969.888888889,2412.83333333333,117.222222222222
"8440","26244","2021",2,2,0,337500,2785.5,117.5
"8441","26247","2021",8,8,0,175962.5,1821.5,96
"8442","26248","2021",9,9,0,120705.555555556,1412.55555555556,86.6666666666667
"8443","26249","2021",6,3,3,165061.666666667,2328.5,77.8333333333333
"8444","26250","2021",43,40,3,215379.651162791,2238.32558139535,101.162790697674
"8445","26251","2021",13,13,0,295366.769230769,2978.61538461538,105.461538461538
"8446","26252","2021",140,71,69,184082.4,2299.80714285714,81.2142857142857
"8447","26253","2021",2,2,0,74500,1774,42
"8448","26256","2021",2,2,0,291495.5,3529.5,82.5
"8449","26257","2021",5,5,0,253260,2442,103.8
"8450","26258","2021",19,18,1,263879.473684211,2268.78947368421,114.421052631579
"8451","26259","2021",7,7,0,252978.571428571,2004.14285714286,126
"8452","26261","2021",19,17,2,292727.105263158,2636.15789473684,110.894736842105
"8453","26262","2021",4,4,0,120000,1609.5,90.5
"8454","26263","2021",4,3,1,213750,2047.75,99
"8455","26264","2021",4,4,0,146562.5,1406,130.5
"8456","26266","2021",3,3,0,266500,1896,130
"8457","26269","2021",2,2,0,282450,2163,124
"8458","26270","2021",2,2,0,4e+05,2608.5,151.5
"8459","26271","2021",36,32,4,215958.277777778,2180.38888888889,105.694444444444
"8460","26272","2021",2,2,0,378325,1883,210
"8461","26273","2021",8,8,0,307875,2528.625,118.625
"8462","26275","2021",29,28,1,296895.862068966,2560.86206896552,116.586206896552
"8463","26276","2021",9,9,0,236412.222222222,2768.44444444444,91.8888888888889
"8464","26277","2021",3,3,0,120530,1752,73.3333333333333
"8465","26278","2021",2,2,0,51800,862,61
"8466","26279","2021",2,2,0,145500,1491.5,95
"8467","26281","2021",683,256,427,145577.150805271,1816.42752562225,79.2708638360176
"8468","26282","2021",2,2,0,106450,1960.5,55.5
"8469","26284","2021",4,4,0,350100,2725.75,129.25
"8470","26285","2021",4,4,0,141946.25,1981,94
"8471","26286","2021",1,1,0,74800,733,102
"8472","26287","2021",6,6,0,265833.333333333,2284.33333333333,119.333333333333
"8473","26288","2021",4,4,0,188650,2370.25,87.25
"8474","26289","2021",26,24,2,219407.730769231,2754.26923076923,81.7307692307692
"8475","26290","2021",20,11,9,110749.25,1694.15,62.65
"8476","26291","2021",1,1,0,28000,800,35
"8477","26292","2021",5,5,0,176784,1921.6,92.8
"8478","26293","2021",3,3,0,266666.666666667,2027.66666666667,120
"8479","26294","2021",3,3,0,267058.333333333,2216,117
"8480","26295","2021",24,24,0,233073.333333333,2278.04166666667,102.875
"8481","26298","2021",10,10,0,221090,1842.1,120.5
"8482","26299","2021",1,1,0,255000,1417,180
"8483","26300","2021",1,1,0,68000,850,80
"8484","26301","2021",57,45,12,195351.947368421,2207.70175438596,88.8421052631579
"8485","26302","2021",5,5,0,170178.8,1626,108.6
"8486","26303","2021",5,5,0,117100,1799,62.6
"8487","26304","2021",1,1,0,135000,1627,83
"8488","26305","2021",14,13,1,242232.142857143,2146.57142857143,113.142857142857
"8489","26306","2021",6,6,0,189418.333333333,1874.66666666667,101.166666666667
"8490","26307","2021",40,22,18,142962.675,1533,86.325
"8491","26308","2021",4,4,0,231512.5,1847,133.25
"8492","26309","2021",7,6,1,274386.857142857,3151.14285714286,88.5714285714286
"8493","26311","2021",21,17,4,179108.80952381,1833.52380952381,101.142857142857
"8494","26312","2021",19,16,3,260823.789473684,2463.84210526316,109.473684210526
"8495","26313","2021",72,67,5,262530.208333333,2501.81944444444,107.25
"8496","26314","2021",2,2,0,311965,2460.5,129.5
"8497","26315","2021",10,5,5,234095.5,2160.9,115.5
"8498","26317","2021",12,11,1,206917.5,2560.66666666667,87.75
"8499","26318","2021",2,2,0,54730,819.5,80.5
"8500","26319","2021",13,12,1,215619.615384615,1802,134.923076923077
"8501","26320","2021",13,11,2,133503.846153846,1863,72.8461538461538
"8502","26321","2021",6,6,0,159758,1657.5,89.6666666666667
"8503","26322","2021",17,5,12,210864.705882353,2449.41176470588,82.7647058823529
"8504","26323","2021",17,17,0,221474.058823529,2110.70588235294,102.411764705882
"8505","26324","2021",143,91,52,192553.818181818,2041.04195804196,94.2517482517483
"8506","26325","2021",88,66,22,176739.443181818,1813.23863636364,96.0227272727273
"8507","26326","2021",14,14,0,405862.928571429,3321.64285714286,127.785714285714
"8508","26327","2021",2,2,0,171500,2217.5,76.5
"8509","26330","2021",26,26,0,186734.615384615,1768.57692307692,109.153846153846
"8510","26331","2021",11,11,0,304497.363636364,2413.72727272727,124.636363636364
"8511","26332","2021",42,36,6,177117.142857143,1782.47619047619,100.285714285714
"8512","26333","2021",62,27,35,107720.774193548,1347.5,78.4677419354839
"8513","26334","2021",4,4,0,313350,2318.75,145.5
"8514","26335","2021",9,9,0,301069.333333333,2281.77777777778,127.222222222222
"8515","26336","2021",7,6,1,200571.428571429,2497.28571428571,84.8571428571429
"8516","26337","2021",23,20,3,216429,2039.91304347826,110.608695652174
"8517","26338","2021",25,22,3,265024,2456.2,109.6
"8518","26339","2021",18,16,2,301239.722222222,2368.88888888889,125.055555555556
"8519","26340","2021",11,8,3,94636.3636363636,1425.90909090909,65.0909090909091
"8520","26341","2021",13,13,0,176353.846153846,1601.61538461538,111.461538461538
"8521","26342","2021",5,5,0,400839.4,2955.4,134.2
"8522","26343","2021",1,1,0,619230,3035,204
"8523","26344","2021",2,2,0,347500,3171.5,109
"8524","26345","2021",35,34,1,305321.142857143,2553.42857142857,118.485714285714
"8525","26346","2021",2,2,0,276000,2399.5,115.5
"8526","26347","2021",104,50,54,169607.942307692,2140.07692307692,80.3076923076923
"8527","26348","2021",29,28,1,238687.172413793,2507.55172413793,96.1034482758621
"8528","26349","2021",4,4,0,253587.5,2346.75,107
"8529","26350","2021",1,1,0,95000,1218,78
"8530","26352","2021",1,1,0,422000,2542,166
"8531","26353","2021",18,15,3,204531.222222222,2046.61111111111,99.3333333333333
"8532","26355","2021",3,3,0,262416.666666667,2726.33333333333,96.6666666666667
"8533","26356","2021",2,1,1,380781.5,4307,71.5
"8534","26357","2021",29,24,5,203835.896551724,2476.93103448276,83.3448275862069
"8535","26358","2021",12,12,0,254579.666666667,2171.25,115.666666666667
"8536","26360","2021",11,11,0,258984.636363636,3139.45454545455,92.9090909090909
"8537","26361","2021",3,3,0,148783.333333333,1482,96
"8538","26362","2021",1221,271,950,159848.274365274,2162.14332514333,74.1777231777232
"8539","26364","2021",9,7,2,161420,1432.66666666667,113.444444444444
"8540","26365","2021",4,4,0,278250,2641.25,101.25
"8541","26367","2021",23,23,0,274699.173913043,2514.73913043478,107.521739130435
"8542","26368","2021",7,7,0,175411.142857143,1960.28571428571,92.5714285714286
"8543","26370","2021",1,1,0,429360,3157,136
"8544","26371","2021",1,1,0,115000,1150,100
"8545","26373","2021",7,7,0,190671.428571429,1847.42857142857,106.714285714286
"8546","26374","2021",1,1,0,235000,2866,82
"8547","26376","2021",5,5,0,295614,3156.2,102
"8548","26377","2021",18,17,1,290289.444444444,2949.94444444444,119.833333333333
"8549","26379","2021",10,10,0,285908,2647.4,109.3
"8550","26380","2021",2,2,0,341800,2810.5,122.5
"8551","26381","2021",9,8,1,326422.222222222,2145.88888888889,153.777777777778
"8552","26382","2021",7,7,0,283007.142857143,2402.57142857143,119.428571428571
"8553","27001","2021",3,3,0,130666.666666667,1772.66666666667,82.6666666666667
"8554","27002","2021",13,13,0,162580.769230769,1658.69230769231,98.3076923076923
"8555","27003","2021",26,26,0,206387.5,1791.15384615385,120.038461538462
"8556","27004","2021",4,4,0,311407,3848.75,135
"8557","27005","2021",10,10,0,234987.5,1935.9,119.5
"8558","27006","2021",2,2,0,149000,1873.5,83.5
"8559","27008","2021",12,12,0,170350,1751.16666666667,98.75
"8560","27009","2021",14,14,0,102342.857142857,1073.71428571429,92.0714285714286
"8561","27010","2021",3,3,0,187666.666666667,1991.33333333333,106.333333333333
"8562","27011","2021",18,18,0,206110.111111111,1843,122.333333333333
"8563","27012","2021",8,8,0,198628.75,1486.625,138.75
"8564","27013","2021",7,7,0,151921.428571429,2035.28571428571,77.8571428571429
"8565","27014","2021",19,19,0,237282.578947368,1837.31578947368,129.789473684211
"8566","27015","2021",15,15,0,205720,2030.4,105
"8567","27016","2021",133,110,23,161999.819548872,1875.01503759398,90.8270676691729
"8568","27017","2021",28,28,0,186568.714285714,1969.82142857143,97.8214285714286
"8569","27018","2021",22,22,0,160787.454545455,1684.04545454545,100.272727272727
"8570","27019","2021",3,3,0,138000,1355,108.333333333333
"8571","27020","2021",18,18,0,217971.777777778,2361.16666666667,94.5555555555556
"8572","27021","2021",6,6,0,245585,2555.33333333333,97.5
"8573","27022","2021",61,61,0,185131.950819672,2158.95081967213,90.9508196721311
"8574","27023","2021",9,9,0,219193.111111111,2178.33333333333,111
"8575","27025","2021",14,13,1,199157.142857143,1849.64285714286,108.928571428571
"8576","27026","2021",8,7,1,201975,2083.125,105.25
"8577","27027","2021",2,2,0,161500,1668,100.5
"8578","27028","2021",4,4,0,133125,1373,106.5
"8579","27031","2021",14,14,0,245387.928571429,2074.28571428571,122.428571428571
"8580","27032","2021",25,25,0,198402.28,1995.96,103.64
"8581","27033","2021",4,4,0,175925,1706.75,111.25
"8582","27034","2021",8,8,0,181187.5,1683,109.25
"8583","27035","2021",3,3,0,211666.666666667,2418.66666666667,97
"8584","27036","2021",8,8,0,156631.25,1664,94.875
"8585","27037","2021",19,19,0,144218.368421053,1600.15789473684,97.0526315789474
"8586","27038","2021",3,3,0,103333.333333333,1281.33333333333,81.3333333333333
"8587","27039","2021",6,6,0,164583.333333333,1688.33333333333,96.3333333333333
"8588","27040","2021",10,10,0,113155,1161.9,91.7
"8589","27042","2021",1,1,0,206500,1665,124
"8590","27043","2021",21,21,0,121079.523809524,1645.80952380952,81.0952380952381
"8591","27044","2021",19,19,0,196417.157894737,1886.52631578947,106.631578947368
"8592","27045","2021",13,13,0,221769.230769231,2035.30769230769,113.538461538462
"8593","27046","2021",5,5,0,116060,1180.8,104
"8594","27047","2021",4,4,0,131500,1251.5,105.5
"8595","27048","2021",6,6,0,254250,1931,131.833333333333
"8596","27049","2021",119,119,0,152175.462184874,1598.65546218487,99.327731092437
"8597","27050","2021",13,12,1,163005.384615385,1488.07692307692,106.923076923077
"8598","27051","2021",61,58,3,151867.901639344,1590.59016393443,107.032786885246
"8599","27052","2021",4,4,0,201150,1477.25,131.25
"8600","27053","2021",5,5,0,328228,2073.2,162.2
"8601","27054","2021",16,16,0,155114.9375,1573,102.75
"8602","27055","2021",2,2,0,277975.5,1950.5,144
"8603","27056","2021",175,132,43,157417.662857143,1862.61714285714,85.12
"8604","27057","2021",5,5,0,175987,1887.6,95.6
"8605","27058","2021",35,32,3,199693.428571429,1921.34285714286,108.171428571429
"8606","27059","2021",10,10,0,193390,2017.4,106.7
"8607","27061","2021",8,8,0,160750,1724,99.75
"8608","27062","2021",25,25,0,218640,2095.4,112.56
"8609","27063","2021",3,3,0,140100,1794.33333333333,80
"8610","27064","2021",18,18,0,218355,2064.83333333333,108.555555555556
"8611","27065","2021",159,100,59,168259.880503145,1923.2893081761,83.7295597484277
"8612","27066","2021",4,4,0,131312.5,1034,118.75
"8613","27067","2021",26,26,0,212133.461538462,2299.30769230769,97
"8614","27068","2021",2,2,0,145100,1591.5,89.5
"8615","27069","2021",13,13,0,135832.307692308,1649.30769230769,92.5384615384615
"8616","27070","2021",18,18,0,179622.222222222,1932.22222222222,95
"8617","27071","2021",3,3,0,159633.333333333,1926.33333333333,81
"8618","27072","2021",13,13,0,283891.307692308,2646.46153846154,107.384615384615
"8619","27073","2021",27,27,0,196051.851851852,2167.11111111111,92.2592592592593
"8620","27074","2021",10,10,0,135110,1267.8,111.7
"8621","27075","2021",11,11,0,125318.181818182,1711.90909090909,73.8181818181818
"8622","27076","2021",10,10,0,230525,2002,116.7
"8623","27077","2021",10,10,0,176534.3,1755.4,102.1
"8624","27078","2021",8,8,0,242975,1865.125,126.375
"8625","27079","2021",6,6,0,208493.333333333,1891.83333333333,115.666666666667
"8626","27081","2021",3,3,0,436666.666666667,3761.66666666667,110.666666666667
"8627","27082","2021",38,38,0,168476.447368421,1829.5,94.1315789473684
"8628","27083","2021",7,7,0,232714.285714286,1761,129.285714285714
"8629","27085","2021",15,15,0,179840,1834.8,98.7333333333333
"8630","27089","2021",17,17,0,220270.588235294,2103.47058823529,109.117647058824
"8631","27090","2021",47,47,0,197012.021276596,2023,100.851063829787
"8632","27091","2021",15,15,0,286450,2440.4,131.466666666667
"8633","27094","2021",3,3,0,199666.666666667,2594.33333333333,78
"8634","27095","2021",7,7,0,212835.714285714,1937.28571428571,114.428571428571
"8635","27096","2021",11,11,0,143272.727272727,1680.45454545455,92.5454545454545
"8636","27097","2021",4,4,0,210750,2061.5,103.75
"8637","27099","2021",9,9,0,160244.333333333,1573.66666666667,103.888888888889
"8638","27100","2021",24,13,11,159616.5,2034.04166666667,81.5833333333333
"8639","27101","2021",8,8,0,328518.75,2551.125,133
"8640","27102","2021",17,17,0,225364.705882353,2092.47058823529,107.117647058824
"8641","27103","2021",50,49,1,222627.76,2216,106.3
"8642","27104","2021",16,16,0,201618.75,1939.4375,105.25
"8643","27105","2021",51,49,2,194143.137254902,1982.70588235294,98.7058823529412
"8644","27106","2021",4,4,0,171250,1658,98
"8645","27107","2021",14,14,0,176127.142857143,1547.71428571429,111.857142857143
"8646","27108","2021",22,22,0,123697.272727273,1427.18181818182,89.0909090909091
"8647","27109","2021",7,7,0,183500,1972.42857142857,97.1428571428571
"8648","27110","2021",6,6,0,185500,1888.83333333333,99.5
"8649","27111","2021",4,4,0,160640,2447,70
"8650","27112","2021",77,75,2,122609.545454545,1519.09090909091,84.4285714285714
"8651","27114","2021",15,15,0,277469.133333333,2275.86666666667,121.066666666667
"8652","27115","2021",6,6,0,123952.166666667,1590.16666666667,92.3333333333333
"8653","27116","2021",80,76,4,143939.8125,1611.0125,91.4125
"8654","27117","2021",22,22,0,104427.272727273,1197.72727272727,87.8636363636364
"8655","27118","2021",16,16,0,248199.9375,2185.625,109.1875
"8656","27119","2021",18,18,0,209611.111111111,2258.05555555556,93.6666666666667
"8657","27120","2021",3,3,0,164000,2204.33333333333,74.6666666666667
"8658","27123","2021",6,5,1,311000,2576.33333333333,126.333333333333
"8659","27124","2021",2,2,0,208760,1989,106
"8660","27125","2021",14,14,0,160171.428571429,1516.35714285714,100.642857142857
"8661","27126","2021",14,14,0,194711.071428571,1739,111.285714285714
"8662","27127","2021",9,9,0,194593.777777778,1656.44444444444,116
"8663","27129","2021",10,10,0,177879,1746.2,107.8
"8664","27130","2021",5,5,0,155000,1686.4,91.8
"8665","27132","2021",14,14,0,183740,1836.57142857143,105
"8666","27133","2021",19,19,0,252730,2025,126.105263157895
"8667","27134","2021",2,2,0,97000,1223.5,77
"8668","27135","2021",8,8,0,210993.75,1878.875,113.25
"8669","27136","2021",8,8,0,231000,2112,114.875
"8670","27137","2021",8,8,0,143875,1237.75,108.25
"8671","27138","2021",8,8,0,129305,1544,82.375
"8672","27139","2021",5,5,0,144478,1876,84.6
"8673","27140","2021",5,5,0,259004,2734,100.8
"8674","27141","2021",2,2,0,265000,1670.5,158
"8675","27142","2021",1,1,0,232000,1785,130
"8676","27144","2021",3,3,0,205333.333333333,2598.33333333333,92.3333333333333
"8677","27146","2021",6,6,0,185433.333333333,2589.33333333333,83.6666666666667
"8678","27147","2021",7,7,0,200786.714285714,1938.57142857143,104.714285714286
"8679","27148","2021",8,8,0,124000,1278.625,103.125
"8680","27149","2021",4,4,0,132125,2224.5,75
"8681","27151","2021",30,30,0,163845,1736.66666666667,93.8
"8682","27152","2021",16,15,1,202641.375,2502.5625,82.875
"8683","27153","2021",7,7,0,204307.142857143,1902.42857142857,113.857142857143
"8684","27154","2021",11,11,0,192227.272727273,1960.63636363636,108.181818181818
"8685","27155","2021",6,6,0,98383.3333333333,999,107.666666666667
"8686","27156","2021",12,12,0,123378.333333333,1454.41666666667,90.8333333333333
"8687","27157","2021",35,35,0,167326.428571429,1760.65714285714,100.8
"8688","27158","2021",20,20,0,225483.65,2207,103.35
"8689","27161","2021",16,16,0,198560.625,1923.4375,98.1875
"8690","27162","2021",5,5,0,111000,1385.4,83
"8691","27163","2021",2,2,0,205000,1521.5,134.5
"8692","27164","2021",13,13,0,129399.461538462,1477.46153846154,88.2307692307692
"8693","27165","2021",81,75,6,139930.37037037,1607.66666666667,92.6543209876543
"8694","27167","2021",9,9,0,173228.888888889,1862.44444444444,95.8888888888889
"8695","27168","2021",6,6,0,245887.5,1935.66666666667,126.166666666667
"8696","27169","2021",20,20,0,248757,2460.7,105.75
"8697","27170","2021",32,25,7,150337.1875,1823,82.4375
"8698","27171","2021",7,7,0,218285.714285714,1985.14285714286,111
"8699","27173","2021",2,2,0,151500,1891,81
"8700","27174","2021",27,27,0,172637.444444444,1937.37037037037,91.5925925925926
"8701","27176","2021",4,4,0,152250,2258.25,68
"8702","27177","2021",10,10,0,156120,1987.2,80.8
"8703","27179","2021",13,13,0,183452.153846154,1702.30769230769,108
"8704","27180","2021",24,24,0,208948.75,2122.25,101.166666666667
"8705","27181","2021",8,8,0,192500,1790.875,122.875
"8706","27182","2021",1,1,0,40000,1905,21
"8707","27183","2021",50,48,2,188901,2137.06,93.1
"8708","27184","2021",2,2,0,96600,1256,77.5
"8709","27185","2021",15,15,0,174911.533333333,1794.4,101.933333333333
"8710","27187","2021",6,6,0,182650,1828.33333333333,104.333333333333
"8711","27188","2021",17,17,0,205327.058823529,2087.17647058824,101.470588235294
"8712","27189","2021",10,10,0,203634,1833.2,117.3
"8713","27190","2021",5,5,0,262000,1992.8,124.6
"8714","27191","2021",35,35,0,207795.428571429,1732.6,126.542857142857
"8715","27192","2021",6,6,0,212650,1922.5,116.666666666667
"8716","27193","2021",33,33,0,190336.727272727,2032.21212121212,99.1818181818182
"8717","27194","2021",3,3,0,192166.666666667,1487,140.666666666667
"8718","27196","2021",10,10,0,212905,2216.4,93.9
"8719","27198","2021",110,108,2,160811.181818182,1686.26363636364,98.6545454545455
"8720","27199","2021",6,6,0,157083.333333333,1833.5,87.5
"8721","27201","2021",3,3,0,212816.666666667,1841.33333333333,118.333333333333
"8722","27202","2021",8,8,0,178437.5,2370,75.75
"8723","27203","2021",11,11,0,303190.909090909,2822.36363636364,111
"8724","27204","2021",6,6,0,192450,2543.5,79.8333333333333
"8725","27205","2021",9,9,0,167422.222222222,1820.77777777778,85.5555555555556
"8726","27206","2021",6,6,0,151648.166666667,1868.5,87.8333333333333
"8727","27207","2021",7,7,0,178168.571428571,2012.28571428571,99.1428571428571
"8728","27208","2021",6,6,0,135166.666666667,1317,111.5
"8729","27209","2021",5,5,0,160955,2117.2,80.2
"8730","27210","2021",11,11,0,181984.272727273,1721.54545454545,110.272727272727
"8731","27212","2021",2,2,0,137500,939.5,122
"8732","27213","2021",108,108,0,206261.185185185,2150.5462962963,103.953703703704
"8733","27214","2021",20,20,0,183566,1555.5,121.6
"8734","27215","2021",3,3,0,299350,1929.33333333333,160
"8735","27216","2021",4,4,0,194075,2179,90
"8736","27217","2021",6,6,0,170173.333333333,1833.5,99.1666666666667
"8737","27218","2021",32,31,1,186715.9375,1804.25,104.375
"8738","27219","2021",5,5,0,177050,1868,95
"8739","27220","2021",5,5,0,178000,1831.4,101.4
"8740","27222","2021",3,3,0,147000,1319.66666666667,123.333333333333
"8741","27224","2021",3,3,0,204874.666666667,1929.66666666667,107
"8742","27226","2021",52,48,4,179145.115384615,1984.90384615385,97.3076923076923
"8743","27227","2021",9,9,0,147107.777777778,1634.88888888889,93.1111111111111
"8744","27228","2021",3,3,0,179666.666666667,1786.66666666667,103
"8745","27229","2021",738,262,476,136668.52303523,1844.88482384824,73.840108401084
"8746","27230","2021",83,64,19,172280.891566265,2039.79518072289,92.1807228915663
"8747","27231","2021",11,11,0,232509.090909091,2516.63636363636,97.8181818181818
"8748","27232","2021",7,7,0,205668.571428571,2135,96.4285714285714
"8749","27233","2021",17,17,0,247036.470588235,2342.11764705882,104.588235294118
"8750","27234","2021",1,1,0,215000,2108,102
"8751","27235","2021",3,3,0,110000,1083.33333333333,96.6666666666667
"8752","27237","2021",2,2,0,198725,2984,69
"8753","27238","2021",18,18,0,209267.777777778,1728.27777777778,120.277777777778
"8754","27239","2021",4,4,0,146500,1658.25,85.5
"8755","27240","2021",12,11,1,126666.666666667,1587.33333333333,83.1666666666667
"8756","27241","2021",2,2,0,263900,1665.5,155
"8757","27242","2021",29,29,0,158565.517241379,1655.20689655172,107.862068965517
"8758","27243","2021",12,12,0,241690,2370.58333333333,102
"8759","27245","2021",7,7,0,172857.142857143,1647.57142857143,109.571428571429
"8760","27246","2021",24,24,0,155709.166666667,1789.08333333333,91.2916666666667
"8761","27247","2021",1,1,0,159000,2120,75
"8762","27248","2021",5,5,0,126780,1410.4,97
"8763","27249","2021",11,11,0,222945.454545455,1919.18181818182,119
"8764","27251","2021",10,9,1,116750,1461,77.8
"8765","27252","2021",3,3,0,152666.666666667,1693.66666666667,91.3333333333333
"8766","27254","2021",19,19,0,278444.736842105,2443.21052631579,121.315789473684
"8767","27256","2021",11,11,0,187489.363636364,2075.18181818182,95.3636363636364
"8768","27258","2021",13,13,0,201884.769230769,2280.61538461538,99.2307692307692
"8769","27259","2021",4,4,0,166750,2024.75,84
"8770","27260","2021",9,9,0,191500,1986.55555555556,97.6666666666667
"8771","27261","2021",10,10,0,131873,1548.4,86.2
"8772","27263","2021",11,11,0,164704.727272727,1677,97.9090909090909
"8773","27266","2021",8,8,0,221012.5,2008.125,112.125
"8774","27267","2021",12,12,0,202073.083333333,1960,101.583333333333
"8775","27269","2021",2,2,0,313495,2801,104.5
"8776","27271","2021",5,5,0,165364.6,1687,101.6
"8777","27273","2021",6,6,0,234630,2067.5,113.166666666667
"8778","27275","2021",127,62,65,135316.968503937,1813.00787401575,73.7007874015748
"8779","27276","2021",1,1,0,245000,1424,172
"8780","27277","2021",9,9,0,187000,1872.11111111111,101.555555555556
"8781","27278","2021",45,44,1,210486.044444444,2269.82222222222,98.6444444444444
"8782","27279","2021",41,34,7,193227.56097561,2197.90243902439,92.6829268292683
"8783","27280","2021",9,9,0,233733.333333333,2214.55555555556,107.222222222222
"8784","27281","2021",1,1,0,229000,3523,65
"8785","27282","2021",10,10,0,189265,1877.4,123.7
"8786","27284","2021",176,118,58,175938.142045455,2366.5625,77.3352272727273
"8787","27285","2021",5,5,0,372076,3176.4,120.4
"8788","27286","2021",3,3,0,126633.333333333,1360.66666666667,100.666666666667
"8789","27287","2021",15,15,0,190330.733333333,1955.73333333333,101.933333333333
"8790","27288","2021",11,11,0,160055.272727273,1435.90909090909,110
"8791","27289","2021",3,3,0,254000,1462.66666666667,138
"8792","27290","2021",30,30,0,154546.666666667,1618.6,96.7333333333333
"8793","27291","2021",5,5,0,211174.2,1717.2,126.6
"8794","27294","2021",20,20,0,155879.25,1586.7,103.65
"8795","27295","2021",5,5,0,190448,2130.6,89
"8796","27298","2021",5,5,0,233200,2146.8,104
"8797","27299","2021",41,31,10,146300.780487805,1973.21951219512,76.5365853658537
"8798","27300","2021",13,13,0,146638.769230769,1485.23076923077,103.153846153846
"8799","27301","2021",17,17,0,203960.294117647,1985.70588235294,102.235294117647
"8800","27302","2021",11,11,0,207181.818181818,2047.72727272727,97.7272727272727
"8801","27304","2021",4,4,0,211625,2083.75,104
"8802","27306","2021",31,31,0,211513.741935484,2271.06451612903,96.741935483871
"8803","27307","2021",10,10,0,160008.3,1706.4,98
"8804","27309","2021",14,14,0,199495.714285714,1842.57142857143,111.214285714286
"8805","27310","2021",6,6,0,189353.333333333,2939.16666666667,83.6666666666667
"8806","27311","2021",5,5,0,142600,1853.6,80.6
"8807","27312","2021",6,6,0,367916.666666667,3449.83333333333,107.333333333333
"8808","27313","2021",6,6,0,165150,1857.16666666667,89.6666666666667
"8809","27315","2021",4,4,0,203225,2001.75,111.25
"8810","27316","2021",19,19,0,182226.315789474,1972.36842105263,94.9473684210526
"8811","27317","2021",5,5,0,157620,2192.6,75
"8812","27318","2021",2,2,0,136970,1300.5,99
"8813","27319","2021",1,1,0,217000,2047,106
"8814","27320","2021",5,5,0,191380,1503,130.6
"8815","27321","2021",2,2,0,102500,1447.5,98
"8816","27322","2021",17,17,0,190605.882352941,1729.35294117647,113.529411764706
"8817","27323","2021",9,9,0,115091.111111111,1479.55555555556,80.8888888888889
"8818","27324","2021",12,12,0,248270.833333333,2248.66666666667,115.833333333333
"8819","27325","2021",3,3,0,139333.333333333,1385.66666666667,101.666666666667
"8820","27326","2021",7,7,0,250782.285714286,2525.85714285714,102.285714285714
"8821","27327","2021",2,2,0,140225,1171.5,132
"8822","27329","2021",16,16,0,192770.625,2252.125,99.125
"8823","27330","2021",1,1,0,85000,1393,61
"8824","27331","2021",5,5,0,211610,2263.8,96.8
"8825","27332","2021",8,8,0,213687.5,1904.75,117.125
"8826","27333","2021",9,9,0,208905.555555556,2133.55555555556,102.666666666667
"8827","27334","2021",2,2,0,130000,2235,58.5
"8828","27335","2021",19,18,1,182360.894736842,1934.78947368421,94.7368421052632
"8829","27336","2021",5,5,0,245040,2306.6,110.2
"8830","27337","2021",10,10,0,192020,1636.1,124.5
"8831","27338","2021",14,14,0,194182.142857143,1905.71428571429,111.928571428571
"8832","27339","2021",11,11,0,169245.454545455,1888.27272727273,91.2727272727273
"8833","27340","2021",14,14,0,264101.428571429,2038.21428571429,134.214285714286
"8834","27342","2021",4,4,0,145018.75,1608.5,94.75
"8835","27343","2021",24,24,0,268567.916666667,2202.45833333333,128.5
"8836","27345","2021",12,12,0,193125,1976.16666666667,102.916666666667
"8837","27346","2021",2,2,0,190950,1635,118.5
"8838","27347","2021",12,12,0,230894.25,2201.33333333333,109.416666666667
"8839","27348","2021",25,23,2,225762,1931.8,121.04
"8840","27349","2021",10,10,0,181399,1692.9,109.9
"8841","27350","2021",17,17,0,173544.117647059,1843.76470588235,99.5882352941177
"8842","27351","2021",13,12,1,170961.538461538,1867.30769230769,101.153846153846
"8843","27353","2021",4,4,0,200875,1987,101
"8844","27354","2021",5,5,0,209271.6,2025.6,102.2
"8845","27355","2021",74,53,21,172814.148648649,2134.08108108108,82.3243243243243
"8846","27358","2021",8,8,0,299531.25,2435.75,128.875
"8847","27359","2021",2,2,0,174150,1858.5,94.5
"8848","27360","2021",4,4,0,252562.5,1984.25,130.75
"8849","27361","2021",14,14,0,256059.285714286,2380.07142857143,107.928571428571
"8850","27363","2021",4,4,0,111975,1649.25,75.25
"8851","27364","2021",3,3,0,144616.666666667,1481.66666666667,100.333333333333
"8852","27365","2021",14,13,1,188045,1904.42857142857,100.428571428571
"8853","27366","2021",5,5,0,240980,1497.8,162.2
"8854","27367","2021",25,25,0,160024,1665.44,107.8
"8855","27368","2021",8,8,0,202712.5,1795.625,113.125
"8856","27369","2021",1,1,0,225000,1573,143
"8857","27370","2021",5,5,0,162500,1965.6,83.2
"8858","27371","2021",2,2,0,135000,1236,100
"8859","27372","2021",12,12,0,198507.333333333,1707.08333333333,114.916666666667
"8860","27373","2021",2,2,0,239000,1574.5,165
"8861","27374","2021",18,18,0,143658.333333333,1792.66666666667,79.8888888888889
"8862","27375","2021",232,172,60,156880.676724138,1912.97413793103,84.073275862069
"8863","27376","2021",5,5,0,194200,2618,105.6
"8864","27377","2021",14,14,0,179228.571428571,1779,106.214285714286
"8865","27378","2021",28,28,0,185301.607142857,1834.82142857143,106.464285714286
"8866","27379","2021",13,13,0,199073.846153846,1709.84615384615,134.307692307692
"8867","27380","2021",1,1,0,90000,1500,60
"8868","27381","2021",4,4,0,145025,1596.75,90.25
"8869","27382","2021",4,4,0,268875,1954,140.25
"8870","27383","2021",9,9,0,176755.555555556,2169.66666666667,88.1111111111111
"8871","27384","2021",10,10,0,265140,2504.6,117.7
"8872","27385","2021",24,21,3,162408.333333333,1867.08333333333,85.9583333333333
"8873","27386","2021",12,12,0,168154.166666667,1637.08333333333,108.916666666667
"8874","27388","2021",10,10,0,158590,2128,82
"8875","27389","2021",12,12,0,219135,2004.25,115.666666666667
"8876","27390","2021",22,22,0,183759.090909091,1607.95454545455,116.5
"8877","27391","2021",28,28,0,192502.857142857,1934.42857142857,100.928571428571
"8878","27392","2021",2,2,0,180000,1943.5,93
"8879","27393","2021",13,13,0,184680.769230769,2315,90.6153846153846
"8880","27394","2021",4,4,0,177475,1964.5,91.75
"8881","27395","2021",2,2,0,183000,3401.5,55
"8882","27396","2021",15,15,0,169866.666666667,1868.6,101.866666666667
"8883","27397","2021",30,30,0,220900.733333333,2246.93333333333,100.166666666667
"8884","27398","2021",28,28,0,172360.892857143,1741.14285714286,103.464285714286
"8885","27399","2021",1,1,0,50000,1515,33
"8886","27400","2021",10,10,0,340722.6,2718.3,120.2
"8887","27401","2021",1,1,0,2e+05,1818,110
"8888","27403","2021",2,2,0,503000,2607,186
"8889","27404","2021",1,1,0,45000,459,98
"8890","27405","2021",2,2,0,182500,1850,95
"8891","27406","2021",20,19,1,196437.75,1889.8,100.95
"8892","27407","2021",6,6,0,221250,1460.83333333333,148.166666666667
"8893","27408","2021",9,9,0,239850,1710.11111111111,143.888888888889
"8894","27410","2021",7,7,0,194928.571428571,1963.71428571429,101.285714285714
"8895","27411","2021",3,3,0,118981.333333333,1030,114.666666666667
"8896","27412","2021",16,16,0,194180.625,2062,98.25
"8897","27413","2021",14,14,0,143906.071428571,1773,82.9285714285714
"8898","27414","2021",21,21,0,138558.333333333,1417.04761904762,99.2380952380952
"8899","27415","2021",14,14,0,200026.857142857,1863.78571428571,112.142857142857
"8900","27417","2021",12,12,0,165835.333333333,2051.66666666667,81.25
"8901","27418","2021",6,6,0,207841.666666667,1955.33333333333,126.666666666667
"8902","27419","2021",13,13,0,194460,2115.92307692308,94.4615384615385
"8903","27420","2021",4,4,0,240250,2099.75,113
"8904","27421","2021",11,11,0,328481.818181818,2321.81818181818,141.909090909091
"8905","27422","2021",10,10,0,209635,2252.5,88.5
"8906","27423","2021",13,13,0,224540.769230769,2437.38461538462,98
"8907","27424","2021",6,6,0,169750,1781.5,100.833333333333
"8908","27425","2021",42,41,1,158635.285714286,1834.66666666667,88.5714285714286
"8909","27426","2021",14,14,0,232545.928571429,2312.71428571429,109.142857142857
"8910","27427","2021",19,19,0,123349.894736842,1659.47368421053,74
"8911","27428","2021",62,49,13,163120.161290323,1848.59677419355,88.9677419354839
"8912","27429","2021",1,1,0,332000,2213,150
"8913","27430","2021",4,4,0,188500,1563.25,124.5
"8914","27431","2021",21,19,2,103200,1089,94.5238095238095
"8915","27432","2021",12,12,0,154708.333333333,1820.25,91.8333333333333
"8916","27433","2021",1,1,0,155600,1831,85
"8917","27434","2021",1,1,0,280000,1077,260
"8918","27435","2021",2,2,0,177600,1882,96.5
"8919","27436","2021",9,9,0,189755.555555556,1928.33333333333,98.8888888888889
"8920","27437","2021",7,7,0,157428.571428571,1783.28571428571,89
"8921","27438","2021",34,27,7,132838.529411765,1648.20588235294,81.6764705882353
"8922","27439","2021",19,19,0,203423.684210526,1952.94736842105,107.157894736842
"8923","27440","2021",7,7,0,243507,2427.14285714286,106.142857142857
"8924","27442","2021",10,10,0,106689.6,1104.8,93.5
"8925","27444","2021",7,7,0,188328.571428571,2042.28571428571,103.428571428571
"8926","27446","2021",5,5,0,194400,1440.8,134.8
"8927","27447","2021",20,20,0,211087.5,1776.8,135
"8928","27448","2021",73,66,7,212734.260273973,2360.65753424658,91.6438356164384
"8929","27451","2021",4,4,0,203400,1942.75,108
"8930","27453","2021",26,26,0,162706.538461538,1944.57692307692,85.5769230769231
"8931","27454","2021",2,2,0,195160,2249,87
"8932","27455","2021",6,6,0,181666.666666667,2242.83333333333,90.3333333333333
"8933","27456","2021",11,11,0,212518.181818182,2169.81818181818,99.6363636363636
"8934","27457","2021",10,10,0,148500,1655.1,91.5
"8935","27458","2021",17,17,0,171752.941176471,1950.70588235294,88
"8936","27459","2021",1,1,0,144000,2028,71
"8937","27460","2021",4,4,0,166950,1688.5,102
"8938","27462","2021",2,2,0,111687.5,2046.5,64
"8939","27463","2021",16,16,0,160425,1693.0625,97.3125
"8940","27464","2021",15,15,0,200186.333333333,1763.4,122.4
"8941","27465","2021",8,8,0,226612.125,2288.875,100.75
"8942","27466","2021",7,7,0,181084,2230.71428571429,90.7142857142857
"8943","27467","2021",174,119,55,153045.948275862,1816.14942528736,83.183908045977
"8944","27468","2021",9,9,0,145369.444444444,1570.88888888889,97.3333333333333
"8945","27469","2021",60,55,5,175667.5,2069.38333333333,89.0833333333333
"8946","27470","2021",29,28,1,151513.448275862,1855.48275862069,83.7586206896552
"8947","27472","2021",5,5,0,181640,1337.2,135.8
"8948","27473","2021",15,15,0,225120,2490.73333333333,98.9333333333333
"8949","27474","2021",20,20,0,188735,2067.7,94.35
"8950","27475","2021",4,4,0,180162.5,1620.5,104.75
"8951","27476","2021",9,9,0,234613.333333333,2143,113.222222222222
"8952","27477","2021",8,8,0,257750,2396.875,102.875
"8953","27478","2021",22,22,0,185008.636363636,1860.95454545455,104.318181818182
"8954","27480","2021",14,14,0,166176.428571429,2097.71428571429,85.5
"8955","27481","2021",11,11,0,199845.454545455,1830.18181818182,111.181818181818
"8956","27482","2021",5,5,0,171160,1953.8,91.8
"8957","27483","2021",5,5,0,228742.8,2416.2,115.2
"8958","27485","2021",13,12,1,75769.2307692308,1070.46153846154,68.7692307692308
"8959","27486","2021",16,15,1,187168.125,1985.9375,98.4375
"8960","27487","2021",7,7,0,149650,1781.28571428571,85
"8961","27488","2021",1,1,0,218000,1615,135
"8962","27489","2021",6,6,0,269333.333333333,1965,131.333333333333
"8963","27490","2021",3,3,0,214410,2733,79.3333333333333
"8964","27492","2021",3,3,0,260900,2096,127
"8965","27493","2021",52,52,0,166877.096153846,1854.38461538462,92.5961538461538
"8966","27495","2021",7,7,0,203285.714285714,1931.28571428571,110.857142857143
"8967","27496","2021",11,11,0,166952.272727273,1528.63636363636,111.090909090909
"8968","27497","2021",13,13,0,186580.769230769,1517.53846153846,131.384615384615
"8969","27498","2021",5,5,0,222292.6,1970.4,111.2
"8970","27500","2021",26,24,2,152943.846153846,1671,99.1153846153846
"8971","27501","2021",5,5,0,268573,1874.2,145.4
"8972","27502","2021",40,39,1,109042.5,1460.225,71.85
"8973","27504","2021",10,10,0,246414.4,2024.8,124
"8974","27505","2021",4,4,0,140500,1400.25,95
"8975","27507","2021",52,51,1,163879.557692308,1850.96153846154,90.4807692307692
"8976","27508","2021",3,3,0,104000,1720.66666666667,66.3333333333333
"8977","27511","2021",15,15,0,185280,2074.06666666667,92.7333333333333
"8978","27512","2021",9,9,0,258066.666666667,2034.55555555556,131.111111111111
"8979","27514","2021",7,7,0,133285.714285714,1821.71428571429,75.1428571428571
"8980","27516","2021",17,17,0,191260,1628.35294117647,121.176470588235
"8981","27517","2021",20,20,0,195623.75,2075.05,98.15
"8982","27518","2021",7,7,0,157165.714285714,1853.14285714286,89.7142857142857
"8983","27520","2021",3,3,0,175000,1676.33333333333,103.666666666667
"8984","27521","2021",2,2,0,177500,1405.5,125
"8985","27522","2021",9,9,0,237987.222222222,1900.44444444444,122.111111111111
"8986","27524","2021",16,16,0,169059.375,1873.5625,92
"8987","27525","2021",2,2,0,425000,3101,137
"8988","27527","2021",9,9,0,155812.444444444,1751.88888888889,85.4444444444444
"8989","27528","2021",54,45,9,219532.092592593,2147,99.7407407407407
"8990","27529","2021",12,12,0,228075,1753.75,131.916666666667
"8991","27530","2021",1,1,0,150000,862,174
"8992","27531","2021",3,3,0,189283.333333333,1605,121.333333333333
"8993","27533","2021",11,11,0,239709.090909091,2090.90909090909,123.545454545455
"8994","27534","2021",19,19,0,186752.210526316,1872.15789473684,102.052631578947
"8995","27535","2021",4,4,0,258690,1906.5,133.25
"8996","27536","2021",6,6,0,170856.666666667,2056.5,87.5
"8997","27537","2021",10,10,0,199300,2046.9,98.5
"8998","27538","2021",7,7,0,197679.714285714,1710.85714285714,111.714285714286
"8999","27539","2021",7,7,0,303339.571428571,2020.14285714286,147.285714285714
"9000","27540","2021",8,8,0,216581.25,2278.125,100.125
"9001","27541","2021",6,6,0,173000,1775,102
"9002","27542","2021",17,17,0,201743.058823529,1873.17647058824,112.235294117647
"9003","27543","2021",18,18,0,188761.111111111,1904.05555555556,104.833333333333
"9004","27544","2021",7,7,0,230014.285714286,2304.71428571429,102.428571428571
"9005","27545","2021",2,2,0,521050,2814.5,187.5
"9006","27546","2021",2,2,0,176000,1304.5,150
"9007","27547","2021",17,17,0,163029.411764706,1403.29411764706,114.588235294118
"9008","27548","2021",28,28,0,207130.178571429,1778.82142857143,115.857142857143
"9009","27550","2021",13,13,0,181438.461538462,1922.92307692308,93.3076923076923
"9010","27552","2021",7,7,0,123342.571428571,1376.14285714286,98.5714285714286
"9011","27553","2021",7,7,0,122107.142857143,1551.57142857143,69.7142857142857
"9012","27554","2021",46,44,2,258914.347826087,2506.84782608696,106.891304347826
"9013","27555","2021",6,6,0,191583.333333333,1982.33333333333,98
"9014","27556","2021",3,3,0,109670,1441.33333333333,81.6666666666667
"9015","27557","2021",3,3,0,139666.666666667,1563.33333333333,90.6666666666667
"9016","27558","2021",4,4,0,281412.5,1629.75,162.75
"9017","27560","2021",6,6,0,153700,1544.33333333333,99.1666666666667
"9018","27561","2021",11,11,0,223283.636363636,1959.81818181818,115.363636363636
"9019","27562","2021",53,37,16,204998.113207547,2320,89.622641509434
"9020","27563","2021",17,17,0,158376.470588235,1857.94117647059,90.1764705882353
"9021","27564","2021",12,12,0,170658.333333333,1425.41666666667,118.833333333333
"9022","27565","2021",13,13,0,158380.769230769,1471.23076923077,100.076923076923
"9023","27567","2021",3,3,0,229879.666666667,2169,110.666666666667
"9024","27568","2021",9,9,0,186333.333333333,1879.22222222222,106.333333333333
"9025","27569","2021",3,3,0,511000,5117.33333333333,65.3333333333333
"9026","27570","2021",2,2,0,174000,1811.5,96
"9027","27571","2021",6,6,0,169975.833333333,1700.66666666667,105.666666666667
"9028","27572","2021",4,4,0,262565,2342.5,106
"9029","27576","2021",4,4,0,185875,1525.5,118.25
"9030","27577","2021",10,10,0,161404,2058.6,84.3
"9031","27578","2021",14,14,0,172118.785714286,1405.42857142857,116.214285714286
"9032","27579","2021",2,2,0,253000,1798.5,144
"9033","27580","2021",36,36,0,217620.694444444,2167.94444444444,101.416666666667
"9034","27582","2021",22,22,0,246205.681818182,2249.59090909091,110.363636363636
"9035","27584","2021",3,3,0,181666.666666667,1701.66666666667,102
"9036","27586","2021",1,1,0,75000,625,120
"9037","27587","2021",21,21,0,219073.571428571,2195,100.142857142857
"9038","27589","2021",18,18,0,286996.666666667,2584.83333333333,114.722222222222
"9039","27590","2021",6,6,0,103250,1210.16666666667,85.1666666666667
"9040","27591","2021",12,12,0,283905.333333333,2795.83333333333,109.666666666667
"9041","27592","2021",2,2,0,147150,1880.5,84.5
"9042","27593","2021",18,18,0,199905.555555556,1884.11111111111,107.666666666667
"9043","27594","2021",7,7,0,154589.142857143,1268,110.142857142857
"9044","27595","2021",12,12,0,219591.666666667,1880.33333333333,123.583333333333
"9045","27597","2021",9,9,0,262777.777777778,2255,128.444444444444
"9046","27598","2021",16,15,1,136718.75,1797.625,77.1875
"9047","27599","2021",8,8,0,298593.75,2010.875,143.5
"9048","27601","2021",13,13,0,170316.153846154,2163.69230769231,85
"9049","27602","2021",72,69,3,185091.805555556,1857.44444444444,99.4861111111111
"9050","27603","2021",9,9,0,154828.888888889,1866.66666666667,88.4444444444444
"9051","27604","2021",3,3,0,217666.666666667,1681,135.666666666667
"9052","27605","2021",9,9,0,259792.444444444,2298.11111111111,113.777777777778
"9053","27606","2021",13,13,0,188466.153846154,2138.30769230769,95.4615384615385
"9054","27608","2021",7,7,0,152700,1798.42857142857,84.4285714285714
"9055","27609","2021",9,9,0,147968.777777778,1896,78.7777777777778
"9056","27610","2021",2,2,0,386500,2741,125.5
"9057","27611","2021",4,4,0,212937.5,1865.25,141
"9058","27612","2021",4,4,0,258727.5,1854.5,136.75
"9059","27613","2021",4,4,0,151000,1499.5,103.75
"9060","27614","2021",1,1,0,305000,2033,150
"9061","27615","2021",4,4,0,228500,1960.25,118.25
"9062","27616","2021",22,22,0,218303.590909091,1972.13636363636,112.818181818182
"9063","27617","2021",3,3,0,129666.666666667,1679,76
"9064","27618","2021",10,10,0,162830,1736.8,95.8
"9065","27620","2021",7,7,0,201214.285714286,1941,103.142857142857
"9066","27621","2021",5,5,0,220550,1980.6,130.8
"9067","27622","2021",35,35,0,111844.285714286,1492.37142857143,75.9428571428571
"9068","27623","2021",12,12,0,208628.166666667,1683.58333333333,130.666666666667
"9069","27624","2021",6,6,0,213216.666666667,1762.83333333333,132.666666666667
"9070","27625","2021",6,6,0,243583.333333333,1816.33333333333,138.333333333333
"9071","27627","2021",9,9,0,187372.888888889,1419.22222222222,136.444444444444
"9072","27629","2021",23,23,0,146734.913043478,1605.30434782609,94.2608695652174
"9073","27630","2021",4,4,0,168168.75,1977.25,79.75
"9074","27631","2021",6,6,0,184251.666666667,1765.66666666667,100.666666666667
"9075","27632","2021",8,8,0,169068.75,1971.5,88.5
"9076","27633","2021",13,10,3,169723.846153846,1815.15384615385,93.3846153846154
"9077","27635","2021",3,3,0,183500,1933.66666666667,88
"9078","27638","2021",40,40,0,250872.425,2078.65,124.95
"9079","27640","2021",4,4,0,144250,1437.75,103
"9080","27641","2021",4,4,0,162121,1533.75,114.25
"9081","27643","2021",29,26,3,140774,1333.48275862069,104.068965517241
"9082","27644","2021",12,12,0,198345,2041.16666666667,104.916666666667
"9083","27645","2021",2,2,0,190000,1955,101
"9084","27646","2021",4,4,0,217462.5,3871.75,82.25
"9085","27649","2021",9,9,0,162222.222222222,1703.44444444444,102.333333333333
"9086","27650","2021",5,5,0,192532,2087.4,97.4
"9087","27652","2021",3,3,0,213967,2300,99.6666666666667
"9088","27654","2021",16,16,0,229334.375,2087.5,117.25
"9089","27655","2021",11,11,0,232531.818181818,1974.09090909091,118.818181818182
"9090","27656","2021",19,19,0,200762.631578947,2033.68421052632,101.631578947368
"9091","27658","2021",8,8,0,196718.875,1779.625,119.25
"9092","27659","2021",2,2,0,276000,2132,124
"9093","27660","2021",11,11,0,129863.636363636,1465,85.6363636363636
"9094","27661","2021",8,8,0,258281.25,2063,133.75
"9095","27662","2021",12,12,0,210365,2133.25,105.833333333333
"9096","27663","2021",1,1,0,542600,2206,246
"9097","27664","2021",18,18,0,186777.777777778,2108.5,104.555555555556
"9098","27665","2021",11,11,0,148445.454545455,2188.18181818182,69.6363636363636
"9099","27666","2021",4,4,0,266825,2101.5,129.25
"9100","27667","2021",6,6,0,262808.333333333,2000.33333333333,136
"9101","27668","2021",12,12,0,200750,1884.75,107.583333333333
"9102","27669","2021",2,2,0,166178,2058,82
"9103","27670","2021",13,13,0,166040,1718.15384615385,97.7692307692308
"9104","27671","2021",3,3,0,185800,1565.66666666667,117.666666666667
"9105","27672","2021",2,2,0,118000,1606.5,73
"9106","27673","2021",5,5,0,267390,2568,125
"9107","27674","2021",8,6,2,240061.875,1982.875,128.625
"9108","27677","2021",6,6,0,242233.333333333,2087.33333333333,121.5
"9109","27678","2021",17,17,0,195972.941176471,1780.76470588235,109.764705882353
"9110","27679","2021",140,109,31,145181.028571429,1723.78571428571,83.15
"9111","27680","2021",9,9,0,107000,1263.55555555556,87.5555555555556
"9112","27681","2021",321,163,158,208375.218068536,2540.39563862928,82.9968847352025
"9113","27682","2021",8,8,0,276583.875,2790.25,123.625
"9114","27683","2021",3,3,0,165833.333333333,1734.66666666667,96
"9115","27684","2021",7,7,0,166628.571428571,1808.42857142857,102.428571428571
"9116","27685","2021",22,22,0,216893.181818182,1933.63636363636,114.954545454545
"9117","27686","2021",2,2,0,205000,3409,63
"9118","27689","2021",9,9,0,259333.333333333,2364.88888888889,113.222222222222
"9119","27690","2021",5,5,0,218000,3270.8,114.6
"9120","27691","2021",21,21,0,224295.238095238,2153.57142857143,107.666666666667
"9121","27692","2021",2,2,0,197500,2003,109.5
"9122","27693","2021",28,28,0,187108.928571429,1626.92857142857,122.642857142857
"9123","27694","2021",8,8,0,281125,2376.375,118.125
"9124","27695","2021",4,4,0,181938.75,1735.5,110
"9125","27696","2021",12,12,0,279425,2267.83333333333,137.583333333333
"9126","27697","2021",3,3,0,258333.333333333,1918.66666666667,135.666666666667
"9127","27698","2021",10,10,0,189615,2129.6,94.4
"9128","27699","2021",1,1,0,35000,745,47
"9129","27700","2021",6,6,0,222583.333333333,2257.16666666667,104.5
"9130","27701","2021",83,62,21,135370.734939759,1595.25301204819,85.5903614457831
"9131","28001","2021",31,29,2,260357.838709677,2428.09677419355,113.387096774194
"9132","28003","2021",2,2,0,229225,1680.5,136.5
"9133","28004","2021",3,3,0,133333.333333333,1614,84.3333333333333
"9134","28005","2021",18,18,0,128804.166666667,1325.61111111111,99.2777777777778
"9135","28006","2021",33,33,0,210984.363636364,2050.39393939394,105
"9136","28007","2021",52,43,9,249971.538461538,2272.07692307692,105.230769230769
"9137","28008","2021",7,7,0,144267.142857143,1504.42857142857,106.714285714286
"9138","28009","2021",1,1,0,155000,1582,98
"9139","28010","2021",4,4,0,105793.75,1612.75,79.25
"9140","28012","2021",92,90,2,102822.413043478,1177.4347826087,87.3804347826087
"9141","28013","2021",29,29,0,194118.620689655,2081.75862068966,100.48275862069
"9142","28014","2021",13,13,0,154374.384615385,2012.84615384615,81.2307692307692
"9143","28015","2021",115,90,25,199245.486956522,2215.13913043478,92.8608695652174
"9144","28016","2021",9,9,0,131002.222222222,1385.77777777778,97.5555555555556
"9145","28018","2021",40,40,0,98297.45,1088.3,92.225
"9146","28019","2021",1,1,0,188000,1297,145
"9147","28021","2021",25,25,0,158591.04,1873.88,91.28
"9148","28022","2021",11,11,0,187295.454545455,1849.36363636364,104.272727272727
"9149","28023","2021",18,18,0,245442.777777778,2497.83333333333,103.555555555556
"9150","28024","2021",19,19,0,238290.473684211,2169,111.210526315789
"9151","28026","2021",3,3,0,172666.666666667,1239,173.333333333333
"9152","28027","2021",30,30,0,86808.3333333333,1127.2,84.5666666666667
"9153","28028","2021",7,7,0,75142.8571428571,813.285714285714,103
"9154","28029","2021",2,2,0,110000,1605.5,73.5
"9155","28030","2021",4,4,0,115625,1373.5,84.25
"9156","28031","2021",13,13,0,82487.6923076923,883.923076923077,96.3846153846154
"9157","28032","2021",6,6,0,118833.333333333,1435.33333333333,97.3333333333333
"9158","28033","2021",17,17,0,115523.529411765,1225,97.7647058823529
"9159","28034","2021",22,22,0,211607.818181818,2026.95454545455,115.318181818182
"9160","28035","2021",11,11,0,185137.272727273,2114.09090909091,96.8181818181818
"9161","28036","2021",18,15,3,246015.555555556,2602.27777777778,97.2222222222222
"9162","28037","2021",10,9,1,247700,2855,96.5
"9163","28038","2021",2,2,0,57750,887,68.5
"9164","28039","2021",31,30,1,208856.419354839,2293.1935483871,98.6129032258064
"9165","28040","2021",5,5,0,178220,1853.4,99.8
"9166","28041","2021",1,1,0,123000,1295,95
"9167","28045","2021",3,3,0,131333.333333333,1503.66666666667,85
"9168","28046","2021",10,10,0,169749.9,1687.3,99.2
"9169","28047","2021",19,19,0,142554.736842105,1572.68421052632,97.7894736842105
"9170","28048","2021",11,11,0,193621.818181818,1650.09090909091,118.545454545455
"9171","28049","2021",2,2,0,172500,1012.5,175.5
"9172","28050","2021",7,7,0,185877.142857143,2519.14285714286,88
"9173","28051","2021",86,73,13,119281.430232558,1444.60465116279,84.3837209302326
"9174","28052","2021",19,18,1,218499.473684211,2341.57894736842,99.1052631578947
"9175","28053","2021",1,1,0,255000,1328,192
"9176","28054","2021",5,5,0,208500,2284.8,95.4
"9177","28055","2021",12,12,0,191943.666666667,1848.25,110.583333333333
"9178","28056","2021",34,33,1,303783.323529412,2609.29411764706,123.588235294118
"9179","28057","2021",13,13,0,154246.153846154,1556.61538461538,111.615384615385
"9180","28058","2021",12,12,0,277741.666666667,2438,122.25
"9181","28059","2021",28,27,1,125375.357142857,1456.67857142857,87.5357142857143
"9182","28060","2021",5,5,0,157440.4,1806.8,87.2
"9183","28061","2021",85,81,4,118129.141176471,1340.56470588235,91.0117647058824
"9184","28062","2021",12,11,1,272884.166666667,3372.33333333333,108.666666666667
"9185","28064","2021",25,24,1,290622,2631.16,109.04
"9186","28065","2021",3,3,0,124633.333333333,1222,110.333333333333
"9187","28067","2021",1,1,0,62000,1550,40
"9188","28068","2021",3,3,0,222333.333333333,1846,134
"9189","28070","2021",49,49,0,255276.714285714,2359.77551020408,109.571428571429
"9190","28071","2021",13,13,0,122576.923076923,1215.38461538462,104.230769230769
"9191","28072","2021",5,5,0,130600,1305.6,100.8
"9192","28073","2021",4,4,0,263212.5,2287.5,117.5
"9193","28074","2021",4,4,0,203750,1607,133.75
"9194","28075","2021",20,19,1,138366.45,1561.9,87
"9195","28076","2021",3,3,0,190500,1764,105
"9196","28077","2021",8,8,0,202947.875,1542.5,133.375
"9197","28078","2021",6,6,0,105333.333333333,1546.16666666667,78.8333333333333
"9198","28079","2021",7,7,0,78152.2857142857,930.857142857143,84.4285714285714
"9199","28080","2021",5,5,0,92800,1002,89.6
"9200","28081","2021",6,6,0,129150,1238.5,109.166666666667
"9201","28082","2021",7,7,0,268771.428571429,1973.42857142857,135.714285714286
"9202","28084","2021",25,25,0,242196,2270.92,112.4
"9203","28085","2021",797,227,570,170198.033877039,2453.54579673777,69.5859473023839
"9204","28086","2021",5,5,0,103030,728.6,150.6
"9205","28087","2021",7,7,0,238885.714285714,1601.57142857143,149.571428571429
"9206","28088","2021",198,152,46,100508.631313131,1241.49494949495,82.3989898989899
"9207","28089","2021",31,28,3,133016.129032258,1655.06451612903,80.9354838709677
"9208","28090","2021",1,1,0,180000,3158,57
"9209","28091","2021",3,3,0,93166.6666666667,992.666666666667,88.3333333333333
"9210","28092","2021",3,3,0,180166.666666667,1525.33333333333,120
"9211","28094","2021",33,32,1,203767.878787879,2033.78787878788,107.484848484848
"9212","28095","2021",4,4,0,174312.5,1586.25,108.25
"9213","28096","2021",18,16,2,214880.611111111,2246,99.7777777777778
"9214","28098","2021",41,41,0,240858.292682927,2408.58536585366,100.756097560976
"9215","28099","2021",16,16,0,161818.75,1595.5,106.25
"9216","28100","2021",4,4,0,198575,1847.25,108
"9217","28102","2021",7,7,0,158990,1843.14285714286,96
"9218","28103","2021",123,119,4,111979.601626016,1245.82113821138,90.4227642276423
"9219","28104","2021",13,13,0,235685.384615385,2211.07692307692,114.307692307692
"9220","28105","2021",9,9,0,133377.777777778,1685,87.5555555555556
"9221","28106","2021",3,3,0,84406.6666666667,1100.66666666667,80.6666666666667
"9222","28107","2021",6,6,0,210451.666666667,1926.83333333333,107.166666666667
"9223","28108","2021",6,6,0,143541.666666667,1478.33333333333,107.166666666667
"9224","28109","2021",4,4,0,165192.5,1404.25,119.25
"9225","28110","2021",70,39,31,217858.357142857,2498.51428571429,91.3857142857143
"9226","28111","2021",5,5,0,213600,1841.4,113.6
"9227","28113","2021",21,17,4,221830.476190476,1974.19047619048,109.428571428571
"9228","28114","2021",6,6,0,131416.666666667,1433,83.5
"9229","28116","2021",34,34,0,164744.705882353,1965.58823529412,88
"9230","28117","2021",6,6,0,209233.333333333,1619.66666666667,124
"9231","28118","2021",8,8,0,333465,2492.25,135.5
"9232","28119","2021",6,6,0,95666.6666666667,1164.83333333333,83.3333333333333
"9233","28120","2021",6,6,0,126166.666666667,1503,81.8333333333333
"9234","28121","2021",1,1,0,114500,895,128
"9235","28122","2021",24,24,0,192970.833333333,1955.16666666667,103.75
"9236","28123","2021",17,17,0,120710.882352941,1332.17647058824,91.8235294117647
"9237","28124","2021",13,13,0,152000,1591.76923076923,95.3076923076923
"9238","28126","2021",4,4,0,94781.25,1325.25,76.25
"9239","28127","2021",21,21,0,148011.761904762,1619.47619047619,96.2857142857143
"9240","28128","2021",4,4,0,179400,1705,102.25
"9241","28129","2021",15,15,0,174630.533333333,1723.66666666667,103
"9242","28130","2021",23,22,1,164906.52173913,1509.26086956522,113.869565217391
"9243","28132","2021",12,11,1,147558.333333333,1400,107.833333333333
"9244","28134","2021",428,205,223,134731.682242991,1731.36448598131,79.3621495327103
"9245","28135","2021",21,20,1,298389.857142857,2647.38095238095,114
"9246","28136","2021",6,6,0,248736.666666667,1771.33333333333,140.833333333333
"9247","28137","2021",14,14,0,281162.571428571,2517.92857142857,119.214285714286
"9248","28139","2021",3,3,0,114300,1030.66666666667,109.333333333333
"9249","28140","2021",110,54,56,188204.418181818,2707.14545454545,71.0181818181818
"9250","28141","2021",4,4,0,199837.5,2027.75,100
"9251","28142","2021",5,5,0,140240,1509.8,95.8
"9252","28143","2021",5,5,0,254410,1873.8,136.4
"9253","28144","2021",9,9,0,169644.444444444,1794.66666666667,88.6666666666667
"9254","28146","2021",21,21,0,234071.904761905,2090.61904761905,115.428571428571
"9255","28147","2021",8,8,0,160082.5,1403.875,108.5
"9256","28148","2021",8,8,0,168187.5,1813.625,96.5
"9257","28149","2021",14,13,1,103042.857142857,1245.92857142857,86
"9258","28151","2021",3,3,0,177166.666666667,1277.66666666667,165.333333333333
"9259","28153","2021",3,3,0,135300,2402.33333333333,62.6666666666667
"9260","28154","2021",13,13,0,213833.076923077,2190.76923076923,98.6153846153846
"9261","28155","2021",5,5,0,143400,1609.8,95.6
"9262","28156","2021",20,20,0,158215.6,1344.95,123.15
"9263","28157","2021",3,3,0,167000,1353.66666666667,122
"9264","28158","2021",6,6,0,333445,2251.5,146.666666666667
"9265","28159","2021",12,12,0,154222.5,1410.5,109.833333333333
"9266","28160","2021",11,11,0,169958.272727273,1932.72727272727,90.4545454545455
"9267","28161","2021",11,11,0,96868.1818181818,948.636363636364,94.4545454545455
"9268","28162","2021",4,4,0,162437.5,1937.5,98.75
"9269","28163","2021",1,1,0,194870,1856,105
"9270","28164","2021",15,15,0,130566,1578.53333333333,96.2666666666667
"9271","28166","2021",2,2,0,172500,2038,87.5
"9272","28167","2021",5,5,0,134100,1244.2,115.2
"9273","28168","2021",68,51,17,186168.558823529,2233.54411764706,88.3382352941177
"9274","28169","2021",6,6,0,242500,2111.83333333333,115
"9275","28170","2021",3,3,0,207400,2101.33333333333,100
"9276","28171","2021",14,14,0,237041.428571429,2152.21428571429,128.857142857143
"9277","28172","2021",14,14,0,250069.357142857,2409.92857142857,109.285714285714
"9278","28173","2021",19,17,2,228998.526315789,2094.63157894737,111.631578947368
"9279","28175","2021",1,1,0,85000,1062,80
"9280","28176","2021",16,16,0,162010,1520.125,108.9375
"9281","28177","2021",7,7,0,232085.714285714,1948,127.857142857143
"9282","28178","2021",1,1,0,170000,2429,70
"9283","28180","2021",10,10,0,252160,2074.6,122.9
"9284","28182","2021",6,6,0,103094.166666667,1511.66666666667,75.8333333333333
"9285","28183","2021",9,9,0,188444.444444444,1986.44444444444,96.4444444444444
"9286","28184","2021",9,9,0,163944.444444444,1537,109.222222222222
"9287","28185","2021",20,18,2,290699,2538.25,118.2
"9288","28187","2021",14,14,0,276076.642857143,2182,122.5
"9289","28188","2021",21,20,1,219528.714285714,1995.38095238095,113.666666666667
"9290","28189","2021",2,2,0,177250,1451.5,121.5
"9291","28190","2021",6,6,0,122500,1373.33333333333,96.3333333333333
"9292","28191","2021",46,42,4,253596.956521739,2490.76086956522,104.630434782609
"9293","28192","2021",6,6,0,150083.333333333,1622.16666666667,97
"9294","28193","2021",2,2,0,289000,2135.5,145.5
"9295","28194","2021",8,8,0,144152.5,2085.375,69.625
"9296","28195","2021",13,13,0,272111.538461538,2359.53846153846,121.846153846154
"9297","28196","2021",64,63,1,121660.546875,1346.40625,91.046875
"9298","28197","2021",2,2,0,145000,1707,84
"9299","28198","2021",18,18,0,124969.111111111,1415.61111111111,89.6666666666667
"9300","28199","2021",31,28,3,156233.225806452,1446.22580645161,114.41935483871
"9301","28200","2021",10,10,0,179884.7,1582.2,133.4
"9302","28201","2021",29,28,1,207553.448275862,2255.86206896552,95.4827586206897
"9303","28202","2021",4,4,0,88250,1070,86
"9304","28203","2021",7,7,0,161236.428571429,1727.57142857143,94.7142857142857
"9305","28206","2021",11,11,0,151210.909090909,1613.54545454545,100.090909090909
"9306","28207","2021",4,4,0,183875,1698.5,112
"9307","28208","2021",6,6,0,216100,2604.83333333333,90.6666666666667
"9308","28209","2021",87,63,24,215003.183908046,2321.74712643678,93.3448275862069
"9309","28210","2021",3,3,0,190000,1656,120.333333333333
"9310","28211","2021",15,15,0,126370,1307,107.533333333333
"9311","28212","2021",7,7,0,123282.571428571,945.428571428571,124.142857142857
"9312","28213","2021",6,5,1,202115,2742.66666666667,78.3333333333333
"9313","28214","2021",54,52,2,130066.666666667,1411.55555555556,94.1851851851852
"9314","28215","2021",6,6,0,146566.666666667,1411.16666666667,107.5
"9315","28216","2021",3,3,0,205000,4584.66666666667,72.3333333333333
"9316","28217","2021",7,7,0,149578.571428571,1477.57142857143,105
"9317","28218","2021",182,82,100,144378.049450549,2197.8021978022,67.478021978022
"9318","28219","2021",7,7,0,90428.5714285714,1508.28571428571,61
"9319","28220","2021",93,75,18,247364.47311828,2585.68817204301,99.3225806451613
"9320","28221","2021",1,1,0,120000,1538,78
"9321","28222","2021",9,9,0,138493.888888889,1519,107.666666666667
"9322","28223","2021",31,31,0,212712.516129032,2003.09677419355,109.322580645161
"9323","28225","2021",9,9,0,162166.666666667,1912.55555555556,89.7777777777778
"9324","28226","2021",22,22,0,142679.772727273,1598.59090909091,94.7272727272727
"9325","28227","2021",89,71,18,217053.539325843,2507.20224719101,89.4044943820225
"9326","28229","2021",176,82,94,163548.051136364,2221.27840909091,75.1988636363636
"9327","28230","2021",12,12,0,204341.666666667,1900,112.666666666667
"9328","28231","2021",4,4,0,217447.25,1709,133.75
"9329","28232","2021",15,15,0,152269.333333333,1651.8,88.2666666666667
"9330","28233","2021",21,21,0,117153.80952381,1394.95238095238,85.8095238095238
"9331","28234","2021",11,11,0,137386.545454545,1575.45454545455,87.5454545454545
"9332","28235","2021",4,4,0,301762.5,2788.75,109.5
"9333","28236","2021",34,34,0,128730.588235294,1324,96.9705882352941
"9334","28237","2021",3,3,0,201766.666666667,2012.33333333333,89.6666666666667
"9335","28239","2021",17,17,0,238090.529411765,1874.52941176471,132.941176470588
"9336","28240","2021",10,10,0,167360,1828.8,99.8
"9337","28243","2021",1,1,0,208000,2101,99
"9338","28245","2021",5,5,0,334100,2189,157
"9339","28246","2021",9,9,0,135787.777777778,1295.22222222222,116
"9340","28247","2021",13,13,0,231326.923076923,1968.92307692308,118.769230769231
"9341","28248","2021",6,6,0,162966.666666667,1890.33333333333,86.6666666666667
"9342","28249","2021",16,16,0,223214.5,2124.625,108.8125
"9343","28251","2021",11,11,0,213554.727272727,1992.09090909091,115.363636363636
"9344","28252","2021",8,8,0,133200,1303.625,96.25
"9345","28253","2021",8,8,0,244110.125,2153.125,115.875
"9346","28254","2021",12,12,0,179051.166666667,1725,110.083333333333
"9347","28255","2021",4,4,0,194862.5,1472.75,138.25
"9348","28256","2021",6,6,0,125550,1530.5,86.1666666666667
"9349","28257","2021",2,2,0,216000,1711.5,129
"9350","28259","2021",8,8,0,132896.875,1334.875,104.75
"9351","28261","2021",12,12,0,144239.083333333,1552.66666666667,92.25
"9352","28263","2021",7,7,0,159714.285714286,1294.85714285714,114.285714285714
"9353","28264","2021",4,4,0,137300,1680.5,100.5
"9354","28265","2021",5,5,0,70080,840.4,81.8
"9355","28267","2021",7,7,0,220757.142857143,2004.14285714286,113.857142857143
"9356","28268","2021",1,1,0,311500,2077,150
"9357","28269","2021",29,26,3,271491.655172414,2426.65517241379,117.551724137931
"9358","28270","2021",3,3,0,140000,1234.33333333333,116.666666666667
"9359","28271","2021",5,5,0,132720,1440.4,92.2
"9360","28272","2021",5,5,0,80280,887.2,96.4
"9361","28273","2021",4,4,0,120592.5,1215.25,103.5
"9362","28274","2021",6,6,0,123316.666666667,1592.66666666667,95.1666666666667
"9363","28275","2021",13,13,0,183951.923076923,1952.30769230769,95.0769230769231
"9364","28276","2021",3,3,0,115000,1324.33333333333,88.3333333333333
"9365","28277","2021",9,9,0,133311.111111111,1488,90.5555555555556
"9366","28278","2021",10,10,0,264049,1942.4,133.8
"9367","28279","2021",56,39,17,162629.910714286,2069.66071428571,79.8928571428571
"9368","28280","2021",162,113,49,119495.932098765,1324.43827160494,85.1851851851852
"9369","28281","2021",4,4,0,277950,2446,118.75
"9370","28282","2021",13,13,0,121992.307692308,1361.69230769231,91.9230769230769
"9371","28283","2021",8,8,0,93690,1171.375,88
"9372","28284","2021",9,9,0,154211.111111111,1409.11111111111,111.222222222222
"9373","28285","2021",8,8,0,260715,2113.625,132.875
"9374","28286","2021",4,4,0,194700,1991.75,105.75
"9375","28287","2021",14,14,0,137771.428571429,1289.21428571429,106
"9376","28289","2021",2,2,0,207500,1735,126.5
"9377","28290","2021",4,4,0,122500,1477.5,87.25
"9378","28291","2021",8,8,0,198243.75,2009.625,106.25
"9379","28292","2021",11,11,0,231816.909090909,2223.81818181818,113.545454545455
"9380","28293","2021",15,15,0,244904.133333333,2320.93333333333,106.6
"9381","28294","2021",13,13,0,227391.461538462,2001.61538461538,121.153846153846
"9382","28296","2021",6,6,0,111909.166666667,1683.66666666667,77
"9383","28298","2021",61,52,9,205065.360655738,2415.65573770492,90.1967213114754
"9384","28299","2021",3,3,0,206676.333333333,2043.66666666667,102.666666666667
"9385","28300","2021",1,1,0,53000,3118,17
"9386","28301","2021",4,4,0,301037.5,2088.75,147.75
"9387","28302","2021",21,21,0,138733.333333333,1720.57142857143,81.1904761904762
"9388","28303","2021",1,1,0,265200,2286,116
"9389","28304","2021",7,7,0,141428.571428571,1548.71428571429,99
"9390","28305","2021",10,10,0,149585,1510.9,88.5
"9391","28306","2021",6,6,0,157893.333333333,1293.5,132.166666666667
"9392","28308","2021",3,3,0,255333.333333333,1385.66666666667,180
"9393","28309","2021",22,22,0,155839.318181818,1622.36363636364,101.090909090909
"9394","28310","2021",3,3,0,169333.333333333,1932.66666666667,88.3333333333333
"9395","28312","2021",4,4,0,182925,1859.5,102.25
"9396","28313","2021",2,2,0,274250,2105.5,128
"9397","28314","2021",5,5,0,131500,1874.8,69.2
"9398","28316","2021",8,8,0,194052.125,1879,93.625
"9399","28317","2021",11,11,0,188121.818181818,1999.18181818182,96.4545454545455
"9400","28319","2021",11,11,0,180131.818181818,1700.90909090909,117.363636363636
"9401","28321","2021",19,19,0,326805.263157895,2395.68421052632,131.947368421053
"9402","28322","2021",7,7,0,208811.428571429,1653.85714285714,132.142857142857
"9403","28323","2021",7,7,0,176142.857142857,1446.42857142857,124.428571428571
"9404","28324","2021",14,14,0,181492.714285714,2038.14285714286,91.4285714285714
"9405","28325","2021",7,7,0,160521.428571429,1892.14285714286,83.2857142857143
"9406","28326","2021",9,9,0,133666.666666667,1563.44444444444,87.5555555555556
"9407","28327","2021",2,2,0,57500,1011,56
"9408","28329","2021",2,2,0,84000,988.5,85
"9409","28330","2021",39,39,0,115572.820512821,1245.64102564103,97
"9410","28331","2021",33,33,0,120106.060606061,1355.15151515152,93.2424242424242
"9411","28332","2021",26,26,0,259375.769230769,2054.34615384615,126.538461538462
"9412","28334","2021",40,40,0,132744.8,1395.725,94.1
"9413","28335","2021",15,15,0,130319.333333333,1328.06666666667,101.533333333333
"9414","28336","2021",1,1,0,156740,1264,124
"9415","28337","2021",35,34,1,201769.142857143,2089.57142857143,100.342857142857
"9416","28339","2021",1,1,0,211000,1563,135
"9417","28341","2021",4,4,0,181250,1794.5,108.25
"9418","28342","2021",4,4,0,109000,1380.5,80.25
"9419","28343","2021",14,14,0,371551.857142857,2476.57142857143,161.214285714286
"9420","28344","2021",5,5,0,207502.6,1735,125.6
"9421","28346","2021",1,1,0,329240,2814,117
"9422","28347","2021",18,17,1,291668.777777778,2859.11111111111,104.111111111111
"9423","28348","2021",50,50,0,152619.8,1633.3,96.68
"9424","28349","2021",7,7,0,464062.142857143,2459.57142857143,184.285714285714
"9425","28350","2021",14,14,0,196313.928571429,1970.92857142857,98.2857142857143
"9426","28351","2021",10,10,0,181452,1524.4,114.4
"9427","28352","2021",24,24,0,287284.25,2475.66666666667,116.25
"9428","28353","2021",4,4,0,128280,1470.5,84.25
"9429","28354","2021",15,15,0,127960,1508,93.2666666666667
"9430","28355","2021",6,6,0,404275.666666667,2622.66666666667,175.166666666667
"9431","28357","2021",21,20,1,247998.047619048,2094.09523809524,130.666666666667
"9432","28358","2021",35,34,1,280629.828571429,2300.77142857143,118.685714285714
"9433","28359","2021",61,60,1,145494.967213115,1728.11475409836,87.2131147540984
"9434","28360","2021",15,15,0,148082.666666667,1352,112.733333333333
"9435","28362","2021",14,14,0,132023.571428571,1396,95.1428571428571
"9436","28363","2021",23,23,0,187815.217391304,1999.73913043478,95.8695652173913
"9437","28364","2021",22,20,2,110220.454545455,1620.5,88.3636363636364
"9438","28365","2021",4,4,0,148000,1565,90.75
"9439","28366","2021",11,11,0,177037.272727273,2063.63636363636,96.8181818181818
"9440","28367","2021",6,6,0,168666.666666667,1410.66666666667,125.333333333333
"9441","28368","2021",1,1,0,196000,3322,59
"9442","28369","2021",12,12,0,159100,1989.58333333333,81.1666666666667
"9443","28370","2021",9,9,0,142739.888888889,1037.33333333333,129.444444444444
"9444","28371","2021",16,16,0,213157.3125,2174.5,99.75
"9445","28372","2021",13,13,0,263469.307692308,2419.84615384615,113.461538461538
"9446","28373","2021",66,62,4,127012.424242424,1385.01515151515,95.8030303030303
"9447","28374","2021",9,9,0,202935.222222222,1832.33333333333,115.333333333333
"9448","28375","2021",5,5,0,153631,2079.2,89.2
"9449","28377","2021",47,47,0,218430.170212766,2213.51063829787,101.765957446809
"9450","28378","2021",13,13,0,127347.461538462,1141.76923076923,106.615384615385
"9451","28379","2021",5,5,0,197100,2185.4,92.6
"9452","28380","2021",28,28,0,245932.5,2283.17857142857,108.928571428571
"9453","28382","2021",8,8,0,241437.5,2241.5,114.875
"9454","28383","2021",12,12,0,210260.166666667,2081.33333333333,107.666666666667
"9455","28385","2021",4,4,0,126875,1243.5,109
"9456","28386","2021",20,20,0,169287,1453.75,117.75
"9457","28387","2021",11,10,1,91302.7272727273,1067.09090909091,86.2727272727273
"9458","28388","2021",19,18,1,224090.526315789,2333.68421052632,97.1052631578947
"9459","28389","2021",5,5,0,109200,1030.6,90
"9460","28390","2021",10,10,0,202500,1460.5,123.1
"9461","28391","2021",44,44,0,147606.363636364,1680.06818181818,91.1590909090909
"9462","28392","2021",2,2,0,99000,1045.5,93
"9463","28393","2021",48,48,0,202331.375,1870.89583333333,118.958333333333
"9464","28394","2021",19,17,2,174933.157894737,1776.68421052632,100.368421052632
"9465","28395","2021",5,5,0,346422,1871.4,146.4
"9466","28396","2021",6,6,0,165319.166666667,1340.33333333333,128.166666666667
"9467","28397","2021",6,6,0,284725,2210,136.666666666667
"9468","28398","2021",32,32,0,114567.8125,1287.40625,95.375
"9469","28400","2021",6,6,0,123416.666666667,906.666666666667,139
"9470","28401","2021",8,8,0,145722.5,1354.625,108.25
"9471","28403","2021",9,9,0,256772.222222222,2268.22222222222,116.444444444444
"9472","28404","2021",143,117,26,165569.58041958,1952.22377622378,88.041958041958
"9473","28405","2021",25,25,0,197026.6,2201.2,89.2
"9474","28406","2021",26,26,0,139457.884615385,1488.5,98.9230769230769
"9475","28407","2021",5,5,0,113200,1179.4,89.4
"9476","28408","2021",3,3,0,160733.333333333,2610.33333333333,70.6666666666667
"9477","28409","2021",9,9,0,133678.888888889,1332.88888888889,100.555555555556
"9478","28410","2021",9,9,0,199444.444444444,1306.88888888889,142.333333333333
"9479","28411","2021",3,3,0,113666.666666667,1385.66666666667,81.3333333333333
"9480","28415","2021",36,34,2,195871.666666667,1832.13888888889,103.111111111111
"9481","28417","2021",35,32,3,202399.257142857,2185.11428571429,98.2285714285714
"9482","28418","2021",1,1,0,189900,1484,128
"9483","28419","2021",4,4,0,129407.5,1207.5,107.75
"9484","28421","2021",8,8,0,169225.375,1937.25,105.125
"9485","28422","2021",62,58,4,139413.225806452,1607.20967741935,89
"9486","28423","2021",5,5,0,193920,2054.2,97
"9487","28424","2021",22,22,0,113719.090909091,1422.81818181818,77.4090909090909
"9488","28425","2021",11,10,1,218006.818181818,2431.63636363636,91.9090909090909
"9489","28426","2021",9,9,0,118110,1521.33333333333,78.5555555555556
"9490","29001","2021",13,13,0,213950,2721.92307692308,84.7692307692308
"9491","29002","2021",12,12,0,182237.5,1761.75,105.666666666667
"9492","29003","2021",92,65,27,166380.25,2100.44565217391,79.4239130434783
"9493","29004","2021",87,81,6,156220.287356322,1626.47126436782,97.6896551724138
"9494","29005","2021",14,14,0,217392.857142857,2090.35714285714,101.642857142857
"9495","29006","2021",126,51,75,207222.142857143,3029.49206349206,71.0793650793651
"9496","29007","2021",15,15,0,97946.6666666667,1188.13333333333,78.2666666666667
"9497","29008","2021",11,11,0,249181.818181818,2208.54545454545,131.454545454545
"9498","29010","2021",16,16,0,143026.25,1442.1875,105.25
"9499","29011","2021",35,30,5,248370.714285714,2272.6,110.371428571429
"9500","29012","2021",6,5,1,61833.3333333333,786.833333333333,85.3333333333333
"9501","29013","2021",8,8,0,86625,1047.125,81.875
"9502","29014","2021",7,7,0,128214.285714286,1324,90.2857142857143
"9503","29015","2021",37,36,1,191987.891891892,1974.89189189189,98.4594594594595
"9504","29016","2021",14,14,0,190550,2016.57142857143,92.5
"9505","29017","2021",12,12,0,179254.166666667,2063,88.3333333333333
"9506","29018","2021",12,12,0,73144.1666666667,952,81
"9507","29019","2021",3354,728,2626,143333.874478235,2041.15474060823,70.9791293977341
"9508","29020","2021",55,51,4,134968.581818182,1342.94545454545,103.2
"9509","29021","2021",33,33,0,199891.212121212,1874.78787878788,108
"9510","29022","2021",50,38,12,204150.3,2238.46,91.72
"9511","29023","2021",67,53,14,314189.850746269,3196.16417910448,95.2686567164179
"9512","29024","2021",123,103,20,112015.243902439,1236.91869918699,91.7154471544715
"9513","29025","2021",19,19,0,158468.947368421,1504.05263157895,115.684210526316
"9514","29026","2021",60,50,10,123957.5,1263.5,97.1666666666667
"9515","29027","2021",64,61,3,115963.9375,1113.21875,103.84375
"9516","29028","2021",19,19,0,166713.210526316,1662.78947368421,101.842105263158
"9517","29029","2021",23,22,1,79613.0434782609,1035.13043478261,77.5217391304348
"9518","29030","2021",70,68,2,165532.785714286,1774.22857142857,101.1
"9519","29031","2021",80,63,17,304713.375,3121.95,104.8875
"9520","29032","2021",36,36,0,301926.527777778,2536.66666666667,125.083333333333
"9521","29033","2021",8,7,1,67725,837,79.375
"9522","29034","2021",11,11,0,107786.363636364,1284.63636363636,87
"9523","29035","2021",14,14,0,165346.428571429,1823.07142857143,98.5
"9524","29036","2021",22,22,0,86252.2727272727,1102.40909090909,83.6818181818182
"9525","29037","2021",72,67,5,348966.041666667,2944.25,117.819444444444
"9526","29038","2021",25,24,1,106548.52,1300,89.32
"9527","29039","2021",346,205,141,230341.560693642,2679.96242774566,85.7312138728324
"9528","29040","2021",55,49,6,285661,2780.43636363636,103.236363636364
"9529","29041","2021",22,22,0,117931.818181818,1237.40909090909,96.3636363636364
"9530","29042","2021",148,108,40,214185.844594595,2668.77702702703,85.6689189189189
"9531","29043","2021",25,25,0,188680,1739.08,110.88
"9532","29044","2021",15,15,0,121750.4,1325.93333333333,96.4
"9533","29045","2021",29,29,0,209652.379310345,1862.96551724138,112.413793103448
"9534","29046","2021",246,162,84,162396.573170732,1950.5406504065,85.4715447154472
"9535","29047","2021",25,25,0,166832.8,1721.88,101.52
"9536","29048","2021",37,37,0,154907.324324324,1642.7027027027,104
"9537","29049","2021",47,47,0,161349.127659574,1635.57446808511,110.106382978723
"9538","29051","2021",72,72,0,195747.888888889,1943.59722222222,103.083333333333
"9539","29053","2021",24,24,0,143782.083333333,1528.625,100.666666666667
"9540","29054","2021",17,17,0,94482.3529411765,1141.58823529412,83.8235294117647
"9541","29055","2021",41,39,2,162193.195121951,1650.82926829268,101.439024390244
"9542","29056","2021",23,23,0,216736.347826087,2113.13043478261,101.95652173913
"9543","29057","2021",55,48,7,318366.690909091,2908.36363636364,110.8
"9544","29058","2021",171,115,56,281613.450292398,3043.54970760234,93.9941520467836
"9545","29059","2021",14,14,0,166639.285714286,1787.21428571429,93.5
"9546","29060","2021",35,34,1,231495.457142857,2057.8,116.8
"9547","29061","2021",74,65,9,250693.175675676,2333.51351351351,109.945945945946
"9548","29062","2021",13,13,0,100530.692307692,1246.53846153846,84.3076923076923
"9549","29063","2021",8,8,0,163736.875,1944,88
"9550","29064","2021",12,12,0,145519.666666667,1605.41666666667,104.583333333333
"9551","29065","2021",12,12,0,180122,1887.91666666667,103.75
"9552","29066","2021",28,28,0,196683.928571429,1594.53571428571,122.607142857143
"9553","29067","2021",35,35,0,102852.571428571,1063.88571428571,101.4
"9554","29068","2021",46,46,0,145993.804347826,1403.65217391304,106.369565217391
"9555","29069","2021",104,91,13,211434.086538462,2128.35576923077,100.721153846154
"9556","29070","2021",5,5,0,189926,1545.4,125.4
"9557","29071","2021",8,8,0,152500,1433,103.375
"9558","29072","2021",77,64,13,179836.142857143,2170.76623376623,85.8571428571429
"9559","29073","2021",21,21,0,187105.142857143,1764.95238095238,104.857142857143
"9560","29074","2021",22,22,0,135836.363636364,1416.95454545455,94.0454545454545
"9561","29075","2021",187,164,23,242790.802139037,2448.33689839572,99.8181818181818
"9562","29076","2021",48,48,0,203572.083333333,1929.875,107.3125
"9563","29077","2021",31,31,0,188319.580645161,1918.45161290323,107.548387096774
"9564","29078","2021",31,30,1,180105.483870968,1737.25806451613,104.709677419355
"9565","29079","2021",26,26,0,158338.038461538,1615.88461538462,99.8461538461538
"9566","29080","2021",40,40,0,169349.55,1721.025,97.5
"9567","29081","2021",43,41,2,104119.534883721,1098.13953488372,98.7209302325581
"9568","29082","2021",11,11,0,240063.636363636,2760.72727272727,89.7272727272727
"9569","29085","2021",22,17,5,254553.636363636,3531.36363636364,75.2272727272727
"9570","29086","2021",19,18,1,190323.315789474,1893.73684210526,104.210526315789
"9571","29087","2021",6,6,0,121221.666666667,1472.33333333333,83.3333333333333
"9572","29089","2021",13,13,0,101875.153846154,1168,86.2307692307692
"9573","29090","2021",11,11,0,150863.636363636,1414.63636363636,120.545454545455
"9574","29091","2021",50,50,0,216861.46,2176.62,109.56
"9575","29093","2021",27,27,0,161398.148148148,1686.18518518519,98.5185185185185
"9576","29094","2021",12,12,0,195745.083333333,1588.66666666667,124.583333333333
"9577","29095","2021",19,19,0,249745.789473684,2154.36842105263,118.736842105263
"9578","29097","2021",36,36,0,138531.555555556,1269.13888888889,106.722222222222
"9579","29098","2021",38,34,4,196413.552631579,2333.23684210526,91.9473684210526
"9580","29099","2021",11,11,0,263603.636363636,2009.90909090909,135.181818181818
"9581","29101","2021",55,53,2,229479.8,2290.36363636364,102.454545454545
"9582","29102","2021",25,25,0,111326,1095.48,96.96
"9583","29103","2021",256,160,96,179644.890625,2038.01953125,89.43359375
"9584","29104","2021",6,6,0,168683.333333333,1473.33333333333,127.333333333333
"9585","29105","2021",191,148,43,135923.832460733,1548.4554973822,88.7696335078534
"9586","29106","2021",12,12,0,166744.75,1652.33333333333,100.583333333333
"9587","29107","2021",9,9,0,181044.555555556,1735.11111111111,105.888888888889
"9588","29108","2021",22,22,0,158315.136363636,1445.77272727273,110.318181818182
"9589","29109","2021",27,26,1,228082.222222222,2286.51851851852,103.444444444444
"9590","29110","2021",17,17,0,142442.117647059,1368.47058823529,103.705882352941
"9591","29111","2021",18,18,0,129396.611111111,1469.72222222222,90
"9592","29112","2021",15,14,1,233443.333333333,2893.53333333333,87.8666666666667
"9593","29113","2021",44,42,2,158478.636363636,1649.75,94.4090909090909
"9594","29114","2021",15,15,0,96900,1165.6,87.9333333333333
"9595","29115","2021",1,1,0,52000,531,98
"9596","29117","2021",87,73,14,196158.206896552,2151.16091954023,97.8390804597701
"9597","29119","2021",20,19,1,195582.7,1855.05,107.55
"9598","29120","2021",40,36,4,149495.25,1527.85,98.575
"9599","29122","2021",7,7,0,62728.7142857143,948,69.4285714285714
"9600","29123","2021",16,16,0,133042.9375,1237.625,105.4375
"9601","29124","2021",145,102,43,148625.248275862,1720.07586206897,88.2551724137931
"9602","29125","2021",16,16,0,99381.25,944.1875,111.75
"9603","29126","2021",2,2,0,171000,1828,93.5
"9604","29128","2021",6,6,0,152757.833333333,1315.83333333333,127.5
"9605","29130","2021",57,52,5,265009,2572.01754385965,101.19298245614
"9606","29131","2021",5,5,0,111700,1023,102.4
"9607","29132","2021",13,13,0,217706.538461538,2342.69230769231,94.0769230769231
"9608","29133","2021",43,41,2,280888.953488372,2920.09302325581,97.0930232558139
"9609","29134","2021",7,7,0,214583.714285714,1666.85714285714,131.428571428571
"9610","29135","2021",85,78,7,258332.647058824,2661.68235294118,99.5529411764706
"9611","29136","2021",22,20,2,155609.545454545,1374.04545454545,116.909090909091
"9612","29137","2021",30,30,0,204388.333333333,1986.13333333333,102.9
"9613","29139","2021",8,8,0,104262.5,1312.75,88.5
"9614","29140","2021",62,62,0,247113.790322581,2117.14516129032,116.870967741935
"9615","29141","2021",14,14,0,72285.7142857143,916.857142857143,77.9285714285714
"9616","29142","2021",3,3,0,150166.666666667,1362.33333333333,113
"9617","29143","2021",7,7,0,145742.857142857,1568.71428571429,95.1428571428571
"9618","29144","2021",14,14,0,155378.571428571,1464.14285714286,110.714285714286
"9619","29145","2021",13,13,0,179277.692307692,1621.53846153846,116.769230769231
"9620","29146","2021",40,38,2,207734.25,2007.125,103.25
"9621","29147","2021",38,36,2,193794.052631579,1936.31578947368,103.236842105263
"9622","29148","2021",19,19,0,142317.894736842,1456.73684210526,98.8421052631579
"9623","29150","2021",121,108,13,240762.669421488,2530.76859504132,97.8760330578512
"9624","29151","2021",389,188,201,116885.845758355,1451.96658097686,80.1233933161954
"9625","29152","2021",11,11,0,66635.4545454545,811.545454545455,81
"9626","29153","2021",49,43,6,266309.510204082,2834.26530612245,103.081632653061
"9627","29155","2021",21,20,1,234109.238095238,3282.7619047619,82.6190476190476
"9628","29156","2021",31,31,0,223420.483870968,2001.03225806452,115
"9629","29158","2021",102,92,10,194957.539215686,2124.54901960784,94.2647058823529
"9630","29159","2021",9,9,0,177577.777777778,2527.44444444444,79.5555555555556
"9631","29160","2021",116,102,14,182455.129310345,1939.99137931034,95.7586206896552
"9632","29161","2021",38,36,2,223870.578947368,2208.97368421053,104.684210526316
"9633","29162","2021",52,52,0,132051.826923077,1294.44230769231,99.6346153846154
"9634","29163","2021",65,63,2,124261.692307692,1201.89230769231,107.246153846154
"9635","29165","2021",72,66,6,229183.111111111,2344.86111111111,101.375
"9636","29166","2021",8,7,1,172812.5,2246.5,109.625
"9637","29167","2021",17,17,0,170320.352941176,1814.35294117647,95.2941176470588
"9638","29168","2021",28,28,0,168900.142857143,2098.78571428571,83
"9639","29169","2021",30,29,1,158298.366666667,1573.86666666667,105.466666666667
"9640","29170","2021",42,42,0,259331.19047619,2043.28571428571,126.47619047619
"9641","29171","2021",54,54,0,228695.092592593,2101.57407407407,110.296296296296
"9642","29172","2021",41,37,4,158015.219512195,1590.70731707317,100.682926829268
"9643","29173","2021",23,23,0,165953.260869565,1737.60869565217,99.1739130434783
"9644","29174","2021",77,76,1,193468.857142857,1939.83116883117,101.181818181818
"9645","29175","2021",41,41,0,78948.9268292683,944.292682926829,85.5853658536585
"9646","29176","2021",19,19,0,170876.315789474,1453.15789473684,113.421052631579
"9647","29177","2021",63,63,0,240593.793650794,2384.28571428571,104.047619047619
"9648","29178","2021",95,89,6,219606.368421053,2092.42105263158,105.410526315789
"9649","29179","2021",50,50,0,197370.12,1753.7,116.68
"9650","29180","2021",13,13,0,159038.846153846,1581,104.615384615385
"9651","29181","2021",27,26,1,183561.851851852,1843.88888888889,99.6296296296296
"9652","29182","2021",15,15,0,126923.333333333,1727.66666666667,73.7333333333333
"9653","29183","2021",15,15,0,133030,1428.8,96.2666666666667
"9654","29184","2021",35,35,0,158212.4,1523.57142857143,108.771428571429
"9655","29185","2021",88,83,5,198076.875,1745.25,115.556818181818
"9656","29186","2021",24,24,0,213398.625,2311.41666666667,93.5833333333333
"9657","29187","2021",10,10,0,177361.4,1581,116.5
"9658","29188","2021",77,69,8,218287.818181818,2397.2987012987,94.8571428571429
"9659","29189","2021",194,169,25,251270.25257732,2388.17525773196,106
"9660","29190","2021",64,47,17,244827.265625,2843.21875,90.875
"9661","29191","2021",53,53,0,137678.622641509,1408.75471698113,96.9056603773585
"9662","29192","2021",35,35,0,180655.857142857,1628.25714285714,107.6
"9663","29193","2021",19,19,0,170011.842105263,1373.68421052632,127.368421052632
"9664","29195","2021",140,127,13,208890.178571429,2181.12857142857,96.1857142857143
"9665","29196","2021",39,38,1,153204.820512821,1547.76923076923,103.358974358974
"9666","29197","2021",84,77,7,198601.071428571,2163.05952380952,93.3214285714286
"9667","29198","2021",46,46,0,160672.304347826,1380.41304347826,117.5
"9668","29199","2021",80,80,0,161477.85,1637.85,100.125
"9669","29201","2021",35,35,0,210505.542857143,2142.68571428571,108.057142857143
"9670","29202","2021",32,32,0,106745.3125,1152.90625,95.625
"9671","29204","2021",34,34,0,163474.705882353,1493.61764705882,110.823529411765
"9672","29205","2021",12,12,0,120875,1133.08333333333,107.166666666667
"9673","29206","2021",34,34,0,153578.676470588,1568.88235294118,103.470588235294
"9674","29207","2021",63,62,1,158960.634920635,1565.03174603175,102.777777777778
"9675","29208","2021",25,24,1,187317.36,1789.92,103.28
"9676","29209","2021",37,37,0,168398.054054054,1687.7027027027,100.837837837838
"9677","29210","2021",61,61,0,152577.180327869,1319.67213114754,122.098360655738
"9678","29211","2021",23,23,0,75864.3913043478,939,83.4782608695652
"9679","29212","2021",180,167,13,215060.577777778,2109.35555555556,102.416666666667
"9680","29213","2021",36,36,0,141016.5,1536.41666666667,96.0555555555556
"9681","29214","2021",10,10,0,328153.6,2472.3,118.2
"9682","29215","2021",52,51,1,203269.25,1878.38461538462,108.384615384615
"9683","29216","2021",40,40,0,223441.25,2146.725,106.975
"9684","29217","2021",47,40,7,169208.70212766,2039.59574468085,87.8510638297872
"9685","29218","2021",35,23,12,141398.257142857,1864.4,80.4857142857143
"9686","29220","2021",175,112,63,166041.445714286,2116.90857142857,80.3542857142857
"9687","29221","2021",31,31,0,233602.419354839,2438.8064516129,104.064516129032
"9688","29222","2021",9,6,3,94333.4444444444,849,112.777777777778
"9689","29224","2021",11,11,0,139991.818181818,1374.27272727273,101.636363636364
"9690","29225","2021",24,24,0,173184,1689.25,109.291666666667
"9691","29226","2021",14,14,0,205000,1877.92857142857,106.142857142857
"9692","29227","2021",33,33,0,95245.4545454545,1064.18181818182,93.6060606060606
"9693","29228","2021",22,22,0,196383.636363636,2170.13636363636,89.9090909090909
"9694","29229","2021",16,15,1,128312.375,1362.5,98.3125
"9695","29230","2021",27,27,0,166738.518518519,1498.88888888889,113.259259259259
"9696","29232","2021",1374,578,796,148381.434497817,1920.06841339156,76.8245997088792
"9697","29233","2021",173,130,43,162969.502890173,1789.90173410405,92.5433526011561
"9698","29234","2021",35,35,0,220194.485714286,2025.25714285714,113.4
"9699","29235","2021",153,112,41,242467.68627451,2627.92156862745,90.5686274509804
"9700","29236","2021",52,51,1,211191.057692308,1913.01923076923,112.461538461538
"9701","29237","2021",26,25,1,165950,1540.76923076923,110.346153846154
"9702","29238","2021",25,25,0,229145,2229.52,102.48
"9703","29239","2021",75,42,33,209565.84,2658.68,79.96
"9704","29240","2021",8,8,0,222125,2297.5,93.875
"9705","29241","2021",119,104,15,145964.907563025,1595.21848739496,91.9243697478992
"9706","29243","2021",6,6,0,222033.333333333,1936.83333333333,120.666666666667
"9707","29244","2021",19,19,0,110571.052631579,1164.89473684211,95.2105263157895
"9708","29245","2021",19,19,0,221154.210526316,1841.26315789474,120.631578947368
"9709","29246","2021",3,3,0,142133.333333333,2542.66666666667,71
"9710","29247","2021",36,36,0,224081.388888889,2161.13888888889,102.5
"9711","29248","2021",11,11,0,138126.818181818,1612.36363636364,87.0909090909091
"9712","29249","2021",13,13,0,93468.3846153846,1085.38461538462,89.8461538461538
"9713","29250","2021",20,20,0,88329,990.9,90.4
"9714","29251","2021",11,11,0,220690.909090909,1798.54545454545,126.181818181818
"9715","29252","2021",14,14,0,215185.857142857,2335.35714285714,100.785714285714
"9716","29254","2021",82,73,9,126970.914634146,1442.78048780488,89.3170731707317
"9717","29255","2021",14,14,0,204893.928571429,1898.35714285714,108.428571428571
"9718","29256","2021",34,15,19,122203.235294118,2380.94117647059,57.2058823529412
"9719","29257","2021",31,31,0,251918.580645161,2242.38709677419,111.290322580645
"9720","29259","2021",144,119,25,164584.416666667,1718.55555555556,98.5833333333333
"9721","29260","2021",111,79,32,205294.09009009,2235.91891891892,95.8468468468468
"9722","29261","2021",3,3,0,95333.3333333333,1016.66666666667,94
"9723","29262","2021",20,20,0,93896.85,1024.1,99.7
"9724","29263","2021",9,9,0,177632.222222222,1564.77777777778,105.222222222222
"9725","29264","2021",14,14,0,149557.142857143,1451.78571428571,104.571428571429
"9726","29265","2021",12,12,0,158375,1680.25,97
"9727","29266","2021",50,50,0,138458.54,1455.58,99.5
"9728","29267","2021",18,18,0,104622.111111111,1076.72222222222,95.3888888888889
"9729","29268","2021",30,30,0,259408.066666667,2205.06666666667,122.433333333333
"9730","29269","2021",13,13,0,141019.230769231,1539.46153846154,91.7692307692308
"9731","29270","2021",23,23,0,198398.695652174,1894.82608695652,105.826086956522
"9732","29271","2021",13,13,0,158365.307692308,1223.38461538462,126.153846153846
"9733","29272","2021",23,23,0,196364.652173913,1818.17391304348,107.565217391304
"9734","29273","2021",36,36,0,275962.138888889,2578.77777777778,104.111111111111
"9735","29274","2021",119,118,1,122144.294117647,1208.6974789916,101.705882352941
"9736","29275","2021",24,24,0,113827.083333333,1109,100.333333333333
"9737","29276","2021",22,22,0,199964.681818182,1733.22727272727,118.136363636364
"9738","29277","2021",39,39,0,133049.358974359,1236,108.74358974359
"9739","29278","2021",33,33,0,109810.757575758,1083.90909090909,99.9393939393939
"9740","29279","2021",42,41,1,146587.380952381,1358.42857142857,108.5
"9741","29280","2021",34,32,2,173000.588235294,1825.91176470588,96.7352941176471
"9742","29281","2021",17,17,0,137323.529411765,1339.94117647059,105.941176470588
"9743","29282","2021",6,6,0,215900,2239.16666666667,94.1666666666667
"9744","29284","2021",43,41,2,238080.651162791,2275.48837209302,106.06976744186
"9745","29285","2021",13,13,0,143622.307692308,1378.46153846154,102.230769230769
"9746","29286","2021",3,3,0,143790,1330,109.333333333333
"9747","29287","2021",15,15,0,200285.333333333,1878.53333333333,105.266666666667
"9748","29288","2021",8,8,0,201210.25,1702.5,121.125
"9749","29289","2021",4,4,0,85000,850,95
"9750","29290","2021",10,10,0,199090,1758.4,112.3
"9751","29291","2021",27,27,0,94750.0740740741,1140.88888888889,85.8148148148148
"9752","29292","2021",3,3,0,283400,2419.33333333333,116.333333333333
"9753","29293","2021",101,89,12,259519.811881188,2654.40594059406,97.4554455445545
"9754","29294","2021",6,6,0,124121.666666667,1210.83333333333,98.6666666666667
"9755","29295","2021",4,4,0,188525,1846.25,105.75
"9756","29296","2021",20,20,0,197871.45,1840.2,106.05
"9757","29297","2021",26,25,1,170457.692307692,1551.15384615385,108.346153846154
"9758","29298","2021",4,4,0,239125,1599.75,144.5
"9759","29299","2021",4,4,0,181112.75,2377.25,93.5
"9760","29300","2021",20,17,3,189925,1800.05,107.45
"9761","29301","2021",4,4,0,165100,1524.75,121.25
"9762","29302","2021",87,87,0,122318.965517241,1284.98850574713,92.2528735632184
"9763","2A001","2021",26,19,7,430205.769230769,3935.26923076923,113.538461538462
"9764","2A004","2021",965,46,919,260239.675647668,3666.90984455959,71.7937823834197
"9765","2A006","2021",30,25,5,407855.533333333,3667.56666666667,109.2
"9766","2A008","2021",40,16,24,446294.2,5652.025,83.2
"9767","2A017","2021",8,7,1,336693.75,4446.875,92.375
"9768","2A018","2021",2,1,1,108500,1909,57
"9769","2A019","2021",2,0,2,95000,1571.5,62.5
"9770","2A021","2021",1,0,1,36000,1200,30
"9771","2A024","2021",1,1,0,150000,2055,73
"9772","2A026","2021",2,1,1,191000,3133.5,53
"9773","2A028","2021",1,1,0,220000,1310,168
"9774","2A031","2021",3,1,2,122993.333333333,1663.66666666667,71.6666666666667
"9775","2A032","2021",26,19,7,460296.692307692,4223.42307692308,107.884615384615
"9776","2A035","2021",5,4,1,823970,6800.2,110.4
"9777","2A040","2021",6,2,4,123070,1828.16666666667,64.6666666666667
"9778","2A041","2021",48,22,26,516568,5248.14583333333,95.9791666666667
"9779","2A048","2021",22,10,12,184258.5,4023.36363636364,48.5
"9780","2A056","2021",1,1,0,111800,2033,55
"9781","2A061","2021",4,3,1,112628,1426,75.5
"9782","2A062","2021",2,2,0,295000,3067,96.5
"9783","2A065","2021",14,8,6,374083.571428571,4789.14285714286,87.6428571428571
"9784","2A066","2021",1,1,0,210000,2360,89
"9785","2A070","2021",14,4,10,271134.642857143,4370.07142857143,61.6428571428571
"9786","2A071","2021",1,0,1,130000,1806,72
"9787","2A085","2021",18,15,3,334065,3484.22222222222,96.2777777777778
"9788","2A089","2021",1,1,0,104181,1736,60
"9789","2A090","2021",13,8,5,360620,4607.92307692308,69.8461538461538
"9790","2A091","2021",1,0,1,90000,783,115
"9791","2A092","2021",23,8,15,287027.695652174,4162.86956521739,69.9130434782609
"9792","2A098","2021",26,25,1,878651.5,7481.19230769231,114.192307692308
"9793","2A099","2021",5,3,2,95120,1070.6,74.4
"9794","2A103","2021",11,7,4,323923.636363636,4063.90909090909,84.2727272727273
"9795","2A104","2021",12,12,0,415315,3830.83333333333,106
"9796","2A108","2021",6,3,3,113333.333333333,1833.83333333333,65.3333333333333
"9797","2A114","2021",8,7,1,386101.5,3368.125,108.875
"9798","2A115","2021",1,1,0,590700,3715,159
"9799","2A118","2021",1,0,1,25400,1104,23
"9800","2A127","2021",2,2,0,2e+05,3077,65
"9801","2A130","2021",107,40,67,413472.401869159,5619.46728971963,69.0467289719626
"9802","2A131","2021",3,3,0,94989.6666666667,723.333333333333,131.666666666667
"9803","2A133","2021",2,1,1,46000,941,44
"9804","2A139","2021",61,41,20,649627.573770492,6025.04918032787,98.016393442623
"9805","2A141","2021",2,2,0,72500,1577.5,49
"9806","2A142","2021",3,1,2,78666.6666666667,1560.66666666667,51.6666666666667
"9807","2A144","2021",4,3,1,106875,1834.25,63.5
"9808","2A154","2021",6,4,2,50500,969,57.1666666666667
"9809","2A160","2021",1,1,0,1e+05,1031,97
"9810","2A163","2021",5,2,3,103598,2319.6,42.6
"9811","2A174","2021",2,1,1,115000,2310,53
"9812","2A181","2021",4,4,0,271474.25,3977,68.5
"9813","2A186","2021",4,0,4,68317.5,1579.25,47.5
"9814","2A189","2021",12,7,5,378414.166666667,4198.25,87.25
"9815","2A191","2021",1,1,0,320000,2286,140
"9816","2A196","2021",1,0,1,71220,1424,50
"9817","2A197","2021",1,1,0,503700,10074,50
"9818","2A198","2021",9,1,8,137000,2607.77777777778,51.2222222222222
"9819","2A200","2021",1,1,0,35000,660,53
"9820","2A203","2021",2,1,1,96500,2404,43
"9821","2A204","2021",1,1,0,120000,876,137
"9822","2A209","2021",16,16,0,339204.6875,3186.75,103.5
"9823","2A211","2021",8,7,1,226876.25,2489.375,90.875
"9824","2A212","2021",2,0,2,46750,1039,49
"9825","2A215","2021",7,6,1,823235.714285714,6509.57142857143,116.714285714286
"9826","2A228","2021",47,27,20,463343,5334.74468085106,89.7659574468085
"9827","2A232","2021",3,3,0,141333.333333333,1697,102
"9828","2A247","2021",221,127,94,454668.221719457,5104.47963800905,87.1990950226244
"9829","2A249","2021",95,14,81,254002.031578947,3994.90526315789,65.7157894736842
"9830","2A254","2021",3,2,1,48566.6666666667,1246.66666666667,64.3333333333333
"9831","2A258","2021",4,3,1,130400,1823,68.5
"9832","2A259","2021",1,1,0,30000,429,70
"9833","2A262","2021",1,1,0,67855,1094,62
"9834","2A269","2021",39,13,26,325433.794871795,4055.10256410256,82.2051282051282
"9835","2A270","2021",2,1,1,65000,1357,48
"9836","2A271","2021",46,11,35,224776.847826087,3368,68.3695652173913
"9837","2A272","2021",42,15,27,238724.904761905,2899.61904761905,72.7619047619048
"9838","2A276","2021",10,3,7,328609.5,5179,77
"9839","2A278","2021",3,1,2,109166.666666667,1416.66666666667,75
"9840","2A279","2021",1,0,1,120000,2667,45
"9841","2A282","2021",7,3,4,110828.571428571,2046,57.2857142857143
"9842","2A284","2021",4,4,0,203312.5,2517,86.5
"9843","2A285","2021",1,1,0,97000,1702,57
"9844","2A288","2021",13,9,4,239645.846153846,3611.92307692308,75.6153846153846
"9845","2A295","2021",2,1,1,326239,2773.5,101
"9846","2A300","2021",12,12,0,403755,4116.91666666667,84.25
"9847","2A308","2021",6,4,2,240400,2663,91.3333333333333
"9848","2A312","2021",7,1,6,158285.714285714,2060.71428571429,81.7142857142857
"9849","2A322","2021",2,1,1,100950,1351,66
"9850","2A323","2021",3,3,0,240716.666666667,2392.66666666667,99
"9851","2A324","2021",3,3,0,186000,1897.66666666667,118.666666666667
"9852","2A326","2021",1,1,0,19000,655,29
"9853","2A330","2021",2,0,2,77500,800.5,80.5
"9854","2A331","2021",2,1,1,155250,1792,86.5
"9855","2A336","2021",4,4,0,322805.75,3343,95.75
"9856","2A345","2021",3,2,1,383926.666666667,4366,87.6666666666667
"9857","2A348","2021",10,5,5,286244.2,4130.5,78.3
"9858","2A349","2021",6,4,2,369833.333333333,3289.5,116.333333333333
"9859","2A351","2021",2,2,0,380125,4018,95
"9860","2A357","2021",2,2,0,91100,2069.5,40.5
"9861","2A359","2021",3,1,2,87333.3333333333,1231.66666666667,71.6666666666667
"9862","2A360","2021",1,1,0,213500,1369,156
"9863","2A362","2021",94,77,17,762934.659574468,5762.27659574468,117.574468085106
"9864","2A363","2021",3,3,0,138750,1983,71
"9865","2B002","2021",1,0,1,90485,1508,60
"9866","2B007","2021",2,1,1,95000,1283.5,64
"9867","2B009","2021",7,3,4,291650,2940.57142857143,99.7142857142857
"9868","2B010","2021",9,0,9,212962.222222222,5030.44444444444,43
"9869","2B015","2021",1,1,0,50000,833,60
"9870","2B020","2021",6,0,6,111436.666666667,2905.83333333333,41.1666666666667
"9871","2B025","2021",2,0,2,91500,2435.5,37.5
"9872","2B029","2021",2,2,0,527500,7550.5,101.5
"9873","2B030","2021",2,2,0,190010.5,2167,67.5
"9874","2B033","2021",346,21,325,186578.497109827,2781.22543352601,66.6098265895954
"9875","2B034","2021",19,9,10,213753.052631579,3721.31578947368,57.0526315789474
"9876","2B036","2021",1,1,0,266500,2098,127
"9877","2B037","2021",74,26,48,230157.513513514,2729.21621621622,85.3648648648649
"9878","2B039","2021",1,1,0,141900,2405,59
"9879","2B042","2021",118,39,79,193287.56779661,2990.39830508475,66.9661016949153
"9880","2B043","2021",20,9,11,293545.3,3762,81.05
"9881","2B047","2021",2,2,0,181850,2239,81.5
"9882","2B049","2021",21,13,8,245177.619047619,2938.61904761905,84.0952380952381
"9883","2B050","2021",121,12,109,206783.619834711,3949.09090909091,51.6611570247934
"9884","2B052","2021",1,1,0,36000,857,42
"9885","2B054","2021",4,2,2,83750,2110.75,45.75
"9886","2B055","2021",1,1,0,66000,1571,42
"9887","2B057","2021",5,3,2,204524,2638.8,76.4
"9888","2B058","2021",3,2,1,191290,3465.33333333333,79.6666666666667
"9889","2B063","2021",1,1,0,37000,378,98
"9890","2B074","2021",3,0,3,61833.3333333333,1270.33333333333,47.6666666666667
"9891","2B077","2021",6,4,2,188595,1980.66666666667,91.5
"9892","2B078","2021",1,0,1,27000,1038,26
"9893","2B079","2021",5,5,0,91000,1156.2,79.6
"9894","2B080","2021",4,4,0,98658.75,1709.5,70
"9895","2B082","2021",2,2,0,140000,1805.5,75.5
"9896","2B083","2021",2,1,1,210600,1750,111.5
"9897","2B084","2021",2,2,0,404100,4572,91.5
"9898","2B086","2021",1,1,0,617000,7712,80
"9899","2B087","2021",25,9,16,169744.16,2226,80.2
"9900","2B088","2021",2,2,0,264300,2926,86
"9901","2B093","2021",10,7,3,384690,4309.9,78.5
"9902","2B095","2021",1,0,1,62000,1000,62
"9903","2B096","2021",53,7,46,154019.433962264,2922.45283018868,57.2641509433962
"9904","2B107","2021",2,2,0,152850,2826.5,55
"9905","2B109","2021",2,2,0,495000,4809.5,102.5
"9906","2B112","2021",5,4,1,261480,2731.2,91.2
"9907","2B113","2021",2,1,1,175000,2959.5,59
"9908","2B116","2021",1,1,0,239000,2255,106
"9909","2B120","2021",35,15,20,266881.857142857,3178.11428571429,90.9142857142857
"9910","2B121","2021",5,3,2,238550,4061,102.4
"9911","2B122","2021",2,1,1,70000,1418.5,50
"9912","2B123","2021",27,16,11,216434.518518519,2402.81481481481,90.8888888888889
"9913","2B124","2021",2,0,2,140000,1359,103
"9914","2B126","2021",1,1,0,231650,3861,60
"9915","2B134","2021",70,2,68,210092.485714286,3914.58571428571,53.6714285714286
"9916","2B135","2021",3,2,1,75000,1509,50
"9917","2B138","2021",1,1,0,150000,1500,100
"9918","2B140","2021",1,0,1,87500,1944,45
"9919","2B143","2021",25,6,19,142710.48,2971.04,44.76
"9920","2B145","2021",2,1,1,43800,998,42.5
"9921","2B148","2021",72,37,35,213057.611111111,2861.93055555556,73.9305555555556
"9922","2B150","2021",44,13,31,357424.386363636,4826.52272727273,68.6136363636364
"9923","2B152","2021",8,4,4,182325,2401.125,79.625
"9924","2B155","2021",1,1,0,83500,1740,48
"9925","2B156","2021",1,1,0,110000,1667,66
"9926","2B159","2021",3,2,1,192000,3068.33333333333,62.3333333333333
"9927","2B161","2021",1,1,0,66000,1650,40
"9928","2B162","2021",3,3,0,220000,2903.66666666667,70
"9929","2B165","2021",3,1,2,256666.666666667,10208.3333333333,25.3333333333333
"9930","2B166","2021",2,1,1,189765,2637.5,74
"9931","2B167","2021",5,4,1,226982,3659.4,61
"9932","2B168","2021",27,12,15,342085.740740741,4312.11111111111,78.8518518518518
"9933","2B169","2021",2,1,1,112645.5,1928.5,57.5
"9934","2B170","2021",6,5,1,250641.666666667,2806.33333333333,106.833333333333
"9935","2B172","2021",2,2,0,55000,1194.5,44
"9936","2B173","2021",1,1,0,840000,6000,140
"9937","2B178","2021",1,1,0,150000,2027,74
"9938","2B182","2021",1,1,0,555000,3675,151
"9939","2B185","2021",31,15,16,370060.741935484,4095.83870967742,82.6774193548387
"9940","2B188","2021",6,6,0,266771.333333333,3112.83333333333,92.3333333333333
"9941","2B190","2021",4,4,0,125619.5,1782.5,72.5
"9942","2B192","2021",1,0,1,87000,1642,53
"9943","2B193","2021",6,5,1,167250.833333333,1895.33333333333,84.8333333333333
"9944","2B195","2021",1,1,0,50000,1667,30
"9945","2B199","2021",2,2,0,429636.5,3795.5,93
"9946","2B201","2021",1,1,0,125000,1389,90
"9947","2B205","2021",8,5,3,227232.5,3953,63.5
"9948","2B207","2021",27,9,18,173792.222222222,2318.2962962963,73.8148148148148
"9949","2B210","2021",1,0,1,70000,972,72
"9950","2B218","2021",1,0,1,40000,2000,20
"9951","2B222","2021",1,1,0,55000,688,80
"9952","2B224","2021",10,7,3,239892.5,3242,71.6
"9953","2B229","2021",1,1,0,280000,3043,92
"9954","2B230","2021",2,1,1,80500,1615,50
"9955","2B231","2021",1,0,1,450000,7500,60
"9956","2B233","2021",1,1,0,8e+05,6452,124
"9957","2B236","2021",2,1,1,92800,1522,59
"9958","2B239","2021",2,2,0,506950,3690.5,141
"9959","2B242","2021",34,24,10,144548.823529412,3181.26470588235,51.6176470588235
"9960","2B244","2021",2,2,0,134000,1715,73
"9961","2B245","2021",1,1,0,50000,926,54
"9962","2B246","2021",1,0,1,33675,748,45
"9963","2B250","2021",3,0,3,93166.6666666667,1354.33333333333,69
"9964","2B251","2021",26,20,6,211794.846153846,2504.34615384615,85.8846153846154
"9965","2B252","2021",2,1,1,77500,1474,46
"9966","2B255","2021",1,0,1,70000,1458,48
"9967","2B257","2021",3,3,0,234000,3153.33333333333,70.3333333333333
"9968","2B260","2021",2,2,0,174250,1700,106.5
"9969","2B261","2021",9,6,3,185777.777777778,2681,78.7777777777778
"9970","2B265","2021",2,2,0,232500,3291.5,75
"9971","2B277","2021",1,1,0,2e+05,4545,44
"9972","2B280","2021",1,0,1,40000,800,50
"9973","2B281","2021",18,13,5,270499.277777778,3459.61111111111,84.8888888888889
"9974","2B283","2021",7,6,1,311004.285714286,3605.28571428571,83
"9975","2B286","2021",4,2,2,87750,1716.25,67.25
"9976","2B287","2021",4,4,0,55812.5,1234,47.25
"9977","2B292","2021",1,1,0,110000,1571,70
"9978","2B293","2021",2,1,1,258817,2459.5,100
"9979","2B298","2021",33,9,24,280546.96969697,4129.06060606061,71.8787878787879
"9980","2B303","2021",4,3,1,245000,4184.25,84.75
"9981","2B305","2021",32,8,24,230226.75,3178.28125,72.0625
"9982","2B307","2021",19,9,10,184681.578947368,2476.47368421053,78.8421052631579
"9983","2B309","2021",9,4,5,335841.555555556,3319.77777777778,90.1111111111111
"9984","2B311","2021",18,14,4,206263.277777778,3389.38888888889,71.1666666666667
"9985","2B313","2021",59,13,46,133814.813559322,2633.89830508475,52.271186440678
"9986","2B314","2021",1,1,0,410400,2565,160
"9987","2B316","2021",10,3,7,300199,3806.8,78.7
"9988","2B317","2021",1,1,0,126000,1575,80
"9989","2B318","2021",2,2,0,948500,7325.5,121.5
"9990","2B319","2021",5,3,2,166480,2491.4,73.8
"9991","2B320","2021",2,2,0,149820,1781,93.5
"9992","2B327","2021",3,2,1,161000,2002.33333333333,82
"9993","2B328","2021",1,0,1,90000,750,120
"9994","2B329","2021",1,1,0,65000,1083,60
"9995","2B332","2021",1,1,0,66500,3325,20
"9996","2B334","2021",1,1,0,90000,1875,48
"9997","2B335","2021",3,2,1,86666.6666666667,1673.66666666667,52.6666666666667
"9998","2B340","2021",6,5,1,212760,2254.66666666667,93.5
"9999","2B341","2021",5,3,2,121200,1472.6,94.4
"10000","2B342","2021",7,7,0,250864.285714286,2580,97.5714285714286
"10001","2B343","2021",11,8,3,182255.454545455,2608.09090909091,73.3636363636364
"10002","2B346","2021",16,12,4,216390.5625,2392.75,88.6875
"10003","2B347","2021",2,1,1,160000,1604,100
"10004","2B352","2021",3,3,0,186977.666666667,1673,110
"10005","2B353","2021",64,5,59,247485.03125,3082.40625,81.15625
"10006","2B354","2021",3,2,1,153333.333333333,1378,102.666666666667
"10007","2B355","2021",1,1,0,145000,2377,61
"10008","2B356","2021",2,2,0,155000,1855.5,82.5
"10009","2B361","2021",3,2,1,135726.333333333,2269.66666666667,72.3333333333333
"10010","2B364","2021",1,0,1,68000,1360,50
"10011","2B365","2021",2,1,1,39000,790,49.5
"10012","30001","2021",3,3,0,475810,3160.33333333333,151
"10013","30002","2021",8,8,0,252328.375,2058.125,120.5
"10014","30003","2021",201,153,48,284185.791044776,3627.89552238806,82.5323383084577
"10015","30004","2021",22,21,1,218213.863636364,2272.81818181818,103.590909090909
"10016","30005","2021",1,1,0,880000,6286,140
"10017","30006","2021",112,100,12,259573.616071429,2761.58035714286,95.0446428571429
"10018","30007","2021",652,304,348,134399.124233129,1712.50460122699,77.7407975460123
"10019","30008","2021",15,15,0,153613.866666667,1883.13333333333,79.3333333333333
"10020","30009","2021",3,3,0,120101.666666667,1373.66666666667,78
"10021","30010","2021",53,40,13,225644.188679245,2355.35849056604,90.2075471698113
"10022","30011","2021",178,104,74,281087.674157303,3108.23595505618,88.2808988764045
"10023","30012","2021",67,52,15,202225.074626866,2371.88059701493,87.8208955223881
"10024","30013","2021",8,8,0,437215.625,2888.625,172.125
"10025","30014","2021",25,25,0,275364.92,2643.96,98.6
"10026","30015","2021",2,2,0,94000,1666.5,70
"10027","30016","2021",6,5,1,100483.333333333,1229.66666666667,74.6666666666667
"10028","30017","2021",5,4,1,163719,1503.2,108.4
"10029","30018","2021",5,4,1,297518,3224.4,101.6
"10030","30019","2021",47,42,5,335013.021276596,3128.14893617021,107.340425531915
"10031","30020","2021",19,18,1,258506.631578947,2470.47368421053,101.631578947368
"10032","30021","2021",10,10,0,630807.5,3655.3,151.9
"10033","30022","2021",3,3,0,229940.333333333,1806.33333333333,122
"10034","30023","2021",13,13,0,300922.692307692,2890.38461538462,106.307692307692
"10035","30024","2021",7,4,3,135753.571428571,1512,79.2857142857143
"10036","30025","2021",9,8,1,98081.6666666667,1267.44444444444,85.2222222222222
"10037","30026","2021",28,24,4,126241.428571429,1379.28571428571,96.6071428571429
"10038","30027","2021",33,33,0,267023.181818182,2329.12121212121,116.666666666667
"10039","30028","2021",258,149,109,168058.96124031,1879.71705426357,86.0426356589147
"10040","30029","2021",36,28,8,195439.583333333,1973.16666666667,93.9444444444444
"10041","30030","2021",5,5,0,233790,2317.2,112.2
"10042","30031","2021",10,10,0,399838,3380.1,116.9
"10043","30032","2021",184,125,59,171374.336956522,1886.33152173913,89.1358695652174
"10044","30033","2021",88,80,8,258827.386363636,2569.17045454545,102.454545454545
"10045","30034","2021",83,75,8,235596.879518072,2647.14457831325,90.4578313253012
"10046","30035","2021",6,6,0,261120,2419.83333333333,100.333333333333
"10047","30036","2021",63,53,10,226372.142857143,2416.65079365079,98.0952380952381
"10048","30037","2021",43,26,17,117810.348837209,1277.86046511628,92.7209302325581
"10049","30038","2021",7,3,4,103481.428571429,1218.57142857143,79.1428571428571
"10050","30039","2021",40,37,3,211775.075,2061.95,104.725
"10051","30040","2021",4,4,0,120375,1773.25,73.75
"10052","30041","2021",28,28,0,355226.821428571,2804.60714285714,123.178571428571
"10053","30042","2021",42,41,1,264713.857142857,2368.64285714286,114.047619047619
"10054","30043","2021",11,11,0,242372.727272727,2635.54545454545,103.454545454545
"10055","30044","2021",3,3,0,49333.3333333333,1044.33333333333,46.6666666666667
"10056","30045","2021",1,1,0,80000,1231,65
"10057","30046","2021",12,11,1,171158.333333333,1857.5,94.4166666666667
"10058","30047","2021",82,68,14,237919,2520.34146341463,92.1341463414634
"10059","30048","2021",6,6,0,460725,3134,152.166666666667
"10060","30049","2021",8,8,0,395337.25,2725,136.375
"10061","30050","2021",3,3,0,181366.666666667,1906.33333333333,92.3333333333333
"10062","30051","2021",18,14,4,151602.777777778,1397.77777777778,103.333333333333
"10063","30052","2021",14,12,2,155757.142857143,2041.14285714286,82.9285714285714
"10064","30053","2021",7,6,1,226316.428571429,2071,109.428571428571
"10065","30054","2021",7,7,0,367871.428571429,3024.71428571429,129
"10066","30055","2021",18,17,1,260706.666666667,2305.88888888889,114.055555555556
"10067","30056","2021",10,10,0,478999.1,3710.5,131.2
"10068","30057","2021",24,24,0,272208.166666667,2755.5,103.833333333333
"10069","30058","2021",1,1,0,310000,1914,162
"10070","30059","2021",31,30,1,243285.967741935,2577.32258064516,97.0967741935484
"10071","30060","2021",40,39,1,264536.525,2819.55,97.225
"10072","30061","2021",42,34,8,198540.357142857,2211.80952380952,89.3571428571429
"10073","30062","2021",149,85,64,217977.255033557,2807.18791946309,76.758389261745
"10074","30064","2021",6,6,0,89908.3333333333,1306.5,73.3333333333333
"10075","30065","2021",9,9,0,269272.222222222,2126.33333333333,128.111111111111
"10076","30066","2021",14,14,0,275587.142857143,2203.28571428571,123.357142857143
"10077","30067","2021",12,11,1,286945.833333333,2650,108.583333333333
"10078","30068","2021",21,21,0,221146.142857143,2050.52380952381,109.857142857143
"10079","30069","2021",4,4,0,291127.5,2553.25,110.75
"10080","30070","2021",10,10,0,257960.5,2386.9,114.2
"10081","30071","2021",5,4,1,206212,2057,123.6
"10082","30072","2021",7,7,0,308427.142857143,2631.71428571429,118.714285714286
"10083","30073","2021",28,27,1,411653.75,3575.85714285714,129.178571428571
"10084","30075","2021",67,64,3,265724.910447761,2913.4776119403,95.5820895522388
"10085","30076","2021",14,14,0,230108.928571429,2976.78571428571,93.7857142857143
"10086","30077","2021",14,14,0,194555.357142857,1650.5,112.642857142857
"10087","30079","2021",8,8,0,166822.5,1734.875,93.75
"10088","30080","2021",23,14,9,86430.4347826087,1274.08695652174,70.2608695652174
"10089","30081","2021",20,19,1,201221,2227.75,94.05
"10090","30082","2021",88,76,12,261790.875,2675.07954545455,99.4886363636364
"10091","30083","2021",40,35,5,258701.25,2755.325,100.05
"10092","30084","2021",6,6,0,181250,2105.16666666667,105.666666666667
"10093","30085","2021",23,22,1,313884.434782609,2780.47826086957,111.434782608696
"10094","30086","2021",11,11,0,229618.363636364,2427.72727272727,99.9090909090909
"10095","30087","2021",3,3,0,71666.6666666667,1336.33333333333,67
"10096","30088","2021",11,11,0,256348.181818182,2361.18181818182,121.090909090909
"10097","30089","2021",25,24,1,234501.64,2249.68,106.48
"10098","30090","2021",10,10,0,160552.5,1817.4,83.5
"10099","30091","2021",20,18,2,250663.9,2377.5,103.85
"10100","30092","2021",23,23,0,220228.391304348,2315.95652173913,99.8695652173913
"10101","30093","2021",1,1,0,284400,3386,84
"10102","30094","2021",5,2,3,201015,4223.6,53.2
"10103","30095","2021",14,14,0,290487.642857143,2206.57142857143,138.571428571429
"10104","30096","2021",13,13,0,234561.461538462,2114.07692307692,117.923076923077
"10105","30097","2021",6,6,0,200583.333333333,1832.33333333333,105.5
"10106","30098","2021",6,6,0,312350,2370,144.333333333333
"10107","30099","2021",9,9,0,313450.333333333,2550.77777777778,131.111111111111
"10108","30100","2021",15,13,2,211418.733333333,2081.13333333333,105.2
"10109","30101","2021",14,14,0,242567.857142857,1943.5,123.571428571429
"10110","30102","2021",17,17,0,258790.352941176,2368.17647058824,112.117647058824
"10111","30103","2021",11,10,1,298040.909090909,2194.09090909091,131.363636363636
"10112","30104","2021",6,6,0,231391.666666667,2273.5,102.666666666667
"10113","30105","2021",5,5,0,70300,1204.4,54.6
"10114","30106","2021",15,14,1,194279,2043.26666666667,93.4666666666667
"10115","30107","2021",7,6,1,276078.571428571,3080.57142857143,90.1428571428571
"10116","30108","2021",6,6,0,139325,1401.5,114.833333333333
"10117","30109","2021",4,4,0,251825,2061,118
"10118","30110","2021",4,4,0,328311,2431.5,137.75
"10119","30111","2021",6,6,0,302451.666666667,2581.66666666667,115.833333333333
"10120","30112","2021",22,21,1,236853.636363636,2422.22727272727,99.5454545454545
"10121","30113","2021",5,4,1,310000,1650.2,170.6
"10122","30114","2021",9,9,0,285092.222222222,2666.55555555556,110.666666666667
"10123","30115","2021",9,9,0,434466.666666667,3123.11111111111,142.222222222222
"10124","30116","2021",20,20,0,225942.05,2601.95,90.9
"10125","30117","2021",25,14,11,188611.6,2594.68,74.12
"10126","30119","2021",6,5,1,233429,2734,108.5
"10127","30120","2021",19,17,2,166350.947368421,1792.21052631579,88.7894736842105
"10128","30121","2021",5,5,0,202740,1926.6,108.8
"10129","30122","2021",4,4,0,159792.5,2013.25,79.5
"10130","30123","2021",64,59,5,263677.75,2854.09375,92.828125
"10131","30124","2021",4,4,0,261736.25,2530.25,98.75
"10132","30125","2021",64,51,13,227615.703125,2470.96875,93.8125
"10133","30126","2021",8,8,0,313986.75,2979.875,108.5
"10134","30127","2021",15,15,0,245575,2328.46666666667,106.466666666667
"10135","30128","2021",67,56,11,231213.582089552,2378.16417910448,93.7164179104478
"10136","30129","2021",13,13,0,254234.615384615,2717.84615384615,101.153846153846
"10137","30130","2021",18,16,2,121821.277777778,1380.66666666667,86.4444444444444
"10138","30131","2021",17,17,0,244628.529411765,2255.23529411765,115.823529411765
"10139","30132","2021",50,33,17,92513.12,1145.3,80.6
"10140","30133","2021",1120,70,1050,177214.317857143,4592.27142857143,38.4821428571429
"10141","30134","2021",14,14,0,293776.857142857,2201.57142857143,139.285714285714
"10142","30135","2021",53,40,13,199236.018867925,2131.75471698113,94.1132075471698
"10143","30136","2021",21,20,1,226164.19047619,2902.90476190476,81.8571428571429
"10144","30138","2021",27,24,3,348030.259259259,2934.44444444444,120.111111111111
"10145","30139","2021",3,3,0,95000,1343,74
"10146","30140","2021",21,18,3,159454.333333333,1682.19047619048,100.428571428571
"10147","30141","2021",71,65,6,242082.535211268,2531,99.6760563380282
"10148","30142","2021",9,7,2,128303.222222222,1371.33333333333,85.3333333333333
"10149","30143","2021",3,3,0,244356.666666667,2174.66666666667,117
"10150","30144","2021",8,8,0,273718.75,2270.875,128.25
"10151","30145","2021",17,16,1,231348,2103.70588235294,112.117647058824
"10152","30146","2021",25,23,2,195079.2,1923.36,109.88
"10153","30147","2021",24,23,1,158083.5,1749.41666666667,93.375
"10154","30148","2021",4,4,0,224605,2128.5,107.5
"10155","30149","2021",11,11,0,290195.454545455,2659.45454545455,109.545454545455
"10156","30150","2021",5,5,0,227164,2147.4,105.6
"10157","30151","2021",10,10,0,279110,2163.5,138.6
"10158","30152","2021",31,31,0,168137.096774194,1769.35483870968,94.8064516129032
"10159","30153","2021",4,4,0,198194,2606.5,74.75
"10160","30154","2021",7,7,0,150685.714285714,2093.28571428571,79
"10161","30155","2021",77,75,2,244139.701298701,2510.45454545455,98.5454545454545
"10162","30156","2021",90,78,12,206533.966666667,2485.4,88.7333333333333
"10163","30158","2021",7,7,0,327821.428571429,2588.85714285714,131.428571428571
"10164","30159","2021",15,11,4,120091.733333333,1202.8,89.7333333333333
"10165","30161","2021",4,4,0,201925,2043.75,100.25
"10166","30162","2021",12,11,1,228313.583333333,2137.58333333333,109.416666666667
"10167","30163","2021",2,2,0,240005,2091,111
"10168","30164","2021",42,40,2,159864.642857143,2124.47619047619,77.4523809523809
"10169","30165","2021",10,10,0,327853.5,2430.8,129.4
"10170","30166","2021",35,32,3,227955.885714286,2427,98.4
"10171","30167","2021",16,13,3,168016.0625,2047.25,84.3125
"10172","30168","2021",10,10,0,180237.6,2267,69.2
"10173","30169","2021",86,61,25,203380.906976744,2467.23255813953,81.2441860465116
"10174","30170","2021",20,19,1,159766,1701.15,96.55
"10175","30171","2021",24,17,7,130087.916666667,1335.66666666667,95.3333333333333
"10176","30172","2021",7,7,0,188700,2253.71428571429,90
"10177","30173","2021",18,18,0,211668.444444444,1919.11111111111,113.166666666667
"10178","30174","2021",37,37,0,345388.891891892,3140.48648648649,111.189189189189
"10179","30175","2021",3,3,0,268333.333333333,2561.33333333333,109
"10180","30176","2021",3,3,0,72333.3333333333,1027.33333333333,66.6666666666667
"10181","30177","2021",6,6,0,242285,2500,100.333333333333
"10182","30178","2021",22,21,1,233040.090909091,2543.54545454545,93.2727272727273
"10183","30179","2021",62,59,3,198509.209677419,2034.75806451613,95.5483870967742
"10184","30180","2021",3,3,0,251786.666666667,2279.33333333333,111
"10185","30181","2021",12,12,0,263435.916666667,2528,106.5
"10186","30182","2021",19,18,1,236677.157894737,2656.36842105263,92.3684210526316
"10187","30183","2021",15,15,0,165901.733333333,2069.66666666667,84.5333333333333
"10188","30184","2021",24,24,0,241718,2060.04166666667,114.291666666667
"10189","30185","2021",20,19,1,311257.5,2834.7,109.2
"10190","30186","2021",33,32,1,376826.424242424,3144.75757575758,123.151515151515
"10191","30187","2021",5,5,0,134560,1538.8,87.6
"10192","30188","2021",23,22,1,170557.434782609,1756.95652173913,96.9130434782609
"10193","30189","2021",2711,756,1955,167875.995573589,2318.26669125784,71.3991147178163
"10194","30191","2021",9,9,0,192929.444444444,2103.55555555556,90.8888888888889
"10195","30192","2021",9,9,0,288459.333333333,2750.77777777778,104.888888888889
"10196","30193","2021",9,9,0,222259,2485.66666666667,95.7777777777778
"10197","30194","2021",6,4,2,127916.666666667,1485.5,103.166666666667
"10198","30195","2021",1,1,0,121250,978,124
"10199","30196","2021",9,9,0,247261.111111111,2567.22222222222,95.1111111111111
"10200","30197","2021",1,1,0,220000,2418,91
"10201","30198","2021",3,3,0,192000,1975.33333333333,113.333333333333
"10202","30199","2021",3,3,0,120511.666666667,1111,114.333333333333
"10203","30200","2021",17,17,0,172332.823529412,1766.17647058824,101.647058823529
"10204","30201","2021",7,7,0,103357.142857143,1493.57142857143,74
"10205","30202","2021",188,131,57,152567.372340426,1728.07446808511,88.0797872340426
"10206","30203","2021",6,6,0,173083.333333333,2068.83333333333,94
"10207","30204","2021",8,7,1,199312.5,1868.875,104.875
"10208","30205","2021",6,6,0,302666.666666667,2424,116.5
"10209","30206","2021",67,66,1,302779.28358209,2739.37313432836,112.328358208955
"10210","30207","2021",17,17,0,239721.176470588,2284.35294117647,105
"10211","30209","2021",55,48,7,350105.763636364,3111.03636363636,116.709090909091
"10212","30210","2021",42,36,6,201662.857142857,2059.33333333333,100.642857142857
"10213","30211","2021",48,44,4,247642.958333333,2442.75,99.4166666666667
"10214","30212","2021",33,20,13,164155.757575758,2215.12121212121,80.5454545454545
"10215","30213","2021",2,2,0,89000,1204.5,81
"10216","30214","2021",35,32,3,204109.485714286,2015.14285714286,101.914285714286
"10217","30215","2021",5,5,0,217264,1568.2,124.8
"10218","30216","2021",19,16,3,141007.368421053,1569.63157894737,98.8421052631579
"10219","30217","2021",110,103,7,314144.345454545,3031.15454545455,101.590909090909
"10220","30218","2021",6,6,0,242750,2431,100.666666666667
"10221","30219","2021",4,4,0,317430,2145,139.75
"10222","30220","2021",3,3,0,198000,3436,59.6666666666667
"10223","30221","2021",78,64,14,194667.051282051,2155.46153846154,88.6282051282051
"10224","30222","2021",7,7,0,256425.714285714,2774.85714285714,95
"10225","30223","2021",47,46,1,202067.212765957,2097.63829787234,95.9148936170213
"10226","30224","2021",9,9,0,217565.555555556,2185.77777777778,95.1111111111111
"10227","30225","2021",26,26,0,223951.346153846,2517.57692307692,93.1923076923077
"10228","30226","2021",12,12,0,245010.333333333,2234.75,111.916666666667
"10229","30227","2021",70,55,15,151832.328571429,1657.55714285714,86.7285714285714
"10230","30228","2021",32,32,0,228934.96875,2227.59375,103.875
"10231","30229","2021",13,12,1,153654.461538462,1692.30769230769,96.7692307692308
"10232","30230","2021",14,14,0,298710.071428571,2782.85714285714,105.928571428571
"10233","30231","2021",18,17,1,95308.3333333333,1504.5,63.8333333333333
"10234","30232","2021",8,8,0,403453.125,2935.125,134.125
"10235","30233","2021",10,10,0,196245,2187.4,88.5
"10236","30234","2021",3,3,0,163333.333333333,1604,113
"10237","30235","2021",14,12,2,206260.714285714,2210.57142857143,92.2142857142857
"10238","30236","2021",1,1,0,182000,2141,85
"10239","30237","2021",18,17,1,163316.111111111,1974.66666666667,87.5555555555556
"10240","30239","2021",14,14,0,182267.857142857,2235.07142857143,87.2857142857143
"10241","30240","2021",4,3,1,208750,2483,84.25
"10242","30241","2021",24,22,2,250263.791666667,2419.5,115.166666666667
"10243","30242","2021",2,2,0,406500,4841.5,120
"10244","30243","2021",104,83,21,213834.451923077,2145.00961538462,97.7019230769231
"10245","30244","2021",5,5,0,211480,2515.6,87
"10246","30245","2021",11,11,0,224140.909090909,2320.90909090909,105
"10247","30247","2021",7,7,0,225528.571428571,2194.85714285714,105
"10248","30248","2021",7,7,0,198882.714285714,1741.14285714286,114.142857142857
"10249","30249","2021",11,11,0,321250.090909091,2802.54545454545,118.363636363636
"10250","30250","2021",7,7,0,200521.428571429,1899.71428571429,121.714285714286
"10251","30251","2021",9,8,1,113622.222222222,1284.88888888889,85.6666666666667
"10252","30252","2021",4,4,0,120337.5,1857.25,68
"10253","30253","2021",21,19,2,154035.714285714,1828.33333333333,86.1904761904762
"10254","30254","2021",25,23,2,220199.8,2431.84,93.72
"10255","30255","2021",38,28,10,165224.631578947,1831.36842105263,92.2368421052632
"10256","30256","2021",8,7,1,218890,2087.5,98.75
"10257","30257","2021",36,36,0,237814.111111111,2491.77777777778,102.722222222222
"10258","30258","2021",198,148,50,173666.111111111,2050.56060606061,84.0353535353535
"10259","30259","2021",71,66,5,203706.070422535,2039.16901408451,101.704225352113
"10260","30260","2021",16,15,1,312571.25,2426.5625,137.1875
"10261","30261","2021",4,4,0,305412.5,2273,136
"10262","30262","2021",4,4,0,221545,1753,119.25
"10263","30263","2021",57,47,10,177807.01754386,1912.08771929825,90.140350877193
"10264","30264","2021",1,1,0,269000,2069,130
"10265","30265","2021",2,2,0,123857,1107.5,108.5
"10266","30266","2021",19,16,3,160675.789473684,1613.26315789474,95.7368421052632
"10267","30267","2021",6,6,0,181780.833333333,2122.66666666667,88.8333333333333
"10268","30268","2021",12,8,4,119171.666666667,1306.33333333333,92.5
"10269","30269","2021",30,21,9,154978.2,1672.66666666667,92.4333333333333
"10270","30270","2021",21,21,0,229676.19047619,1944.04761904762,117.285714285714
"10271","30271","2021",3,3,0,253000,2294.33333333333,108.666666666667
"10272","30272","2021",3,3,0,137333.333333333,1999.66666666667,68.6666666666667
"10273","30273","2021",22,21,1,257985.545454545,2324.68181818182,111.454545454545
"10274","30274","2021",34,34,0,245564.382352941,2324,109.382352941176
"10275","30275","2021",4,4,0,324465,2163.75,153.75
"10276","30276","2021",87,76,11,253484.137931034,3208.03448275862,85.1724137931034
"10277","30277","2021",8,8,0,251936.25,2159.875,116.5
"10278","30278","2021",39,38,1,326753.230769231,2990.38461538462,116.435897435897
"10279","30279","2021",23,23,0,276478.043478261,2674.21739130435,107.869565217391
"10280","30280","2021",11,7,4,93712.4545454545,1036.72727272727,96.0909090909091
"10281","30281","2021",31,24,7,230362.129032258,2200.48387096774,104.645161290323
"10282","30282","2021",8,8,0,189306.875,2124.625,97.875
"10283","30283","2021",7,7,0,118826.142857143,1271.42857142857,94.2857142857143
"10284","30284","2021",59,54,5,165768.593220339,1745.79661016949,94.6949152542373
"10285","30285","2021",10,9,1,196114,1938.3,105.8
"10286","30286","2021",23,22,1,413628.347826087,3353.04347826087,122.695652173913
"10287","30287","2021",10,9,1,297917,2536.7,116.9
"10288","30288","2021",15,5,10,94400,1335.93333333333,61.1333333333333
"10289","30289","2021",2,2,0,447500,2147,207
"10290","30290","2021",8,8,0,497917.5,3032.75,144.875
"10291","30291","2021",6,6,0,259333.333333333,2349.66666666667,108.5
"10292","30292","2021",11,11,0,291363.363636364,2690.81818181818,106.272727272727
"10293","30293","2021",6,6,0,239525,2007,130.166666666667
"10294","30294","2021",84,69,15,208159.916666667,2091.55952380952,100.452380952381
"10295","30295","2021",66,65,1,306231.742424242,2748.43939393939,107.484848484848
"10296","30296","2021",3,3,0,162666.666666667,1632,133
"10297","30297","2021",13,12,1,138974.692307692,2277.15384615385,72.0769230769231
"10298","30298","2021",5,5,0,225528.4,2373.8,88.2
"10299","30299","2021",43,42,1,482595.837209302,3310.44186046512,145.767441860465
"10300","30300","2021",9,9,0,267693.333333333,2204.44444444444,125.444444444444
"10301","30301","2021",6,6,0,367033.333333333,2692.66666666667,131.166666666667
"10302","30302","2021",31,30,1,268901.774193548,2565.16129032258,104.774193548387
"10303","30303","2021",13,13,0,179776.923076923,1965.76923076923,93.8461538461538
"10304","30304","2021",7,7,0,225735.714285714,2241.14285714286,110.285714285714
"10305","30305","2021",43,40,3,173311.325581395,1724.18604651163,102.604651162791
"10306","30306","2021",6,6,0,357211.5,2568.33333333333,133
"10307","30307","2021",28,22,6,113548.035714286,1309.46428571429,85.5714285714286
"10308","30308","2021",17,16,1,272274.411764706,3057.23529411765,95.8823529411765
"10309","30309","2021",12,12,0,279929.166666667,2419.91666666667,117.333333333333
"10310","30310","2021",8,8,0,174422.625,2016.75,97.125
"10311","30311","2021",39,29,10,169028.58974359,2131.5641025641,84.4358974358974
"10312","30312","2021",20,20,0,255720.3,2536.4,104.05
"10313","30313","2021",5,5,0,226920,2207.4,96.6
"10314","30314","2021",2,2,0,193100,1421.5,126.5
"10315","30315","2021",24,23,1,230564.541666667,2795.41666666667,84.8333333333333
"10316","30316","2021",9,8,1,128405.555555556,1991.88888888889,62.4444444444444
"10317","30317","2021",40,35,5,209055.65,2217.25,95.725
"10318","30318","2021",1,1,0,346000,2768,125
"10319","30319","2021",11,11,0,403955.454545455,2798.90909090909,144.272727272727
"10320","30320","2021",6,6,0,273885.833333333,1688.33333333333,174.833333333333
"10321","30321","2021",69,53,16,241606.942028986,2577.89855072464,93.5217391304348
"10322","30322","2021",3,3,0,334600,2819.66666666667,129.333333333333
"10323","30323","2021",2,2,0,233000,3173.5,80
"10324","30324","2021",8,8,0,225343.75,2274,105.875
"10325","30325","2021",33,25,8,129775.454545455,1651.60606060606,85.6969696969697
"10326","30326","2021",29,26,3,248224.724137931,2616.89655172414,97.7241379310345
"10327","30328","2021",15,15,0,179653.333333333,2199.26666666667,82.5333333333333
"10328","30329","2021",9,9,0,313055.555555556,2555.44444444444,136.888888888889
"10329","30330","2021",10,10,0,302639,2215.2,129.6
"10330","30331","2021",33,33,0,240558.484848485,2446.36363636364,102.090909090909
"10331","30332","2021",2,2,0,134500,2074.5,64.5
"10332","30333","2021",97,72,25,207610.886597938,2301.11340206186,91.3814432989691
"10333","30334","2021",186,81,105,291345.35483871,3301.1935483871,84.1021505376344
"10334","30335","2021",1,1,0,232000,1827,127
"10335","30336","2021",31,30,1,183636.709677419,2105.77419354839,88.0967741935484
"10336","30337","2021",8,7,1,303708.75,2294.25,125.5
"10337","30339","2021",34,21,13,89897.0588235294,1512.67647058824,63.8529411764706
"10338","30340","2021",6,6,0,174850,1722.83333333333,109.833333333333
"10339","30341","2021",194,142,52,200755.75257732,2270.48453608247,89.5979381443299
"10340","30342","2021",13,13,0,241269.230769231,2305.46153846154,101.384615384615
"10341","30343","2021",11,9,2,335872.181818182,2842.63636363636,112.090909090909
"10342","30344","2021",71,60,11,259273.14084507,2611.53521126761,100.225352112676
"10343","30345","2021",12,8,4,74419.5833333333,1199.91666666667,63.3333333333333
"10344","30346","2021",26,22,4,273601.423076923,2452.15384615385,112.961538461538
"10345","30347","2021",19,19,0,252603.684210526,2851.15789473684,92.4210526315789
"10346","30348","2021",36,36,0,275617.666666667,2193.77777777778,123.194444444444
"10347","30349","2021",6,6,0,317109.5,2451.5,143.666666666667
"10348","30350","2021",75,35,40,110930.053333333,1331.44,80.64
"10349","30351","2021",258,172,86,354446.015503876,3434.5503875969,101.531007751938
"10350","30352","2021",26,24,2,308684.846153846,2716.15384615385,114.307692307692
"10351","30354","2021",2,1,1,241060.5,2108,108
"10352","30355","2021",11,11,0,224317.636363636,2302.72727272727,97.3636363636364
"10353","30356","2021",53,40,13,208177.452830189,2516.84905660377,83.4150943396226
"10354","31001","2021",1,1,0,115000,858,134
"10355","31002","2021",5,5,0,267914,2899.2,100.8
"10356","31003","2021",12,10,2,367037.25,3161.33333333333,116.833333333333
"10357","31004","2021",36,35,1,285680.277777778,2647.22222222222,106.666666666667
"10358","31005","2021",13,13,0,115730.769230769,982.461538461538,120.692307692308
"10359","31006","2021",1,1,0,202000,2349,86
"10360","31007","2021",1,1,0,343000,2858,120
"10361","31008","2021",3,3,0,81216.3333333333,1203.33333333333,81
"10362","31009","2021",1,1,0,270000,2213,122
"10363","31010","2021",3,3,0,205556.666666667,1549,128.666666666667
"10364","31011","2021",6,6,0,86323.6666666667,1299.33333333333,70
"10365","31012","2021",5,5,0,94400,1048.8,84.4
"10366","31013","2021",8,8,0,128500,1039.125,127.25
"10367","31014","2021",2,2,0,117920,1515.5,66.5
"10368","31015","2021",3,3,0,50666.6666666667,1116.33333333333,45
"10369","31017","2021",8,8,0,147700.625,1355.875,111.75
"10370","31018","2021",4,4,0,110314.75,985.75,102.25
"10371","31019","2021",2,2,0,321000,2439,147.5
"10372","31020","2021",21,20,1,130469.142857143,1164.38095238095,106.904761904762
"10373","31021","2021",6,6,0,120083.333333333,1184,101.666666666667
"10374","31022","2021",234,89,145,198403.636752137,2838.18376068376,69.3717948717949
"10375","31023","2021",11,11,0,108145.454545455,1092.63636363636,104.727272727273
"10376","31024","2021",4,4,0,241087.5,1938.75,120
"10377","31025","2021",10,10,0,481568,3522.2,143.8
"10378","31026","2021",30,29,1,247818.333333333,2052.1,125.066666666667
"10379","31027","2021",1,1,0,347050,4285,81
"10380","31028","2021",31,22,9,133988.838709677,1431.83870967742,98.5806451612903
"10381","31029","2021",2,2,0,366550,1657,216
"10382","31030","2021",1,1,0,225000,4787,47
"10383","31031","2021",4,4,0,163771,1785,91.25
"10384","31032","2021",111,70,41,260569.387387387,2862.9009009009,95.2612612612613
"10385","31033","2021",214,125,89,166416.214953271,1997.07943925234,80.5327102803738
"10386","31034","2021",2,2,0,178500,698,270
"10387","31035","2021",56,24,32,305606.428571429,3214.80357142857,95.875
"10388","31036","2021",19,16,3,319022.368421053,3131.63157894737,106.157894736842
"10389","31037","2021",14,13,1,183693.214285714,1714.5,120.785714285714
"10390","31038","2021",8,8,0,403658.75,2473.75,171
"10391","31039","2021",1,1,0,155000,775,200
"10392","31041","2021",3,3,0,134293.666666667,1176.33333333333,129.333333333333
"10393","31042","2021",233,41,192,97470.2317596567,1967.65236051502,52.8927038626609
"10394","31043","2021",2,2,0,183897.5,1552.5,117.5
"10395","31044","2021",230,99,131,327194.760869565,3646.47826086957,89.0782608695652
"10396","31045","2021",9,9,0,148133.333333333,1477.11111111111,97.7777777777778
"10397","31047","2021",2,2,0,303850,2766.5,111.5
"10398","31048","2021",73,69,4,233439.767123288,2433.30136986301,97.3561643835616
"10399","31049","2021",3,3,0,269509.666666667,2328,138
"10400","31050","2021",8,8,0,137391.25,1426.875,100.125
"10401","31051","2021",5,5,0,284071.2,1937.4,154
"10402","31052","2021",23,22,1,228438.826086957,1991.82608695652,113.695652173913
"10403","31053","2021",9,9,0,373107.111111111,3168.44444444444,120.222222222222
"10404","31054","2021",6,6,0,369419.166666667,2588.16666666667,158.333333333333
"10405","31055","2021",4,4,0,300382.5,1943.75,157.25
"10406","31056","2021",89,59,30,280747.651685393,3022.26966292135,92.6404494382023
"10407","31057","2021",17,15,2,372517.764705882,3233.17647058824,115.058823529412
"10408","31058","2021",1,1,0,503600,3597,140
"10409","31059","2021",3,3,0,539908.333333333,2494.33333333333,207.333333333333
"10410","31060","2021",2,2,0,172325,1531,115.5
"10411","31061","2021",4,4,0,281912.5,2401.75,116.25
"10412","31063","2021",1,1,0,168950,1877,90
"10413","31065","2021",51,43,8,213438.62745098,2085.62745098039,102.313725490196
"10414","31066","2021",80,65,15,208917.1875,2229.6625,92.45
"10415","31067","2021",2,2,0,199435,1636.5,132
"10416","31069","2021",416,129,287,233009.115384615,3199.52884615385,72.3221153846154
"10417","31070","2021",7,7,0,137564.285714286,873.142857142857,161.857142857143
"10418","31071","2021",4,4,0,350727.5,2532.5,141.75
"10419","31073","2021",7,7,0,211007.142857143,1927.42857142857,116
"10420","31074","2021",1,1,0,230000,2987,77
"10421","31075","2021",15,15,0,341465.533333333,2664.66666666667,132
"10422","31076","2021",4,4,0,126125,1196.75,99.75
"10423","31077","2021",7,7,0,268750,2025.57142857143,129.142857142857
"10424","31078","2021",4,4,0,184595.5,2050.5,101.5
"10425","31079","2021",44,42,2,300181.272727273,2785.38636363636,110.113636363636
"10426","31080","2021",14,13,1,113243.928571429,1397.35714285714,82.5
"10427","31081","2021",1,1,0,45000,562,80
"10428","31082","2021",14,13,1,281372,2369.35714285714,123.357142857143
"10429","31083","2021",2,2,0,192500,1949.5,97.5
"10430","31084","2021",13,12,1,162819.615384615,1734.84615384615,96.6923076923077
"10431","31085","2021",21,19,2,132331.904761905,1682.90476190476,84.1904761904762
"10432","31086","2021",1,1,0,171000,1487,115
"10433","31087","2021",9,8,1,222544.444444444,1932.22222222222,115.888888888889
"10434","31088","2021",18,14,4,336045.555555556,3207.83333333333,101.888888888889
"10435","31089","2021",11,11,0,338652,2625.54545454545,130.454545454545
"10436","31090","2021",12,12,0,192633.333333333,1422.16666666667,128
"10437","31091","2021",108,79,29,265204.564814815,2958.64814814815,91.0833333333333
"10438","31092","2021",4,4,0,140000,1607.25,114.25
"10439","31093","2021",16,15,1,256122,2252.25,116.125
"10440","31094","2021",54,47,7,266451.685185185,2468.61111111111,105.888888888889
"10441","31095","2021",1,1,0,156074,821,190
"10442","31097","2021",4,4,0,233220,2254.75,101.75
"10443","31098","2021",19,19,0,174774.421052632,1957.42105263158,90.3684210526316
"10444","31099","2021",6,6,0,244946.666666667,2103.66666666667,116.333333333333
"10445","31100","2021",41,40,1,171834.512195122,1874.09756097561,93.0731707317073
"10446","31101","2021",3,3,0,424728.333333333,3731,136.333333333333
"10447","31102","2021",4,4,0,279482.5,2878,97.25
"10448","31103","2021",1,1,0,159100,1090,146
"10449","31104","2021",8,8,0,173682.5,1581,120.25
"10450","31105","2021",3,3,0,390956.666666667,3812.66666666667,112.666666666667
"10451","31106","2021",33,30,3,233126.666666667,2181.18181818182,120
"10452","31107","2021",101,85,16,200673.762376238,2107.9702970297,97.4257425742574
"10453","31109","2021",9,9,0,202988.888888889,1457.22222222222,137.777777777778
"10454","31110","2021",11,11,0,166983.181818182,1606.54545454545,103.636363636364
"10455","31111","2021",4,4,0,246682.5,2100.25,121
"10456","31112","2021",2,2,0,87500,1113.5,80.5
"10457","31113","2021",243,93,150,254049.777777778,3165.71193415638,80.6090534979424
"10458","31114","2021",2,2,0,106000,1152.5,92
"10459","31115","2021",2,2,0,165000,1965,86
"10460","31116","2021",173,96,77,224319.404624277,2708.70520231214,82.5375722543353
"10461","31117","2021",49,49,0,353426.081632653,3013.36734693878,119.959183673469
"10462","31118","2021",170,94,76,212539.788235294,2464.86470588235,84.5882352941177
"10463","31119","2021",8,8,0,204946.25,1649.25,126.625
"10464","31120","2021",4,4,0,301407.5,2767.25,111.75
"10465","31121","2021",2,2,0,216500,1344,160.5
"10466","31123","2021",3,3,0,125650,2054,84.6666666666667
"10467","31124","2021",5,5,0,151100,1257,120.6
"10468","31126","2021",6,6,0,220354.5,1612.66666666667,138.666666666667
"10469","31127","2021",1,1,0,180000,1636,110
"10470","31128","2021",16,16,0,217050,1782.875,126.75
"10471","31130","2021",3,3,0,152000,1476,104.333333333333
"10472","31131","2021",1,1,0,71000,1183,60
"10473","31132","2021",2,2,0,250500,1679.5,150.5
"10474","31133","2021",3,3,0,208666.666666667,1753.33333333333,113.666666666667
"10475","31135","2021",110,73,37,146017,1770.46363636364,87.3090909090909
"10476","31136","2021",45,30,15,205115.311111111,2415.15555555556,84.9111111111111
"10477","31137","2021",1,1,0,333000,2467,135
"10478","31138","2021",4,4,0,184916.5,1308.5,151
"10479","31139","2021",6,6,0,79500,821.5,96.5
"10480","31140","2021",3,3,0,130928.333333333,1247.33333333333,97.3333333333333
"10481","31141","2021",6,6,0,159076.666666667,1281.83333333333,129.666666666667
"10482","31142","2021",5,5,0,207421,1918.2,99.2
"10483","31143","2021",2,2,0,140720,1591,90
"10484","31144","2021",25,25,0,107342.8,1188.16,97.92
"10485","31145","2021",57,56,1,191270.877192982,1866.14035087719,108.614035087719
"10486","31147","2021",9,9,0,189614.444444444,1610.22222222222,134.555555555556
"10487","31148","2021",5,5,0,396350,2914,130.6
"10488","31149","2021",573,247,326,225006.118673647,2749.47643979058,79.5602094240838
"10489","31150","2021",122,86,36,255505.106557377,2891.64754098361,88.7786885245902
"10490","31151","2021",11,10,1,395931.363636364,3209.54545454545,125.090909090909
"10491","31153","2021",6,6,0,237603.333333333,1663.66666666667,136.333333333333
"10492","31155","2021",2,2,0,70000,693,103.5
"10493","31156","2021",7,7,0,165162.857142857,1691.14285714286,99
"10494","31157","2021",307,166,141,236866.45276873,2713.22475570033,86.371335504886
"10495","31158","2021",1,1,0,195000,1711,114
"10496","31159","2021",7,7,0,137257.142857143,1288.85714285714,104.285714285714
"10497","31160","2021",45,34,11,253464.244444444,2656.28888888889,96.8888888888889
"10498","31161","2021",14,12,2,334906.714285714,2947.57142857143,116.571428571429
"10499","31162","2021",13,13,0,320454.615384615,2662.53846153846,126.307692307692
"10500","31163","2021",32,28,4,403635.5625,3476.1875,123.375
"10501","31164","2021",7,7,0,258630.857142857,1850.42857142857,128
"10502","31165","2021",109,79,30,232481,2433.39449541284,95.954128440367
"10503","31166","2021",4,4,0,245250,2251.75,111.25
"10504","31167","2021",13,12,1,117398.461538462,1257.53846153846,93.1538461538462
"10505","31169","2021",90,54,36,294507.977777778,3153.8,93.0555555555556
"10506","31170","2021",3,3,0,136000,1112.66666666667,122.333333333333
"10507","31171","2021",2,2,0,386875,2402.5,159.5
"10508","31172","2021",2,2,0,224550,1133,189
"10509","31173","2021",3,3,0,175933.333333333,1524,111.666666666667
"10510","31174","2021",8,8,0,128018.75,1119.125,109.125
"10511","31175","2021",9,9,0,168546,1724.55555555556,98.4444444444444
"10512","31176","2021",8,8,0,107968.75,1301.875,81.875
"10513","31177","2021",3,3,0,126658.333333333,1607,78.6666666666667
"10514","31178","2021",4,3,1,219250,1311.25,158.5
"10515","31179","2021",6,6,0,271647.5,1730.83333333333,159.666666666667
"10516","31180","2021",2,2,0,479950,1816,263.5
"10517","31181","2021",20,16,4,215404.95,2143.7,98.35
"10518","31182","2021",89,49,40,190447.404494382,2509.42696629213,75.7078651685393
"10519","31183","2021",9,9,0,174066.666666667,1512.11111111111,120.333333333333
"10520","31184","2021",24,21,3,369278,3452.91666666667,104.625
"10521","31185","2021",1,1,0,247995,1550,160
"10522","31186","2021",55,22,33,178073,2671.47272727273,67.0181818181818
"10523","31187","2021",206,129,77,240271.04368932,2642.45631067961,89.3640776699029
"10524","31188","2021",5,5,0,394200,2835,140.6
"10525","31189","2021",3,3,0,265950,2460.33333333333,112.666666666667
"10526","31190","2021",14,14,0,110847.142857143,1214.57142857143,102.428571428571
"10527","31191","2021",1,1,0,122590,1532,80
"10528","31192","2021",5,5,0,281491.8,2314.6,120.4
"10529","31193","2021",21,19,2,201074.619047619,1610.57142857143,121.142857142857
"10530","31194","2021",3,3,0,303000,2473.66666666667,127.666666666667
"10531","31195","2021",1,1,0,112200,1058,106
"10532","31196","2021",5,5,0,216800,1914,132.6
"10533","31197","2021",5,5,0,132000,1340.2,120.2
"10534","31198","2021",1,1,0,109000,1028,106
"10535","31199","2021",4,4,0,111625,1104.5,106.75
"10536","31200","2021",2,1,1,65000,1383.5,40
"10537","31202","2021",92,78,14,266867.347826087,2502.26086956522,112.20652173913
"10538","31203","2021",120,72,48,248150.575,2985.25833333333,86.3166666666667
"10539","31205","2021",64,28,36,199000.5,2722.6875,71.71875
"10540","31206","2021",16,16,0,207175.3125,1863.9375,112.6875
"10541","31207","2021",1,1,0,199000,2764,72
"10542","31208","2021",5,5,0,177330,1557.8,115
"10543","31209","2021",5,5,0,241320,1668.4,147.2
"10544","31210","2021",24,20,4,206424.75,1917.70833333333,105.916666666667
"10545","31211","2021",6,6,0,315116.666666667,2627.5,125.333333333333
"10546","31212","2021",18,16,2,285859.222222222,2806.44444444444,104.277777777778
"10547","31213","2021",5,4,1,170095,2107.4,87.2
"10548","31215","2021",7,7,0,327466.142857143,2997.57142857143,111.571428571429
"10549","31216","2021",7,7,0,209642.857142857,1892.42857142857,118.142857142857
"10550","31217","2021",4,4,0,122500,1156.5,99.5
"10551","31218","2021",5,5,0,164070,1493.8,105.6
"10552","31219","2021",1,1,0,170000,2024,84
"10553","31220","2021",12,12,0,307247.083333333,2357.41666666667,130.25
"10554","31221","2021",10,2,8,114834.8,1930,56.4
"10555","31222","2021",3,3,0,166983.333333333,1994.33333333333,86.3333333333333
"10556","31224","2021",19,18,1,104156.842105263,1298.52631578947,84.5789473684211
"10557","31225","2021",2,2,0,239500,2137,110.5
"10558","31226","2021",1,1,0,310000,2583,120
"10559","31227","2021",12,9,3,501642.916666667,3605.16666666667,143.666666666667
"10560","31228","2021",40,25,15,290703.625,2999.55,95.925
"10561","31229","2021",16,16,0,201715,1811.125,114.375
"10562","31230","2021",47,42,5,281371.531914894,2758.3829787234,102.404255319149
"10563","31231","2021",5,5,0,231368,2085.2,121
"10564","31232","2021",142,94,48,204003.633802817,2321.52112676056,89.1056338028169
"10565","31233","2021",15,15,0,249020,2440.33333333333,104.066666666667
"10566","31234","2021",4,4,0,234150,2112.5,109.25
"10567","31235","2021",1,1,0,380450,1268,300
"10568","31236","2021",2,2,0,116595,1135,102.5
"10569","31237","2021",5,5,0,177150,1274.4,143.6
"10570","31238","2021",10,10,0,123875,1236.3,114.2
"10571","31239","2021",36,35,1,120000.027777778,1221.72222222222,99.3055555555556
"10572","31240","2021",7,7,0,284844.285714286,2872.14285714286,103.142857142857
"10573","31241","2021",3,3,0,92100,1251.66666666667,83
"10574","31243","2021",2,2,0,196400,1888.5,104
"10575","31244","2021",9,8,1,186586.666666667,1918.66666666667,96.4444444444444
"10576","31245","2021",4,4,0,179600,1394.75,133.75
"10577","31246","2021",15,15,0,204110.866666667,1518.06666666667,141.133333333333
"10578","31247","2021",21,21,0,146642.19047619,1341.09523809524,112
"10579","31248","2021",70,56,14,277179.3,2709.08571428571,103.442857142857
"10580","31249","2021",14,13,1,327447.857142857,2955.78571428571,110.285714285714
"10581","31250","2021",8,8,0,199093.75,2141.625,101.5
"10582","31251","2021",2,2,0,169173,1872,90.5
"10583","31252","2021",27,23,4,258208.777777778,2680.33333333333,98.1111111111111
"10584","31253","2021",44,32,12,200996.340909091,2244.77272727273,91.5454545454545
"10585","31254","2021",33,25,8,371781.484848485,3504.54545454545,111.242424242424
"10586","31255","2021",6,6,0,103666.666666667,1332.16666666667,72.3333333333333
"10587","31256","2021",4,4,0,277745,1892.75,154.5
"10588","31258","2021",1,1,0,462474,2737,169
"10589","31259","2021",18,15,3,385634.222222222,2849.72222222222,135.444444444444
"10590","31260","2021",1,1,0,170000,1619,105
"10591","31261","2021",12,12,0,209122.916666667,2083.08333333333,103.333333333333
"10592","31262","2021",2,2,0,287470,2303.5,125.5
"10593","31263","2021",56,56,0,254304.660714286,2595.16071428571,102.553571428571
"10594","31264","2021",3,3,0,137195,1353.66666666667,103.666666666667
"10595","31265","2021",11,11,0,164255.181818182,3099.81818181818,80.1818181818182
"10596","31266","2021",4,4,0,197912.5,1731.5,110.5
"10597","31267","2021",3,3,0,205000,2626,77.6666666666667
"10598","31268","2021",2,2,0,145000,1283,113.5
"10599","31269","2021",23,23,0,253671.434782609,2450.69565217391,104.304347826087
"10600","31270","2021",20,20,0,209966.5,1625.05,132.9
"10601","31271","2021",24,18,6,293133.166666667,2857.125,102.541666666667
"10602","31272","2021",1,1,0,266000,2891,92
"10603","31273","2021",34,34,0,401617.705882353,3050.64705882353,134.764705882353
"10604","31274","2021",5,5,0,199300,1601.4,119
"10605","31276","2021",9,9,0,131527.777777778,1146.33333333333,113.666666666667
"10606","31277","2021",19,19,0,315468.789473684,2517.63157894737,122.263157894737
"10607","31278","2021",2,2,0,67500,541,112
"10608","31280","2021",7,7,0,265478.571428571,2138.57142857143,141.285714285714
"10609","31281","2021",16,13,3,211093,1728.1875,117.875
"10610","31282","2021",138,79,59,222798.347826087,2661.1231884058,84.2463768115942
"10611","31283","2021",4,4,0,270875,1926.25,141.25
"10612","31284","2021",7,6,1,423521.428571429,2997.85714285714,143.285714285714
"10613","31285","2021",7,6,1,276560.285714286,2453.57142857143,118.428571428571
"10614","31286","2021",15,15,0,202207.333333333,2042.4,117.466666666667
"10615","31287","2021",54,44,10,248058.981481481,2489.57407407407,98.8703703703704
"10616","31288","2021",6,6,0,260755,1835.83333333333,149.333333333333
"10617","31290","2021",3,3,0,112416.666666667,1371,86
"10618","31291","2021",196,105,91,209685.87755102,2582.14795918367,78.0918367346939
"10619","31293","2021",39,31,8,268770.435897436,2964.71794871795,88.7948717948718
"10620","31294","2021",2,2,0,120000,1009.5,117
"10621","31296","2021",4,4,0,133087.5,1273.75,112.5
"10622","31297","2021",53,43,10,223317.226415094,2332.75471698113,93.5094339622642
"10623","31299","2021",59,54,5,246144.305084746,2233.74576271186,113.474576271186
"10624","31300","2021",5,5,0,172545,1379.4,113.8
"10625","31301","2021",4,4,0,137470.25,730.75,174.75
"10626","31302","2021",4,4,0,126825,1357.25,96.5
"10627","31303","2021",39,31,8,215615.564102564,2148,102.333333333333
"10628","31304","2021",12,11,1,259164.166666667,2271,112.833333333333
"10629","31305","2021",4,4,0,147500,1767.25,88.75
"10630","31306","2021",4,4,0,130462.5,1223.5,118.75
"10631","31308","2021",1,1,0,90000,857,105
"10632","31309","2021",6,6,0,150991.666666667,2002.83333333333,78.1666666666667
"10633","31310","2021",3,3,0,230000,2055.33333333333,100.666666666667
"10634","31311","2021",14,14,0,277979.357142857,2543.71428571429,109
"10635","31313","2021",3,3,0,97433.3333333333,1620.33333333333,60.6666666666667
"10636","31314","2021",10,10,0,210857,1600.9,130.7
"10637","31315","2021",20,20,0,149596.2,1587.75,99.7
"10638","31316","2021",16,16,0,104521.875,1087.25,92.375
"10639","31317","2021",6,6,0,200411.166666667,2046,102.166666666667
"10640","31318","2021",2,2,0,211575,1650.5,128.5
"10641","31319","2021",1,1,0,187900,1917,98
"10642","31320","2021",17,17,0,242151.529411765,2238.47058823529,113.647058823529
"10643","31321","2021",1,1,0,195000,1548,126
"10644","31322","2021",1,1,0,96600,966,100
"10645","31323","2021",6,6,0,123200,1101.16666666667,127.666666666667
"10646","31324","2021",42,38,4,167441.19047619,1669.64285714286,106.404761904762
"10647","31325","2021",2,2,0,196740,1818.5,107.5
"10648","31326","2021",1,1,0,334000,1427,234
"10649","31327","2021",2,2,0,234800,1347.5,170
"10650","31328","2021",3,3,0,345320,2122.33333333333,157.666666666667
"10651","31329","2021",6,6,0,173080.833333333,1760.16666666667,97.1666666666667
"10652","31330","2021",7,7,0,208187.142857143,2021.85714285714,105
"10653","31331","2021",3,3,0,295327.333333333,3061,96.3333333333333
"10654","31332","2021",5,5,0,158935.6,1918.2,96.6
"10655","31333","2021",1,1,0,54000,587,92
"10656","31334","2021",14,13,1,258641.428571429,2392.57142857143,111.5
"10657","31335","2021",1,1,0,108250,1388,78
"10658","31336","2021",6,6,0,121521.666666667,1183.33333333333,100.833333333333
"10659","31337","2021",8,8,0,153725.25,1822.125,85.875
"10660","31338","2021",13,13,0,337331.538461538,2734.38461538462,124.538461538462
"10661","31339","2021",3,3,0,319990,2680,119.333333333333
"10662","31340","2021",3,3,0,729320,3892.33333333333,180.333333333333
"10663","31341","2021",98,67,31,228822.5,2487.41836734694,89.1836734693878
"10664","31342","2021",1,1,0,56000,767,73
"10665","31343","2021",2,2,0,75500.5,914,83.5
"10666","31344","2021",8,7,1,73750,903,82
"10667","31345","2021",48,45,3,225960.833333333,2137.04166666667,105.4375
"10668","31346","2021",21,21,0,213959.047619048,2512.90476190476,92.2380952380952
"10669","31347","2021",2,2,0,105500,1194.5,87.5
"10670","31348","2021",2,2,0,116000,1332.5,88.5
"10671","31349","2021",13,13,0,174615.384615385,1790,96.1538461538462
"10672","31350","2021",2,2,0,254750,1539.5,176.5
"10673","31351","2021",128,63,65,228046.1171875,2896.828125,75.3515625
"10674","31352","2021",1,1,0,350000,3465,101
"10675","31353","2021",2,2,0,225500,2039,112.5
"10676","31354","2021",1,1,0,490500,2230,220
"10677","31355","2021",10,10,0,551026.1,4264.1,138.6
"10678","31356","2021",25,24,1,345002.08,2915,121.6
"10679","31357","2021",6,6,0,123471.666666667,1160.16666666667,104.166666666667
"10680","31358","2021",53,46,7,338917,2796.62264150943,122.603773584906
"10681","31359","2021",1,1,0,202000,2525,80
"10682","31360","2021",11,5,6,192956.636363636,2295.27272727273,89.9090909090909
"10683","31361","2021",6,6,0,275002.333333333,1695,163
"10684","31362","2021",1,1,0,385000,3156,122
"10685","31363","2021",3,3,0,130904.666666667,1138,133.333333333333
"10686","31364","2021",37,36,1,328382.189189189,3006.16216216216,112.459459459459
"10687","31365","2021",6,6,0,180201.333333333,1498.83333333333,132.333333333333
"10688","31366","2021",9,9,0,385100,2959,130.333333333333
"10689","31367","2021",1,1,0,226500,1364,166
"10690","31368","2021",3,3,0,242250,2468.33333333333,96.6666666666667
"10691","31369","2021",2,2,0,210000,1545.5,110
"10692","31370","2021",1,1,0,120000,1091,110
"10693","31371","2021",2,2,0,280250,2152.5,133
"10694","31372","2021",7,7,0,159790.571428571,1833.42857142857,101.285714285714
"10695","31373","2021",4,4,0,213225,1975.5,115.75
"10696","31374","2021",17,17,0,309795.882352941,2875.70588235294,122.764705882353
"10697","31375","2021",36,36,0,177944.722222222,1673.22222222222,114.972222222222
"10698","31377","2021",9,8,1,253344.444444444,2198.66666666667,116.222222222222
"10699","31378","2021",1,1,0,118380,1233,96
"10700","31379","2021",1,1,0,91400,2126,43
"10701","31380","2021",7,7,0,255062.857142857,2395.57142857143,99.1428571428571
"10702","31381","2021",43,38,5,279287.139534884,2726.90697674419,103.441860465116
"10703","31383","2021",12,11,1,270311.666666667,2371.16666666667,113.916666666667
"10704","31384","2021",22,21,1,283613.272727273,2880.86363636364,100
"10705","31385","2021",5,5,0,119414,1142,119.4
"10706","31386","2021",4,4,0,207750,1880.25,105.75
"10707","31387","2021",2,2,0,308141.5,1727.5,197.5
"10708","31388","2021",4,4,0,405385,2114,186.25
"10709","31389","2021",64,33,31,283047.203125,3050.71875,91.40625
"10710","31390","2021",54,33,21,80127.2962962963,1092.75925925926,76.5555555555556
"10711","31391","2021",5,5,0,147790,1220.2,124.2
"10712","31392","2021",1,1,0,247507,1875,132
"10713","31393","2021",2,2,0,187500,1527.5,122.5
"10714","31394","2021",4,3,1,171312.5,2354.25,82
"10715","31395","2021",437,227,210,197478.146453089,2361.56979405034,82.3020594965675
"10716","31396","2021",120,61,59,144696.241666667,1802.18333333333,76.0583333333333
"10717","31397","2021",2,2,0,156500,1534.5,109
"10718","31398","2021",2,2,0,132750,1438,93.5
"10719","31399","2021",41,37,4,224652.951219512,2243,104.80487804878
"10720","31401","2021",4,4,0,222912.5,1762.75,144
"10721","31402","2021",5,5,0,377450,3389.6,110.6
"10722","31403","2021",15,13,2,282255,2593,112.466666666667
"10723","31404","2021",3,3,0,138666.666666667,1470.33333333333,97
"10724","31405","2021",3,3,0,116333.333333333,667,162
"10725","31406","2021",13,13,0,182494.615384615,1648.92307692308,120.307692307692
"10726","31407","2021",21,21,0,331769.095238095,2708.66666666667,126.809523809524
"10727","31408","2021",1,1,0,75000,455,165
"10728","31409","2021",28,15,13,225477.821428571,2991.5,74.9285714285714
"10729","31410","2021",57,49,8,289728.052631579,2901.98245614035,101.912280701754
"10730","31411","2021",4,4,0,565210,3397,166.5
"10731","31412","2021",2,2,0,205198,819,250
"10732","31413","2021",10,10,0,236763.6,2236.4,109.7
"10733","31414","2021",1,1,0,123000,586,210
"10734","31416","2021",3,3,0,237506.666666667,2458,97
"10735","31417","2021",91,64,27,306225.373626374,3061.1978021978,98.4725274725275
"10736","31418","2021",26,14,12,344094.538461538,4189.96153846154,101.461538461538
"10737","31419","2021",2,2,0,452630,2626.5,171.5
"10738","31420","2021",35,28,7,245285.571428571,2537.37142857143,97.7142857142857
"10739","31421","2021",54,40,14,211487.666666667,2532.83333333333,83.9259259259259
"10740","31423","2021",6,6,0,253376.5,2326.66666666667,110.666666666667
"10741","31424","2021",260,202,58,269174.330769231,2848.21153846154,94.3153846153846
"10742","31425","2021",10,10,0,146403,1719.3,95
"10743","31426","2021",11,11,0,172485.090909091,1551,110.636363636364
"10744","31427","2021",6,6,0,151833.333333333,1009.83333333333,156.833333333333
"10745","31428","2021",1,1,0,135000,1350,100
"10746","31429","2021",29,14,15,243351.517241379,2858.37931034483,84.5862068965517
"10747","31430","2021",6,6,0,251885,1631.66666666667,160.5
"10748","31431","2021",7,7,0,91985.7142857143,1127.71428571429,80.5714285714286
"10749","31433","2021",94,70,24,236120.670212766,2697.60638297872,86.9255319148936
"10750","31434","2021",2,2,0,139750,1441,97
"10751","31435","2021",14,14,0,304247.142857143,2817.42857142857,113.571428571429
"10752","31436","2021",3,3,0,159930.666666667,1512.33333333333,102.666666666667
"10753","31439","2021",11,11,0,502276.818181818,3202.90909090909,164.818181818182
"10754","31441","2021",5,5,0,225070,2005.6,110.4
"10755","31442","2021",9,9,0,263639,2090.44444444444,129.777777777778
"10756","31443","2021",7,7,0,149611.428571429,1260.42857142857,138.285714285714
"10757","31444","2021",2,2,0,78500,939.5,83.5
"10758","31445","2021",63,45,18,362975.761904762,3776.87301587302,94.8571428571429
"10759","31446","2021",220,54,166,226539.681818182,3028.23181818182,76.3590909090909
"10760","31447","2021",2,2,0,59000,1127,51.5
"10761","31448","2021",1,1,0,503616,3758,134
"10762","31449","2021",2,2,0,150165,1514,96.5
"10763","31450","2021",3,3,0,437796.666666667,3668,118.666666666667
"10764","31451","2021",162,141,21,186521.222222222,1887.96296296296,100.765432098765
"10765","31453","2021",1,1,0,246800,2973,83
"10766","31454","2021",49,35,14,164857.571428571,1931.44897959184,87.3877551020408
"10767","31455","2021",34,34,0,181781.352941176,1701.79411764706,115.235294117647
"10768","31456","2021",1,1,0,123400,1763,70
"10769","31457","2021",16,16,0,119281.25,1298.8125,93.1875
"10770","31458","2021",71,48,23,231207.478873239,2718.18309859155,85.9154929577465
"10771","31459","2021",11,11,0,318968.363636364,2496.36363636364,142.545454545455
"10772","31460","2021",58,34,24,241051.672413793,2563.70689655172,96.6379310344828
"10773","31461","2021",5,5,0,156340,1527,108.2
"10774","31462","2021",49,31,18,333914.489795918,3235.12244897959,97.9795918367347
"10775","31463","2021",6,6,0,252066.666666667,1897,131.333333333333
"10776","31464","2021",1,1,0,275097,1599,172
"10777","31466","2021",14,14,0,262975.142857143,2228.92857142857,118.714285714286
"10778","31467","2021",74,52,22,248924.391891892,2916.89189189189,84.4594594594595
"10779","31468","2021",5,5,0,159300,1542,107.6
"10780","31469","2021",2,2,0,131000,1568.5,86.5
"10781","31470","2021",18,3,15,69565.5,1710.38888888889,37.3333333333333
"10782","31471","2021",17,16,1,91872.9411764706,1133.17647058824,82.7647058823529
"10783","31472","2021",6,6,0,208841.666666667,1454.66666666667,144.666666666667
"10784","31473","2021",7,2,5,165580.714285714,1840.14285714286,84.4285714285714
"10785","31475","2021",20,15,5,229005.75,2465.7,95.35
"10786","31476","2021",14,14,0,216842.142857143,2046.5,121.071428571429
"10787","31477","2021",1,1,0,70000,875,80
"10788","31478","2021",16,16,0,174260.875,1655.6875,104.875
"10789","31479","2021",2,2,0,146890,935,190
"10790","31480","2021",24,21,3,345189.666666667,3405.91666666667,106.583333333333
"10791","31481","2021",30,25,5,244014,2346.56666666667,108.266666666667
"10792","31482","2021",4,4,0,147600,1463.25,93
"10793","31483","2021",244,133,111,100146.237704918,1212.17213114754,81.8565573770492
"10794","31484","2021",26,24,2,287468.807692308,2963.57692307692,95.3461538461538
"10795","31485","2021",1,1,0,120000,1091,110
"10796","31486","2021",26,24,2,217562.307692308,2411.84615384615,93.7692307692308
"10797","31487","2021",2,2,0,150000,1097.5,135.5
"10798","31488","2021",188,114,74,258599.739361702,3099.03723404255,83.7074468085106
"10799","31490","2021",98,78,20,243203.479591837,2531.14285714286,97.0102040816327
"10800","31491","2021",15,14,1,198010,1619.6,132
"10801","31492","2021",18,18,0,180470.944444444,1760.27777777778,107.888888888889
"10802","31493","2021",2,2,0,198000,2039,95
"10803","31494","2021",4,4,0,177714.5,1849,103
"10804","31495","2021",12,12,0,225268,2322.41666666667,98.0833333333333
"10805","31496","2021",1,1,0,192000,1901,101
"10806","31497","2021",23,22,1,327458.47826087,3105.4347826087,106.434782608696
"10807","31499","2021",201,148,53,221020.407960199,2408.62189054726,89.9303482587065
"10808","31500","2021",26,16,10,138175.576923077,1962.07692307692,74.4230769230769
"10809","31501","2021",3,3,0,292269.666666667,2753,107
"10810","31502","2021",6,5,1,173605.333333333,1376,127
"10811","31503","2021",19,18,1,118242.315789474,1282.84210526316,97.4736842105263
"10812","31504","2021",3,3,0,194830,1720.33333333333,113.333333333333
"10813","31505","2021",9,9,0,134973.333333333,1605.55555555556,84.4444444444444
"10814","31506","2021",195,118,77,273044.169230769,3155.71282051282,86.5538461538462
"10815","31507","2021",26,8,18,142889.307692308,2026.46153846154,67
"10816","31509","2021",2,2,0,151000,1887.5,79
"10817","31510","2021",1,1,0,4e+05,1794,223
"10818","31512","2021",7,7,0,254942.857142857,2575.28571428571,98.2857142857143
"10819","31513","2021",7,7,0,166420,1333.57142857143,132.571428571429
"10820","31515","2021",8,8,0,339747.5,3073.625,115.875
"10821","31516","2021",26,25,1,252580.961538462,2702.07692307692,96.4230769230769
"10822","31517","2021",37,35,2,194601.702702703,2181.02702702703,93.6216216216216
"10823","31518","2021",3,3,0,233250,2147.66666666667,109
"10824","31520","2021",2,2,0,135000,1210,121.5
"10825","31521","2021",3,3,0,207133.333333333,1554.66666666667,122
"10826","31522","2021",3,3,0,150266.666666667,1602.33333333333,82
"10827","31523","2021",27,20,7,163417.740740741,1718,93.1111111111111
"10828","31524","2021",1,1,0,185000,1595,116
"10829","31525","2021",10,10,0,268845,2154.8,122.1
"10830","31526","2021",138,91,47,238022.528985507,2748.24637681159,86.2608695652174
"10831","31529","2021",3,3,0,93467,1107,87.3333333333333
"10832","31530","2021",6,6,0,237356.666666667,2001.83333333333,119
"10833","31531","2021",2,2,0,72800,801.5,84.5
"10834","31532","2021",3,3,0,105402,701.666666666667,159.666666666667
"10835","31533","2021",25,20,5,293153.4,2616.92,108.48
"10836","31534","2021",2,2,0,215000,2963.5,74.5
"10837","31535","2021",11,11,0,135565.909090909,1216.36363636364,108.181818181818
"10838","31536","2021",1,1,0,148435,1499,99
"10839","31537","2021",2,2,0,216225,1802,114
"10840","31538","2021",3,3,0,301166.666666667,1857,166.333333333333
"10841","31539","2021",3,3,0,109666.666666667,953,132
"10842","31541","2021",69,26,43,242523.52173913,3011.23188405797,80.231884057971
"10843","31542","2021",1,1,0,110000,1146,96
"10844","31543","2021",2,2,0,171000,1538,131
"10845","31544","2021",11,10,1,89368.6363636364,1077.72727272727,96.2727272727273
"10846","31545","2021",2,2,0,177500,1839,99.5
"10847","31546","2021",1,1,0,3e+05,2521,119
"10848","31547","2021",106,83,23,237460.113207547,2424.56603773585,98.5471698113208
"10849","31550","2021",10,10,0,117916,1301.9,108.6
"10850","31551","2021",6,6,0,283816.666666667,2656,109
"10851","31552","2021",1,1,0,3e+05,1224,245
"10852","31553","2021",17,12,5,196275.882352941,1996.47058823529,100.764705882353
"10853","31554","2021",4,4,0,158042.5,1403,114
"10854","31555","2021",9357,1460,7897,223283.796836593,3555.07256599337,63.5690926579032
"10855","31556","2021",4,4,0,157700,1375,123.5
"10856","31557","2021",368,209,159,301578.760869565,3202.54619565217,91.0271739130435
"10857","31558","2021",4,4,0,269535,2862.75,94.5
"10858","31560","2021",4,4,0,287400,2308,133.5
"10859","31561","2021",150,121,29,330604.466666667,3570.77333333333,93.76
"10860","31562","2021",3,2,1,114666.666666667,872,147
"10861","31563","2021",10,10,0,287736,2598.9,111.5
"10862","31564","2021",2,2,0,148000,867.5,171.5
"10863","31565","2021",15,13,2,86243.3333333333,997.4,86.8666666666667
"10864","31566","2021",4,4,0,211383.75,2032.25,107.25
"10865","31567","2021",5,5,0,409188,3212,129
"10866","31568","2021",1,1,0,617685,3985,155
"10867","31569","2021",6,6,0,374350,2270.66666666667,156.833333333333
"10868","31570","2021",9,9,0,250216.666666667,1629.77777777778,151.222222222222
"10869","31571","2021",2,2,0,183455,1982.5,96
"10870","31572","2021",33,33,0,265397.636363636,2717.69696969697,100.393939393939
"10871","31573","2021",55,51,4,280333.563636364,2803.90909090909,101.509090909091
"10872","31574","2021",40,40,0,265047.1,2765.075,94.325
"10873","31575","2021",16,15,1,900475.9375,5373.75,181.375
"10874","31576","2021",2,2,0,156100,2074.5,72.5
"10875","31577","2021",1,1,0,125000,2500,50
"10876","31578","2021",10,10,0,661273,3383.3,197
"10877","31579","2021",12,12,0,232925.833333333,2130.08333333333,108.75
"10878","31580","2021",17,16,1,233432.941176471,2336.23529411765,103
"10879","31581","2021",17,17,0,232610.588235294,2317.58823529412,102.235294117647
"10880","31582","2021",77,65,12,229798.623376623,2316.63636363636,105.766233766234
"10881","31583","2021",22,22,0,232250.454545455,2027.81818181818,116.681818181818
"10882","31584","2021",126,93,33,161967.658730159,1955.63492063492,85.1507936507936
"10883","31585","2021",26,26,0,164175.192307692,1470.03846153846,112.192307692308
"10884","31586","2021",4,4,0,178775,1845.25,99.5
"10885","31587","2021",13,13,0,277548.461538462,2693.15384615385,101.923076923077
"10886","31588","2021",146,98,48,226275.719178082,2677.38356164384,85.3287671232877
"10887","31589","2021",15,14,1,243861.666666667,2438.06666666667,102.133333333333
"10888","31591","2021",2,2,0,214500,1537,142
"10889","31592","2021",19,19,0,288990.789473684,2442.36842105263,121.631578947368
"10890","31593","2021",1,1,0,205000,1864,110
"10891","32001","2021",8,8,0,143106.25,1203,135.125
"10892","32002","2021",2,2,0,110500,1190.5,91
"10893","32005","2021",5,5,0,136200,1172.6,138.2
"10894","32007","2021",3,3,0,213123.333333333,1884.33333333333,113.333333333333
"10895","32008","2021",3,3,0,119300,1055.33333333333,105.666666666667
"10896","32009","2021",3,3,0,138300,939.666666666667,152.666666666667
"10897","32010","2021",1,1,0,45000,600,75
"10898","32012","2021",21,21,0,194373.238095238,1617.57142857143,125.952380952381
"10899","32013","2021",453,215,238,132809.269315673,1678.26931567329,79.8101545253863
"10900","32014","2021",1,1,0,110000,714,154
"10901","32015","2021",3,3,0,136365,1294,107.666666666667
"10902","32016","2021",10,10,0,284729.6,2560,114.4
"10903","32017","2021",2,2,0,181217,1933.5,93.5
"10904","32019","2021",4,2,2,139500,1503,89.5
"10905","32020","2021",7,7,0,215747.142857143,1566.85714285714,170.428571428571
"10906","32022","2021",3,3,0,95000,1408.66666666667,67.3333333333333
"10907","32023","2021",3,3,0,199285,1632.33333333333,108.666666666667
"10908","32024","2021",6,6,0,109333.333333333,1197.66666666667,101
"10909","32025","2021",2,2,0,255500,1196,230
"10910","32026","2021",1,1,0,180000,1406,128
"10911","32027","2021",40,39,1,169287.25,1668.125,101.15
"10912","32028","2021",5,5,0,146636,1281.4,119.2
"10913","32029","2021",10,10,0,175165.5,1464.5,120.5
"10914","32030","2021",1,1,0,170000,1753,97
"10915","32031","2021",1,1,0,119151,1489,80
"10916","32032","2021",10,10,0,164267.8,1284.9,124.7
"10917","32033","2021",2,2,0,160545,1562.5,99.5
"10918","32034","2021",1,1,0,326000,2717,120
"10919","32035","2021",3,3,0,138866.666666667,1471.66666666667,97.3333333333333
"10920","32036","2021",8,8,0,209371.25,1513.75,143.5
"10921","32037","2021",2,2,0,552837.5,1662.5,255
"10922","32038","2021",2,2,0,294675,2819,111
"10923","32039","2021",3,3,0,180333.333333333,1991.66666666667,98.6666666666667
"10924","32041","2021",4,4,0,170850,1335.5,134.5
"10925","32042","2021",2,2,0,140000,1489,92
"10926","32044","2021",4,4,0,225960,1867,122
"10927","32045","2021",11,11,0,227934.363636364,2038.09090909091,113.363636363636
"10928","32046","2021",2,2,0,160500,1510.5,110
"10929","32047","2021",4,4,0,234750,2065.25,120.5
"10930","32048","2021",3,3,0,275196.666666667,1794,144.333333333333
"10931","32049","2021",5,5,0,120590,962.4,120.8
"10932","32050","2021",2,2,0,119400,1111.5,100
"10933","32051","2021",1,1,0,165000,1571,105
"10934","32052","2021",1,1,0,198000,2640,75
"10935","32054","2021",7,7,0,193968.571428571,1529.42857142857,132
"10936","32057","2021",3,3,0,406705,2990,154
"10937","32059","2021",2,2,0,366173,1909.5,161.5
"10938","32060","2021",3,3,0,162850,1580.33333333333,103.333333333333
"10939","32061","2021",4,4,0,265547.5,1887.75,147.75
"10940","32062","2021",4,3,1,147360,1589,93.5
"10941","32063","2021",3,3,0,116566.666666667,872,150.666666666667
"10942","32064","2021",9,9,0,182950,1344.22222222222,138.888888888889
"10943","32065","2021",5,4,1,98627,1212,114.2
"10944","32066","2021",2,2,0,186977.5,2077,90
"10945","32067","2021",2,2,0,182750,1644.5,111
"10946","32068","2021",4,4,0,366703,1911.5,168.25
"10947","32070","2021",2,2,0,160000,1504.5,110
"10948","32071","2021",1,1,0,182310,1805,101
"10949","32072","2021",1,1,0,70000,1000,70
"10950","32073","2021",2,2,0,129550,811,153
"10951","32075","2021",4,4,0,181250,1795,105
"10952","32076","2021",12,12,0,155212.916666667,1355,118.916666666667
"10953","32077","2021",2,2,0,480000,2125,217.5
"10954","32078","2021",4,4,0,97250,1544.5,87.5
"10955","32079","2021",31,31,0,125227.741935484,1444.25806451613,96.5806451612903
"10956","32080","2021",4,4,0,193500,1938.5,100.25
"10957","32081","2021",5,5,0,235684,1677.4,141
"10958","32082","2021",7,7,0,229392.857142857,1808.14285714286,124.142857142857
"10959","32083","2021",16,12,4,113831.25,1159.5625,93.25
"10960","32086","2021",4,4,0,148562.5,1120.5,128
"10961","32087","2021",4,4,0,129250,1382.25,110
"10962","32088","2021",2,2,0,172650,1557.5,116
"10963","32089","2021",1,1,0,147000,2410,61
"10964","32090","2021",2,2,0,450000,4146.5,123.5
"10965","32091","2021",3,3,0,210166.666666667,2023.33333333333,106.333333333333
"10966","32093","2021",2,2,0,170300,1203,145
"10967","32094","2021",6,6,0,159507.166666667,1355.33333333333,121.166666666667
"10968","32095","2021",10,10,0,220232,1286.7,163.9
"10969","32096","2021",71,18,53,63011.1690140845,1247.66197183099,53.7605633802817
"10970","32097","2021",6,6,0,85916.6666666667,1369.16666666667,67
"10971","32098","2021",6,6,0,245566.666666667,2293.66666666667,119.166666666667
"10972","32099","2021",3,3,0,183600,1967,91.6666666666667
"10973","32100","2021",2,2,0,119750,1603,74.5
"10974","32101","2021",2,2,0,185416.5,2636,139.5
"10975","32102","2021",5,5,0,171510,1241,142.8
"10976","32103","2021",4,4,0,125512.5,1266.75,101.75
"10977","32104","2021",3,3,0,164826.666666667,1695.33333333333,96.3333333333333
"10978","32105","2021",4,4,0,286805,2233.75,131
"10979","32106","2021",9,9,0,184880,1753.55555555556,104.777777777778
"10980","32107","2021",149,134,15,155193.744966443,1317.13422818792,116.201342281879
"10981","32108","2021",2,2,0,135000,1032,121.5
"10982","32109","2021",8,8,0,139678.75,1031.625,138.5
"10983","32110","2021",8,8,0,190750,1677.125,112.5
"10984","32111","2021",1,1,0,480000,2400,200
"10985","32112","2021",3,3,0,278183.333333333,1747,160.333333333333
"10986","32113","2021",2,2,0,183000,2610.5,79
"10987","32114","2021",3,3,0,107333.333333333,1571.33333333333,75
"10988","32115","2021",8,8,0,179906.25,1463,128.25
"10989","32116","2021",1,1,0,70000,1167,60
"10990","32117","2021",12,12,0,260957,2304.75,115.583333333333
"10991","32118","2021",1,1,0,325000,2181,149
"10992","32119","2021",69,62,7,136595.507246377,1378.76811594203,101.913043478261
"10993","32120","2021",4,4,0,301365,2428.25,127
"10994","32121","2021",9,9,0,277372.222222222,1810.44444444444,146.222222222222
"10995","32123","2021",6,6,0,291416.666666667,1900,151
"10996","32124","2021",6,6,0,176622.666666667,2206.66666666667,85
"10997","32125","2021",2,2,0,137750,1296,105.5
"10998","32126","2021",5,5,0,260150,1597.8,164.2
"10999","32127","2021",17,17,0,142635,1333.47058823529,108.058823529412
"11000","32128","2021",3,3,0,152333.333333333,1297.33333333333,120
"11001","32129","2021",2,1,1,152966,1155.5,138
"11002","32131","2021",2,2,0,126500,856,145
"11003","32132","2021",114,93,21,140472.49122807,1469.78947368421,100.210526315789
"11004","32133","2021",5,5,0,109542,915.8,125.6
"11005","32135","2021",1,1,0,135000,1174,115
"11006","32136","2021",3,3,0,96600,885.333333333333,108.333333333333
"11007","32138","2021",2,2,0,195000,1847,104.5
"11008","32139","2021",1,1,0,164050,1823,90
"11009","32140","2021",2,2,0,214860,1960,112.5
"11010","32141","2021",2,2,0,184500,2159.5,78
"11011","32142","2021",3,3,0,183833.333333333,1130.66666666667,156.666666666667
"11012","32143","2021",8,8,0,259202.875,1958.125,142.125
"11013","32144","2021",3,3,0,201666.666666667,1937.33333333333,105.333333333333
"11014","32146","2021",2,2,0,119950,1437,81.5
"11015","32147","2021",50,43,7,154387.3,1583.64,103.66
"11016","32148","2021",1,1,0,424000,2827,150
"11017","32149","2021",21,21,0,206871.761904762,1459.38095238095,139.761904761905
"11018","32152","2021",5,5,0,157446,1273,135.4
"11019","32153","2021",1,1,0,201925,1402,144
"11020","32154","2021",2,2,0,202500,1513,133
"11021","32155","2021",16,16,0,124373.125,1279.9375,103.625
"11022","32156","2021",3,3,0,236833.333333333,1798.33333333333,130.333333333333
"11023","32157","2021",4,4,0,143727.5,1585.75,87.75
"11024","32158","2021",7,7,0,280114.285714286,1649.71428571429,161.857142857143
"11025","32159","2021",10,10,0,101755,837.1,132.6
"11026","32160","2021",163,118,45,234365.134969325,2508.63190184049,91.3374233128834
"11027","32161","2021",1,1,0,120000,1463,82
"11028","32162","2021",19,18,1,141583.263157895,1173.63157894737,124.578947368421
"11029","32163","2021",6,6,0,157166.666666667,1750,89.6666666666667
"11030","32164","2021",1,1,0,155000,1566,99
"11031","32165","2021",2,2,0,146879,1070,131.5
"11032","32166","2021",1,1,0,55000,500,110
"11033","32167","2021",3,3,0,201666.666666667,1193.33333333333,146.333333333333
"11034","32169","2021",2,2,0,95000,978,95
"11035","32170","2021",3,3,0,163000,1384.66666666667,110.333333333333
"11036","32171","2021",4,4,0,245037.5,2367.75,105.5
"11037","32172","2021",4,4,0,117037.5,867.5,127.75
"11038","32173","2021",5,5,0,147650,1284,122.6
"11039","32174","2021",4,4,0,152500,1453.5,116.5
"11040","32175","2021",1,1,0,141560,1490,95
"11041","32176","2021",1,1,0,120000,916,131
"11042","32177","2021",4,4,0,206125,1960.75,107.75
"11043","32178","2021",1,1,0,603740,4472,135
"11044","32180","2021",4,4,0,158125,1435.5,114
"11045","32181","2021",6,6,0,170500,893.333333333333,183.666666666667
"11046","32182","2021",1,1,0,183990,1179,156
"11047","32184","2021",3,2,1,196016.666666667,1496,124
"11048","32185","2021",2,2,0,165297.5,1637.5,98
"11049","32186","2021",3,3,0,200313.333333333,1389.33333333333,146
"11050","32187","2021",2,2,0,100500,568.5,177.5
"11051","32188","2021",2,2,0,208500,1425,140
"11052","32190","2021",9,9,0,141495.555555556,1025.11111111111,154.888888888889
"11053","32191","2021",1,1,0,355500,2821,126
"11054","32192","2021",3,3,0,110950,1159.66666666667,91
"11055","32193","2021",6,6,0,133509.5,1085.5,125.333333333333
"11056","32194","2021",2,2,0,345500,2272.5,160
"11057","32195","2021",1,1,0,76000,864,88
"11058","32196","2021",4,4,0,297144.25,2127.5,123.5
"11059","32198","2021",2,2,0,247805,2012,132
"11060","32199","2021",3,3,0,161333.333333333,935.666666666667,182.666666666667
"11061","32200","2021",7,7,0,239614.285714286,1805.85714285714,131.857142857143
"11062","32201","2021",4,4,0,165914.25,1405.75,114.75
"11063","32202","2021",7,6,1,142428.571428571,1313.85714285714,109.857142857143
"11064","32203","2021",5,5,0,151048,1489,107.4
"11065","32204","2021",5,5,0,164800,1751.4,94.8
"11066","32205","2021",1,1,0,277300,2773,100
"11067","32206","2021",4,4,0,248362.5,1540.5,174
"11068","32207","2021",1,1,0,245000,3025,81
"11069","32208","2021",73,60,13,191075.095890411,1669.75342465753,108.835616438356
"11070","32209","2021",2,2,0,58950,573.5,102.5
"11071","32210","2021",2,2,0,2e+05,3088.5,66.5
"11072","32211","2021",1,1,0,1e+05,1587,63
"11073","32212","2021",3,3,0,186666.666666667,1119,165.333333333333
"11074","32213","2021",45,40,5,159177.066666667,1397.88888888889,116.2
"11075","32215","2021",3,3,0,189366.666666667,1434.33333333333,134
"11076","32216","2021",3,3,0,141633.333333333,1341,130
"11077","32217","2021",1,1,0,205000,1507,136
"11078","32218","2021",2,2,0,337500,1981.5,168.5
"11079","32219","2021",6,6,0,160655.5,1459.33333333333,104.666666666667
"11080","32220","2021",4,4,0,155375,1194,146
"11081","32221","2021",2,2,0,233030,2242,103
"11082","32222","2021",3,3,0,184000,1465,125
"11083","32223","2021",1,1,0,352890,1764,200
"11084","32224","2021",3,3,0,392383.333333333,3013.33333333333,124.333333333333
"11085","32225","2021",1,1,0,250000,1562,160
"11086","32227","2021",16,16,0,113940.5625,1124.6875,100.0625
"11087","32228","2021",1,1,0,130000,1625,80
"11088","32230","2021",1,1,0,235000,1567,150
"11089","32231","2021",5,5,0,146500,1518,94.8
"11090","32232","2021",1,1,0,167000,1856,90
"11091","32233","2021",42,32,10,89895.8809523809,1217.80952380952,74.5
"11092","32234","2021",8,8,0,347731.25,2354.75,149
"11093","32235","2021",6,6,0,166516.666666667,1257.16666666667,121.166666666667
"11094","32237","2021",3,3,0,211714.333333333,2611.66666666667,84
"11095","32238","2021",2,2,0,170500,1785,95
"11096","32239","2021",5,5,0,397446,2397.2,156.6
"11097","32241","2021",4,4,0,332850,2194.5,152
"11098","32242","2021",24,22,2,82335.5,959.916666666667,92.3333333333333
"11099","32243","2021",14,14,0,126625,1100.35714285714,119.857142857143
"11100","32244","2021",6,6,0,141978.333333333,1525.33333333333,97.1666666666667
"11101","32246","2021",7,7,0,190428.571428571,1480.85714285714,153.428571428571
"11102","32247","2021",1,1,0,270000,2348,115
"11103","32248","2021",3,3,0,107983.333333333,977.333333333333,126
"11104","32249","2021",44,36,8,147571.068181818,1499.84090909091,94.8409090909091
"11105","32250","2021",1,1,0,402403,1829,220
"11106","32251","2021",1,1,0,280000,2205,127
"11107","32252","2021",30,29,1,115589.7,983.166666666667,117.033333333333
"11108","32253","2021",17,17,0,180282.941176471,1173.76470588235,144.647058823529
"11109","32254","2021",10,10,0,216801,1409.8,155.6
"11110","32255","2021",2,2,0,144612.5,1372.5,103
"11111","32256","2021",57,53,4,139523.315789474,1562.80701754386,97.4561403508772
"11112","32257","2021",1,1,0,118500,598,198
"11113","32258","2021",2,2,0,85470,894,100
"11114","32260","2021",2,2,0,199967.5,960.5,222.5
"11115","32261","2021",2,2,0,178000,2056.5,86.5
"11116","32262","2021",4,4,0,308692.5,2738.25,122.5
"11117","32263","2021",2,2,0,244173.5,1550,169.5
"11118","32264","2021",3,3,0,82800,825.666666666667,99.6666666666667
"11119","32265","2021",1,1,0,58000,1933,30
"11120","32266","2021",4,4,0,166995,1549,108.75
"11121","32268","2021",13,13,0,222413.538461538,2030.15384615385,111.692307692308
"11122","32269","2021",14,14,0,171176.428571429,1562.92857142857,108.571428571429
"11123","32271","2021",3,3,0,106666.666666667,989.333333333333,101.666666666667
"11124","32272","2021",1,1,0,105000,981,107
"11125","32273","2021",2,2,0,237625,1146,204.5
"11126","32274","2021",3,3,0,111666.666666667,1126.66666666667,101.666666666667
"11127","32277","2021",2,2,0,335250,1716.5,194.5
"11128","32278","2021",1,1,0,285000,2050,139
"11129","32279","2021",7,7,0,191195.714285714,1591,120.857142857143
"11130","32280","2021",3,3,0,209833.333333333,1106.66666666667,187.666666666667
"11131","32281","2021",2,2,0,185675,1430.5,124.5
"11132","32282","2021",6,6,0,193425,1652.83333333333,121
"11133","32283","2021",4,4,0,190367,1173,152
"11134","32284","2021",2,2,0,310275,1294,245.5
"11135","32285","2021",5,5,0,142066.8,1568,94.4
"11136","32286","2021",12,12,0,180191.666666667,2318.75,89.5
"11137","32287","2021",2,2,0,147602.5,849,174
"11138","32288","2021",1,1,0,371050,1508,246
"11139","32289","2021",3,3,0,104766.666666667,694.333333333333,147.333333333333
"11140","32290","2021",19,18,1,169035.789473684,1375.31578947368,117.736842105263
"11141","32291","2021",3,3,0,192300,1436.33333333333,152
"11142","32292","2021",7,7,0,99403,906.571428571429,110.857142857143
"11143","32293","2021",5,5,0,160166.4,880.8,158.4
"11144","32294","2021",3,3,0,229146.666666667,1641,140.666666666667
"11145","32295","2021",3,3,0,237276.666666667,1813.33333333333,132.666666666667
"11146","32296","2021",31,25,6,148667.774193548,1556.61290322581,95.0645161290323
"11147","32297","2021",3,3,0,225250,1597.66666666667,148.666666666667
"11148","32298","2021",10,10,0,230000.3,1809.3,128.7
"11149","32299","2021",2,2,0,139800,1525,93.5
"11150","32300","2021",5,5,0,139041.6,1721.4,87.4
"11151","32301","2021",14,14,0,214144.285714286,1862.28571428571,120.285714285714
"11152","32302","2021",1,1,0,95000,679,140
"11153","32303","2021",3,3,0,179233.333333333,1221.33333333333,146.666666666667
"11154","32304","2021",5,5,0,129937.4,1449.4,100.4
"11155","32305","2021",11,11,0,159192.090909091,1316.09090909091,116.727272727273
"11156","32306","2021",10,10,0,194400.3,1398,137.7
"11157","32307","2021",36,32,4,177166.777777778,1690.55555555556,105.388888888889
"11158","32309","2021",3,3,0,223666.666666667,1851.33333333333,114.666666666667
"11159","32310","2021",2,2,0,92500,936,106
"11160","32311","2021",4,4,0,219037.5,1972.5,119.25
"11161","32312","2021",6,6,0,219022.666666667,1977.66666666667,114.333333333333
"11162","32313","2021",1,1,0,97000,647,150
"11163","32315","2021",3,3,0,175000,1098.66666666667,157.333333333333
"11164","32316","2021",1,1,0,690000,1725,400
"11165","32317","2021",2,2,0,73000,774,91
"11166","32319","2021",45,45,0,127973.155555556,1139.31111111111,111.377777777778
"11167","32320","2021",2,2,0,88750,838,112.5
"11168","32321","2021",2,2,0,205325,1741,127
"11169","32322","2021",2,2,0,351000,2611.5,139
"11170","32323","2021",4,4,0,241730,1429.25,167.5
"11171","32324","2021",4,4,0,254425,1002,254
"11172","32325","2021",4,4,0,213758,1395.75,167
"11173","32326","2021",3,3,0,219000,1411.33333333333,150.666666666667
"11174","32327","2021",1,1,0,161000,756,213
"11175","32329","2021",4,4,0,209359.5,1271.75,174.75
"11176","32330","2021",4,4,0,122375,1002.5,128
"11177","32331","2021",13,9,4,142320.769230769,1497.46153846154,93.0769230769231
"11178","32332","2021",1,1,0,130000,833,156
"11179","32333","2021",2,2,0,236790,1599.5,146
"11180","32334","2021",23,19,4,283956.652173913,2611,112.739130434783
"11181","32335","2021",10,10,0,218055.5,1802.1,114.6
"11182","32336","2021",3,3,0,221900,1731.33333333333,141.333333333333
"11183","32338","2021",5,5,0,151800,1452.6,106.2
"11184","32339","2021",5,5,0,260562.4,1829,159.8
"11185","32340","2021",7,7,0,169714.285714286,1672,113.428571428571
"11186","32341","2021",2,2,0,134464.5,937.5,133.5
"11187","32342","2021",2,2,0,169575,1468,109.5
"11188","32343","2021",2,2,0,69250,637.5,110
"11189","32344","2021",41,41,0,121334.146341463,1289.53658536585,99.8048780487805
"11190","32345","2021",13,13,0,250361.538461538,1875.38461538462,137.153846153846
"11191","32346","2021",3,3,0,203333.333333333,2202,88
"11192","32347","2021",1,1,0,150000,1744,86
"11193","32348","2021",4,4,0,265700,2087.75,131
"11194","32349","2021",2,2,0,264930,2694,98
"11195","32351","2021",3,3,0,173600,1452.66666666667,121.666666666667
"11196","32352","2021",1,1,0,210000,1981,106
"11197","32353","2021",1,1,0,2e+05,1961,102
"11198","32354","2021",4,4,0,174500,1410.25,124.75
"11199","32356","2021",1,1,0,194490,2047,95
"11200","32358","2021",6,6,0,181039,1970.66666666667,103.333333333333
"11201","32359","2021",2,2,0,215250,1336.5,166.5
"11202","32360","2021",4,4,0,131750,1308,99.5
"11203","32361","2021",2,2,0,141500,1181,129
"11204","32362","2021",5,5,0,114374,1551.8,71.2
"11205","32363","2021",1,1,0,113650,1196,95
"11206","32365","2021",3,3,0,81766.6666666667,961.333333333333,84
"11207","32367","2021",1,1,0,1e+05,483,207
"11208","32368","2021",5,5,0,97600,1098.6,86.8
"11209","32369","2021",3,3,0,277000,2217,145
"11210","32370","2021",17,16,1,169289.411764706,1388.94117647059,120.588235294118
"11211","32372","2021",4,4,0,246720,1660,148.25
"11212","32373","2021",4,4,0,183875,1306.5,145
"11213","32374","2021",3,3,0,153370,1755,97.3333333333333
"11214","32375","2021",3,3,0,161000,1282.66666666667,125.666666666667
"11215","32376","2021",3,3,0,152996.666666667,1320.66666666667,117.666666666667
"11216","32377","2021",4,4,0,314222.5,1482.5,206.75
"11217","32378","2021",6,6,0,152333.333333333,1239.83333333333,128.5
"11218","32379","2021",5,5,0,200312,2841.6,80
"11219","32380","2021",3,3,0,136366.666666667,1107,126.666666666667
"11220","32381","2021",1,1,0,93000,1045,89
"11221","32382","2021",8,8,0,180125,1184.625,153.5
"11222","32383","2021",2,2,0,196400,1075.5,184
"11223","32384","2021",4,4,0,270312.5,1950.75,140
"11224","32385","2021",3,3,0,146400,1784.66666666667,81.6666666666667
"11225","32386","2021",3,3,0,216170,1731.33333333333,135.333333333333
"11226","32387","2021",1,1,0,231500,1690,137
"11227","32388","2021",9,9,0,222486.888888889,1766.88888888889,128.222222222222
"11228","32389","2021",9,9,0,186000,1828,104
"11229","32390","2021",1,1,0,73000,869,84
"11230","32391","2021",1,1,0,162000,953,170
"11231","32393","2021",1,1,0,313550,1695,185
"11232","32394","2021",4,4,0,130650,1180.25,123.25
"11233","32395","2021",1,1,0,110000,1068,103
"11234","32396","2021",5,5,0,157358.6,1292.8,123.4
"11235","32397","2021",5,5,0,237000,961.4,270.8
"11236","32398","2021",3,3,0,185560,1167.66666666667,163.333333333333
"11237","32399","2021",2,2,0,260000,2401.5,122.5
"11238","32400","2021",4,4,0,272302.5,2001.75,143.75
"11239","32401","2021",2,2,0,185100,1281,163.5
"11240","32402","2021",3,3,0,311700,1951.33333333333,161.333333333333
"11241","32404","2021",13,13,0,261855.769230769,1759.30769230769,149.076923076923
"11242","32405","2021",2,2,0,380000,2658,144.5
"11243","32406","2021",11,11,0,161349.090909091,1230.45454545455,129.272727272727
"11244","32409","2021",2,2,0,145275,1106,135
"11245","32410","2021",44,41,3,201110.045454545,2025.79545454545,104.159090909091
"11246","32412","2021",26,25,1,146140.5,1520.26923076923,97.5384615384615
"11247","32413","2021",1,1,0,107000,399,268
"11248","32414","2021",2,2,0,93500,869,110
"11249","32415","2021",3,3,0,229133.333333333,1952,112
"11250","32416","2021",8,8,0,378166.25,2431.5,146.125
"11251","32417","2021",11,11,0,212290.454545455,1492.18181818182,138
"11252","32418","2021",7,7,0,219692.857142857,1429.14285714286,151.714285714286
"11253","32419","2021",1,1,0,170000,766,222
"11254","32422","2021",1,1,0,250000,1543,162
"11255","32424","2021",2,2,0,237350,1945.5,120.5
"11256","32425","2021",8,8,0,272734.25,2884.125,94.625
"11257","32426","2021",18,18,0,203315,1576.77777777778,120.722222222222
"11258","32427","2021",1,1,0,223000,1939,115
"11259","32429","2021",2,2,0,325775,1812,185
"11260","32430","2021",1,1,0,30500,347,88
"11261","32431","2021",2,2,0,222500,1412.5,154.5
"11262","32432","2021",2,2,0,254750,2092,128
"11263","32433","2021",14,12,2,138740.357142857,1385.92857142857,90.9285714285714
"11264","32434","2021",3,3,0,296166.666666667,1686,146.666666666667
"11265","32436","2021",12,12,0,200612.5,1411.91666666667,144.083333333333
"11266","32437","2021",4,4,0,134000,1415.75,88.25
"11267","32439","2021",8,8,0,90347.5,885.375,117.375
"11268","32440","2021",2,2,0,203300,1029,196
"11269","32441","2021",1,1,0,440000,2529,174
"11270","32442","2021",7,7,0,230271.428571429,1528.57142857143,162.571428571429
"11271","32443","2021",4,4,0,123500,1065,123
"11272","32444","2021",2,2,0,297725,2376.5,124.5
"11273","32445","2021",2,2,0,167850,1265.5,140
"11274","32446","2021",7,7,0,181107.142857143,1716,117
"11275","32447","2021",1,1,0,255500,1762,145
"11276","32448","2021",12,11,1,181323.333333333,1631.58333333333,121.833333333333
"11277","32449","2021",5,5,0,161380,1334,118.2
"11278","32450","2021",1,1,0,107000,1189,90
"11279","32451","2021",7,7,0,250472.142857143,1905.14285714286,133.285714285714
"11280","32452","2021",4,4,0,146620.5,1341.5,107.5
"11281","32455","2021",3,3,0,129500,1178.33333333333,106.666666666667
"11282","32457","2021",2,2,0,148700,1687,91
"11283","32458","2021",6,6,0,135666.666666667,1408.33333333333,111.666666666667
"11284","32459","2021",15,15,0,159900,1331.4,122
"11285","32460","2021",6,6,0,205785,1591.66666666667,122.5
"11286","32461","2021",2,2,0,310000,1458,248
"11287","32462","2021",70,69,1,122363.857142857,1185.58571428571,102.942857142857
"11288","32463","2021",10,10,0,130946.5,1268.8,122.2
"11289","32464","2021",14,13,1,151075.785714286,1301.85714285714,116.928571428571
"11290","32465","2021",1,1,0,162000,2077,78
"11291","32466","2021",1,1,0,20000,333,60
"11292","32467","2021",1,1,0,229000,2726,84
"11293","33001","2021",27,26,1,166670.407407407,1769.55555555556,99.037037037037
"11294","33002","2021",11,11,0,222432.181818182,2011.18181818182,121.727272727273
"11295","33003","2021",208,179,29,264568.120192308,2957.69711538462,91.4134615384615
"11296","33004","2021",37,33,4,199464.216216216,2360.43243243243,88.4864864864865
"11297","33005","2021",298,230,68,448807.379194631,5402.39261744966,87.2986577181208
"11298","33006","2021",9,9,0,108085.777777778,1083.88888888889,97.2222222222222
"11299","33007","2021",14,14,0,314521.428571429,2907.92857142857,113.214285714286
"11300","33008","2021",3,3,0,196000,2082.33333333333,96.6666666666667
"11301","33009","2021",592,150,442,472444.783783784,7398.41047297297,64.5945945945946
"11302","33010","2021",8,8,0,290343.75,2244.5,128.875
"11303","33011","2021",213,168,45,366857.295774648,4601.34741784038,81.7089201877934
"11304","33012","2021",51,50,1,376649.68627451,3299.94117647059,116.039215686275
"11305","33013","2021",107,80,27,287444.859813084,3338.18691588785,88.018691588785
"11306","33014","2021",10,10,0,167115,1880.4,96.8
"11307","33015","2021",30,27,3,217603.133333333,2162,101.933333333333
"11308","33016","2021",4,4,0,253062.5,3169.75,80.75
"11309","33017","2021",3,3,0,300566.666666667,1887.66666666667,159
"11310","33018","2021",50,45,5,212949.92,2298.74,94.94
"11311","33019","2021",179,125,54,302339.418994413,3697.98324022346,82.1620111731844
"11312","33020","2021",2,2,0,407000,3156.5,119.5
"11313","33021","2021",19,19,0,205129.736842105,1935.10526315789,110.421052631579
"11314","33022","2021",48,44,4,286868.125,2781.20833333333,107.166666666667
"11315","33023","2021",22,22,0,336270.454545455,2971.04545454545,115.5
"11316","33025","2021",9,9,0,214964.444444444,1858.22222222222,123
"11317","33026","2021",2,2,0,215650,2737,81
"11318","33027","2021",4,4,0,189637.5,1785.75,111.25
"11319","33028","2021",15,15,0,268386.8,2422.73333333333,114.2
"11320","33029","2021",70,62,8,332127.142857143,3150.64285714286,108.042857142857
"11321","33030","2021",43,43,0,202113,1962.6976744186,104.674418604651
"11322","33031","2021",1,1,0,140000,511,274
"11323","33032","2021",61,37,24,240954.393442623,3115.73770491803,78.9672131147541
"11324","33033","2021",9,7,2,460382.222222222,4437.22222222222,94.2222222222222
"11325","33034","2021",8,8,0,160000,1653.375,96.75
"11326","33035","2021",9,9,0,167039.444444444,1926.77777777778,104.777777777778
"11327","33036","2021",61,58,3,208817.327868852,1852.62295081967,121.688524590164
"11328","33037","2021",28,27,1,311854.571428571,3294.25,97.8214285714286
"11329","33038","2021",15,15,0,171933.333333333,1794.4,99.9333333333333
"11330","33039","2021",529,301,228,314731.90926276,4175.97920604915,75.8090737240076
"11331","33040","2021",16,16,0,192393.75,2056.1875,105.3125
"11332","33042","2021",94,89,5,293096.35106383,2964.07446808511,100.382978723404
"11333","33043","2021",3,3,0,131666.666666667,1380.33333333333,91.6666666666667
"11334","33044","2021",3,3,0,408133.333333333,2402,178
"11335","33045","2021",2,2,0,48284.5,635.5,66.5
"11336","33046","2021",23,22,1,225972.869565217,1988.78260869565,115.130434782609
"11337","33047","2021",23,23,0,165596.826086957,1565.65217391304,113.782608695652
"11338","33048","2021",2,2,0,223750,1874,111.5
"11339","33049","2021",38,38,0,306227.263157895,2849.44736842105,113.789473684211
"11340","33050","2021",6,6,0,220897.5,1894.83333333333,123.666666666667
"11341","33051","2021",199,159,40,293301.201005025,3462.39195979899,87.0150753768844
"11342","33052","2021",23,17,6,191110.869565217,2136.52173913043,93.1739130434783
"11343","33053","2021",3,3,0,217666.666666667,1778.33333333333,120.666666666667
"11344","33054","2021",2,2,0,155000,1769.5,87.5
"11345","33055","2021",6,6,0,249095,1866.33333333333,133.666666666667
"11346","33056","2021",178,107,71,294368.584269663,3454.65168539326,87.9550561797753
"11347","33057","2021",10,10,0,163450,1379.1,137
"11348","33058","2021",132,89,43,124259.181818182,1535.95454545455,83.5681818181818
"11349","33059","2021",4,4,0,217825,1721.75,124.5
"11350","33060","2021",7,7,0,230415.857142857,2439.42857142857,107.571428571429
"11351","33061","2021",14,14,0,400738.285714286,3462.78571428571,114.642857142857
"11352","33062","2021",3,3,0,302250,2314.33333333333,126.333333333333
"11353","33063","2021",5473,1500,3973,358222.93824228,4944.85839576101,73.0641330166271
"11354","33064","2021",1,1,0,129000,1466,88
"11355","33065","2021",36,35,1,566690.305555556,4114.30555555556,139.166666666667
"11356","33066","2021",2,2,0,72283.5,642.5,112.5
"11357","33067","2021",46,44,2,173880.282608696,1831.82608695652,98.8695652173913
"11358","33068","2021",1,1,0,1e+05,1000,100
"11359","33069","2021",553,251,302,402128.356238698,4600.07956600362,85.1374321880651
"11360","33070","2021",15,15,0,286417.333333333,2689,107.866666666667
"11361","33071","2021",13,13,0,267860.769230769,1853.30769230769,155.307692307692
"11362","33072","2021",2,2,0,235050,1979,113.5
"11363","33073","2021",26,26,0,124958.115384615,1287.73076923077,100.115384615385
"11364","33075","2021",416,150,266,295059.932692308,3799.96394230769,76.4495192307692
"11365","33076","2021",8,8,0,252468.75,1799.125,137.875
"11366","33077","2021",31,31,0,331693.387096774,2826.09677419355,119.645161290323
"11367","33078","2021",10,10,0,217470,2011.5,114.6
"11368","33079","2021",5,5,0,318288,2473.4,135.6
"11369","33080","2021",115,78,37,265956.191304348,3429.64347826087,79.0695652173913
"11370","33081","2021",37,24,13,171721.27027027,2181.54054054054,80.3513513513514
"11371","33082","2021",24,24,0,253475.458333333,2561.20833333333,101.041666666667
"11372","33083","2021",14,14,0,348501.714285714,3098.28571428571,115
"11373","33084","2021",29,24,5,324794.275862069,3201.51724137931,98.448275862069
"11374","33085","2021",50,50,0,422736.9,3544.48,120.88
"11375","33086","2021",4,4,0,405187.5,2973.5,132.25
"11376","33087","2021",7,7,0,201835.714285714,1422.57142857143,145.857142857143
"11377","33088","2021",3,3,0,149500,1839.66666666667,77.3333333333333
"11378","33089","2021",6,6,0,152758.333333333,1353.66666666667,113.666666666667
"11379","33090","2021",52,50,2,373227.403846154,3736.09615384615,105.173076923077
"11380","33093","2021",14,14,0,235947.428571429,2584.5,93.2142857142857
"11381","33094","2021",5,5,0,174900,1934.6,94.2
"11382","33095","2021",20,20,0,157696.5,1493.55,103.65
"11383","33096","2021",127,89,38,250167.874015748,3272.81102362205,82.9133858267717
"11384","33097","2021",98,53,45,231897.030612245,3583.38775510204,68.3163265306122
"11385","33098","2021",10,10,0,199570,2043.8,104.1
"11386","33099","2021",59,58,1,408781.779661017,3455.25423728814,122.322033898305
"11387","33100","2021",13,13,0,134615,1284.53846153846,105.076923076923
"11388","33101","2021",7,7,0,161835.714285714,1664.14285714286,99.1428571428571
"11389","33102","2021",6,6,0,155550,990.5,147.5
"11390","33103","2021",3,3,0,136533.333333333,1413.33333333333,96.6666666666667
"11391","33104","2021",99,75,24,223667.070707071,2615.26262626263,88.4040404040404
"11392","33105","2021",3,3,0,225383.333333333,1666,125
"11393","33106","2021",20,19,1,214435.7,1659.2,134
"11394","33108","2021",61,53,8,132581.803278689,1363.09836065574,102.081967213115
"11395","33109","2021",36,36,0,274813.972222222,2893.25,96.8888888888889
"11396","33111","2021",17,16,1,181555.941176471,1583.52941176471,120.117647058824
"11397","33112","2021",2,2,0,277447.5,1838,142
"11398","33114","2021",58,34,24,165842.931034483,1956.43103448276,87.7068965517241
"11399","33115","2021",4,4,0,176537.5,1270,138
"11400","33116","2021",4,4,0,272252,1982,135.5
"11401","33117","2021",2,2,0,208375,1492,139.5
"11402","33118","2021",26,26,0,496821.884615385,3875.11538461538,126.692307692308
"11403","33119","2021",371,157,214,227103.409703504,3400.75741239892,67.1698113207547
"11404","33120","2021",36,36,0,262295.25,2185.80555555556,123.222222222222
"11405","33121","2021",1,1,0,241000,1181,204
"11406","33122","2021",175,168,7,422084.005714286,3748.68,116.577142857143
"11407","33123","2021",30,30,0,238495.066666667,1877.53333333333,127.633333333333
"11408","33124","2021",7,7,0,202798.857142857,1518.85714285714,125.285714285714
"11409","33125","2021",33,33,0,239095.484848485,2147.84848484848,106.606060606061
"11410","33126","2021",13,13,0,200080.769230769,1927.92307692308,106.307692307692
"11411","33127","2021",6,6,0,246000,1457.83333333333,164.166666666667
"11412","33128","2021",12,12,0,152371.583333333,1369.25,119.25
"11413","33129","2021",2,2,0,250200,2125.5,117.5
"11414","33130","2021",17,17,0,310530.882352941,2594.05882352941,121.882352941176
"11415","33131","2021",6,6,0,227733.333333333,2289.5,93.8333333333333
"11416","33132","2021",13,13,0,234523.076923077,1999.84615384615,124.307692307692
"11417","33133","2021",3,3,0,244466.666666667,1696,157.333333333333
"11418","33134","2021",2,2,0,171500,2092.5,85.5
"11419","33136","2021",4,4,0,165325,1807.25,97.5
"11420","33137","2021",2,2,0,112500,1119,100
"11421","33138","2021",161,124,37,153330.826086957,1784.3602484472,86.4658385093168
"11422","33139","2021",2,2,0,332720,1362,236
"11423","33140","2021",72,55,17,211025.180555556,2535.41666666667,84.8472222222222
"11424","33141","2021",8,8,0,262820,2277.75,111.375
"11425","33142","2021",33,33,0,227753.212121212,2316.78787878788,103.939393939394
"11426","33143","2021",45,41,4,227914.622222222,2602.82222222222,93.6444444444444
"11427","33144","2021",10,10,0,339910.8,2220.2,159.7
"11428","33145","2021",9,9,0,331150,2865.66666666667,118.111111111111
"11429","33146","2021",30,29,1,219579.333333333,2057.3,109.466666666667
"11430","33147","2021",7,7,0,208635.714285714,2285,94
"11431","33148","2021",2,2,0,255000,1770.5,144
"11432","33149","2021",1,1,0,455895,1577,289
"11433","33150","2021",3,3,0,176243.333333333,1402.33333333333,138.666666666667
"11434","33151","2021",5,4,1,161490,1760,103.8
"11435","33152","2021",1,1,0,67000,838,80
"11436","33153","2021",4,4,0,152378.5,2171.75,79
"11437","33154","2021",41,38,3,138960.195121951,1362.41463414634,103.658536585366
"11438","33155","2021",1,1,0,181716,1063,171
"11439","33156","2021",3,3,0,175700,1644,107.333333333333
"11440","33157","2021",4,4,0,237750,2477,94.75
"11441","33158","2021",1,1,0,178000,1978,90
"11442","33159","2021",43,35,8,113236.744186047,1204.79069767442,89.4418604651163
"11443","33160","2021",11,11,0,148065.545454545,1398.27272727273,107.818181818182
"11444","33161","2021",6,6,0,146083.333333333,1749.83333333333,98
"11445","33162","2021",419,227,192,304393.663484487,3815.21479713604,79.8568019093079
"11446","33163","2021",4,4,0,364950,2809.5,130
"11447","33164","2021",23,23,0,270806.956521739,2174.82608695652,119.608695652174
"11448","33165","2021",53,37,16,308611.169811321,3279.39622641509,97.1698113207547
"11449","33166","2021",4,4,0,155125,1650.5,94.25
"11450","33167","2021",208,108,100,251670.572115385,3401.46634615385,76.0721153846154
"11451","33168","2021",16,16,0,242982.8125,1777.4375,135.9375
"11452","33170","2021",12,12,0,170751.25,1579.75,111.416666666667
"11453","33171","2021",5,5,0,273587,1983.8,139.2
"11454","33172","2021",3,3,0,161333.333333333,1458,98.3333333333333
"11455","33173","2021",2,2,0,536000,3089.5,170.5
"11456","33174","2021",15,15,0,228749.666666667,1553.4,153.2
"11457","33175","2021",13,13,0,185199.076923077,1576.07692307692,118.307692307692
"11458","33176","2021",2,2,0,281550,1534.5,184
"11459","33177","2021",41,40,1,218730.634146341,2325.53658536585,100.292682926829
"11460","33178","2021",2,2,0,187595,1901.5,97
"11461","33179","2021",54,45,9,179368.444444444,1876.77777777778,97.2407407407407
"11462","33180","2021",1,1,0,408000,2147,190
"11463","33181","2021",3,3,0,122275.333333333,1431.66666666667,88
"11464","33182","2021",15,15,0,298493.333333333,1979.33333333333,129.733333333333
"11465","33183","2021",20,20,0,249580,2241.3,114.1
"11466","33184","2021",4,4,0,219325,973.75,204.5
"11467","33185","2021",35,24,11,205630.657142857,2216,93.2
"11468","33186","2021",15,15,0,173166.666666667,1339.26666666667,119.666666666667
"11469","33187","2021",26,18,8,144934.346153846,1618.84615384615,93
"11470","33188","2021",2,2,0,121500,1068,161.5
"11471","33189","2021",11,10,1,156710.909090909,2337.54545454545,80.4545454545455
"11472","33190","2021",2,2,0,95000,701.5,125
"11473","33191","2021",6,6,0,133200,1370.33333333333,99.8333333333333
"11474","33192","2021",352,155,197,292020.122159091,3790.96875,78.4431818181818
"11475","33193","2021",34,34,0,232552.941176471,2454.88235294118,100.382352941176
"11476","33194","2021",7,7,0,197428.571428571,1927.71428571429,103.285714285714
"11477","33195","2021",22,18,4,144859.136363636,1601.04545454545,113.909090909091
"11478","33196","2021",2,2,0,240000,2884,83.5
"11479","33197","2021",6,6,0,248896.666666667,2206.16666666667,126.833333333333
"11480","33198","2021",31,28,3,132218.129032258,1611.32258064516,91.1612903225806
"11481","33199","2021",571,469,102,410695.667250438,4553.95796847636,90.9036777583187
"11482","33200","2021",180,110,70,315732.372222222,3903.17777777778,80.9944444444444
"11483","33201","2021",11,10,1,277388.181818182,2567.81818181818,115.818181818182
"11484","33202","2021",23,21,2,239302.043478261,2668.73913043478,94.1739130434783
"11485","33203","2021",125,100,25,232055.744,3382.112,72.4
"11486","33204","2021",6,6,0,173772,1279,143.833333333333
"11487","33205","2021",20,20,0,321822.55,2501.3,133.1
"11488","33206","2021",7,6,1,178372.857142857,2260,84.2857142857143
"11489","33207","2021",77,74,3,286694.337662338,2844.8961038961,104.324675324675
"11490","33208","2021",29,28,1,172645.931034483,1568.79310344828,115.896551724138
"11491","33209","2021",1,1,0,295000,2269,130
"11492","33210","2021",2,2,0,196226,1381.5,127.5
"11493","33211","2021",10,9,1,296400,2862.7,104.7
"11494","33212","2021",2,2,0,180087.5,1357,135
"11495","33213","2021",61,46,15,360811.213114754,3508,105.573770491803
"11496","33214","2021",323,205,118,297844.390092879,4430.28792569659,68.7863777089783
"11497","33215","2021",1,1,0,470000,1655,284
"11498","33216","2021",3,3,0,121500,1461.66666666667,84.3333333333333
"11499","33218","2021",13,13,0,145430.846153846,1648.46153846154,93.3076923076923
"11500","33219","2021",31,26,5,225608.387096774,2498.93548387097,92.258064516129
"11501","33220","2021",25,25,0,240817,2077.48,119.96
"11502","33221","2021",16,15,1,102950.625,1082.625,99.4375
"11503","33222","2021",8,8,0,270618.875,2370.25,119
"11504","33223","2021",5,5,0,205199,1610.2,124.2
"11505","33224","2021",5,5,0,206100,1195.2,173.4
"11506","33225","2021",25,25,0,236130.8,2322.92,101.56
"11507","33226","2021",31,28,3,240674.580645161,2445.70967741935,98.6451612903226
"11508","33227","2021",150,72,78,143884.693333333,1947.66,75.8866666666667
"11509","33228","2021",10,10,0,265899,2083.2,124.8
"11510","33229","2021",168,134,34,353223.916666667,4381.04761904762,83.3392857142857
"11511","33230","2021",6,6,0,146010,1822.16666666667,87.5
"11512","33231","2021",3,3,0,98500,1059.33333333333,92.6666666666667
"11513","33233","2021",36,35,1,211199.555555556,1806.05555555556,123.055555555556
"11514","33234","2021",64,61,3,506326.34375,3829.375,132.359375
"11515","33235","2021",4,4,0,205480,1688.5,121.75
"11516","33236","2021",290,220,70,796083.337931035,7974.98275862069,99.1275862068966
"11517","33237","2021",14,14,0,234810.714285714,2258.42857142857,114.857142857143
"11518","33238","2021",126,117,9,403944.69047619,3677.80158730159,110.801587301587
"11519","33239","2021",9,9,0,193788.888888889,1495.22222222222,143.888888888889
"11520","33240","2021",137,114,23,157934.423357664,1723.59854014599,95.0802919708029
"11521","33241","2021",16,15,1,210198.125,2024.3125,109.5
"11522","33242","2021",7,7,0,156221.428571429,1536.57142857143,103.428571428571
"11523","33243","2021",538,315,223,201477.373605948,2483.33271375465,81.9684014869889
"11524","33244","2021",1,1,0,230000,4600,50
"11525","33245","2021",10,10,0,504190,3521.3,135.7
"11526","33247","2021",1,1,0,159700,1613,99
"11527","33248","2021",68,65,3,240667.029411765,2251.16176470588,109.720588235294
"11528","33249","2021",230,95,135,220788.191304348,2847.36956521739,78.7173913043478
"11529","33250","2021",5,5,0,144088,1370.4,108.8
"11530","33251","2021",11,11,0,239168.545454545,2307.09090909091,105.818181818182
"11531","33252","2021",11,11,0,272245.090909091,2497.45454545455,113.454545454545
"11532","33253","2021",7,7,0,245121.428571429,1672.57142857143,151.285714285714
"11533","33254","2021",7,7,0,195564.285714286,1968.28571428571,99.8571428571429
"11534","33255","2021",4,4,0,193017.75,1473.5,127
"11535","33256","2021",64,55,9,296507.609375,3036.015625,98.921875
"11536","33257","2021",8,8,0,250875,1920.75,126.125
"11537","33258","2021",2,2,0,235500,2488,105
"11538","33259","2021",18,16,2,195570.277777778,2024.55555555556,100.222222222222
"11539","33260","2021",23,23,0,308973.47826087,2758.73913043478,123.391304347826
"11540","33261","2021",15,15,0,151121.533333333,1617.33333333333,95.4666666666667
"11541","33262","2021",74,73,1,264174.445945946,2883.31081081081,96.4324324324324
"11542","33263","2021",3,3,0,178093.333333333,2500.33333333333,70.6666666666667
"11543","33264","2021",19,19,0,150731.578947368,1666.68421052632,97
"11544","33266","2021",7,7,0,239557.142857143,2022.14285714286,121.571428571429
"11545","33268","2021",38,35,3,258565.131578947,2721.92105263158,101.789473684211
"11546","33269","2021",6,6,0,275515,1740.16666666667,156.666666666667
"11547","33270","2021",3,3,0,199500,2551.66666666667,84
"11548","33271","2021",3,3,0,206916.666666667,2508.33333333333,86.3333333333333
"11549","33272","2021",15,15,0,224560.2,1981.66666666667,120.4
"11550","33273","2021",114,78,36,358011.859649123,3727.26315789474,98.7105263157895
"11551","33274","2021",46,41,5,356131.304347826,3393.84782608696,106.217391304348
"11552","33275","2021",1,1,0,220000,1038,212
"11553","33277","2021",4,4,0,224607.5,1230.75,173.75
"11554","33278","2021",7,7,0,158214.285714286,1516.42857142857,108.857142857143
"11555","33279","2021",6,6,0,194333.333333333,1787.16666666667,107
"11556","33280","2021",6,6,0,179166.666666667,1572.33333333333,121
"11557","33281","2021",1216,493,723,302830.911184211,3869.25822368421,77.8610197368421
"11558","33282","2021",3,3,0,155730,1236.33333333333,138
"11559","33283","2021",2,2,0,165485,1196.5,140
"11560","33284","2021",185,173,12,358768.232432432,3578.06486486486,103.243243243243
"11561","33285","2021",3,3,0,231650,1973,125.666666666667
"11562","33287","2021",8,8,0,189300,1662.5,120.875
"11563","33288","2021",1,1,0,252200,2449,103
"11564","33289","2021",34,33,1,151302.970588235,1296.91176470588,118.647058823529
"11565","33290","2021",25,25,0,358003.48,2390.6,130.6
"11566","33291","2021",2,2,0,151500,1344.5,132.5
"11567","33292","2021",3,3,0,108200,1382.66666666667,90
"11568","33293","2021",68,52,16,282576.25,2950.45588235294,100.308823529412
"11569","33294","2021",7,7,0,132957.142857143,1546.28571428571,87
"11570","33296","2021",18,18,0,181573.333333333,1599.33333333333,116.111111111111
"11571","33297","2021",30,30,0,257761.633333333,2294.8,111.066666666667
"11572","33298","2021",13,13,0,360322,2976.61538461538,122.538461538462
"11573","33299","2021",5,5,0,269310,1768.2,163.2
"11574","33300","2021",28,28,0,276736.071428571,2684.32142857143,111.964285714286
"11575","33301","2021",4,4,0,265293.75,2547.25,106.5
"11576","33302","2021",5,5,0,218040,2198.8,106.8
"11577","33303","2021",12,12,0,180616.666666667,1942.83333333333,96.25
"11578","33304","2021",4,4,0,248700,1149.75,205
"11579","33305","2021",7,7,0,210742.857142857,2034,100
"11580","33306","2021",7,7,0,238107.142857143,1360.14285714286,173.428571428571
"11581","33307","2021",32,32,0,220050.59375,1891.0625,123.4375
"11582","33308","2021",2,2,0,87500,1025.5,104.5
"11583","33309","2021",7,7,0,192752.857142857,1500.42857142857,128.857142857143
"11584","33310","2021",4,4,0,189250,1908.75,112
"11585","33311","2021",29,23,6,205066.206896552,2013.93103448276,98.8965517241379
"11586","33312","2021",157,102,55,273963.955414013,3375.72611464968,81.2356687898089
"11587","33314","2021",59,58,1,186445.203389831,1878.54237288136,107.966101694915
"11588","33315","2021",24,24,0,178218.75,1704.91666666667,111.291666666667
"11589","33316","2021",14,14,0,184310,1292.21428571429,138.142857142857
"11590","33317","2021",11,11,0,204725.181818182,2023.36363636364,104.181818181818
"11591","33318","2021",881,506,375,327728.004540295,4015.16799091941,82.8581157775255
"11592","33319","2021",4,4,0,165000,1629.75,99
"11593","33320","2021",11,11,0,211130.909090909,1715.54545454545,121.363636363636
"11594","33321","2021",14,14,0,246790.285714286,2325.35714285714,107.571428571429
"11595","33322","2021",94,93,1,331918.170212766,3119.98936170213,107.957446808511
"11596","33323","2021",19,19,0,255733.684210526,2252.21052631579,121.631578947368
"11597","33324","2021",93,72,21,130701.849462366,1438.34408602151,91.3333333333333
"11598","33325","2021",12,12,0,154196.666666667,1879.16666666667,87
"11599","33326","2021",2,2,0,63600,932,91.5
"11600","33327","2021",38,34,4,249473.263157895,2944.05263157895,88.3947368421053
"11601","33328","2021",6,6,0,224198.333333333,2763.16666666667,85.3333333333333
"11602","33329","2021",8,8,0,215812.5,2579.25,93.125
"11603","33330","2021",33,31,2,413614.181818182,3457.81818181818,120.787878787879
"11604","33331","2021",8,8,0,272908.25,3066.625,116.375
"11605","33332","2021",15,15,0,139585,1410.53333333333,102.866666666667
"11606","33333","2021",39,36,3,359011.205128205,3869.71794871795,98.3589743589744
"11607","33334","2021",35,30,5,251758.457142857,2716.68571428571,96.9714285714286
"11608","33335","2021",9,9,0,330743,2947.11111111111,113.666666666667
"11609","33336","2021",24,24,0,171358.583333333,1650.91666666667,107.916666666667
"11610","33337","2021",39,38,1,195998.205128205,1804.02564102564,114.307692307692
"11611","33339","2021",28,28,0,225119,2273.64285714286,105.607142857143
"11612","33341","2021",26,26,0,222557.192307692,2346.84615384615,94.9615384615385
"11613","33342","2021",10,10,0,216204.5,2084,103.4
"11614","33343","2021",10,10,0,227760,1887.3,117.2
"11615","33344","2021",7,7,0,260406.571428571,2160.85714285714,120.714285714286
"11616","33345","2021",6,6,0,175818.333333333,1579.33333333333,115
"11617","33346","2021",7,7,0,194471.428571429,1400.71428571429,142.714285714286
"11618","33347","2021",8,8,0,151550,1594.25,113.375
"11619","33348","2021",24,24,0,217524.125,1835.16666666667,119.708333333333
"11620","33349","2021",29,27,2,389082.931034483,3558.24137931034,107.48275862069
"11621","33350","2021",16,14,2,189945.25,2208,107.0625
"11622","33351","2021",28,28,0,131950.892857143,1542.21428571429,102.821428571429
"11623","33352","2021",80,67,13,131203.325,1360.9375,97.825
"11624","33353","2021",4,4,0,178750,2932.5,78.25
"11625","33354","2021",3,3,0,189000,1495.66666666667,126.333333333333
"11626","33355","2021",23,22,1,185691.304347826,2110.39130434783,89.9130434782609
"11627","33356","2021",4,4,0,328337.5,2478.25,140.75
"11628","33357","2021",27,27,0,295568.333333333,2462.62962962963,123.222222222222
"11629","33358","2021",11,11,0,260821.818181818,2320.72727272727,113.272727272727
"11630","33360","2021",8,8,0,134000,1153.625,120.5
"11631","33361","2021",7,7,0,179085.714285714,1623.14285714286,116.857142857143
"11632","33362","2021",19,19,0,179436.842105263,2037.84210526316,90.8421052631579
"11633","33363","2021",73,71,2,327920.273972603,3002.32876712329,113.767123287671
"11634","33364","2021",4,4,0,235637.5,2228,104
"11635","33365","2021",2,2,0,175000,2020,86.5
"11636","33366","2021",211,147,64,205916.127962085,2537.47867298578,82.7867298578199
"11637","33367","2021",5,5,0,196900,1451.6,141.2
"11638","33369","2021",10,10,0,248287,1646.6,148
"11639","33370","2021",7,7,0,130213.714285714,1333.85714285714,101.142857142857
"11640","33372","2021",1,1,0,239050,1328,180
"11641","33373","2021",14,14,0,133298.785714286,1183.64285714286,112.071428571429
"11642","33374","2021",12,12,0,150472.333333333,1201.25,128.25
"11643","33375","2021",5,5,0,246983.6,2234.6,107.2
"11644","33376","2021",98,91,7,469654.12244898,3819.86734693878,122.704081632653
"11645","33377","2021",3,3,0,230366.666666667,1438.66666666667,183.666666666667
"11646","33378","2021",13,13,0,154861.538461538,1463.76923076923,106.230769230769
"11647","33379","2021",3,3,0,215350,1355.33333333333,189.333333333333
"11648","33380","2021",24,24,0,133520.416666667,1280.875,110.916666666667
"11649","33381","2021",57,47,10,272306.105263158,2860.29824561404,95.9649122807018
"11650","33382","2021",29,29,0,193848.620689655,1635.31034482759,123.896551724138
"11651","33383","2021",14,14,0,135234.285714286,1461.71428571429,93.5
"11652","33384","2021",3,3,0,288166.666666667,2750.33333333333,110.333333333333
"11653","33385","2021",10,10,0,169995.6,1441.2,120.4
"11654","33386","2021",1,1,0,144726,1477,98
"11655","33387","2021",17,17,0,163729.411764706,1754.76470588235,97.8235294117647
"11656","33388","2021",13,13,0,236555.769230769,1646.53846153846,146.230769230769
"11657","33389","2021",50,48,2,149263.8,1298.2,110.26
"11658","33390","2021",7,7,0,287807.142857143,2210.42857142857,131.571428571429
"11659","33391","2021",4,4,0,212500,1893.5,148
"11660","33392","2021",12,12,0,148541.666666667,1601.75,103.333333333333
"11661","33393","2021",82,76,6,201429.158536585,1981.85365853659,105.475609756098
"11662","33394","2021",26,26,0,289197.423076923,2638.11538461538,106.192307692308
"11663","33395","2021",42,42,0,141454.214285714,1476.78571428571,98.1666666666667
"11664","33396","2021",3,3,0,389886.666666667,3150.66666666667,137
"11665","33397","2021",54,50,4,292948.87037037,3013.05555555556,99.1851851851852
"11666","33398","2021",1,1,0,219000,4380,50
"11667","33399","2021",9,9,0,221972.222222222,1568.77777777778,143
"11668","33400","2021",5,5,0,127600,1145.8,107.4
"11669","33401","2021",1,1,0,162000,2531,64
"11670","33402","2021",54,43,11,97209.8518518519,1024.51851851852,100.092592592593
"11671","33404","2021",3,3,0,126777.666666667,1280.33333333333,119
"11672","33405","2021",6,6,0,146491.666666667,1218.33333333333,118.5
"11673","33406","2021",9,9,0,596661.111111111,3659.88888888889,133.666666666667
"11674","33407","2021",9,9,0,311910.555555556,2627.11111111111,117.555555555556
"11675","33408","2021",7,7,0,364813.571428571,2735.28571428571,133.571428571429
"11676","33409","2021",4,4,0,220250,1785.5,127
"11677","33411","2021",4,4,0,133537.5,1467.25,97.75
"11678","33412","2021",20,20,0,183972.3,1835.75,100.8
"11679","33413","2021",28,28,0,332545,2571.42857142857,137.321428571429
"11680","33414","2021",8,8,0,275515.125,2057.5,130
"11681","33415","2021",41,30,11,217332.390243902,2309.31707317073,97.6829268292683
"11682","33416","2021",14,14,0,201011.714285714,1681,128.714285714286
"11683","33417","2021",36,33,3,267290.583333333,2788.72222222222,102.722222222222
"11684","33418","2021",3,3,0,171533.333333333,1262.66666666667,134.333333333333
"11685","33419","2021",1,1,0,195000,1773,110
"11686","33421","2021",5,3,2,136471.8,1285.6,116.2
"11687","33422","2021",114,86,28,357665.464912281,3656.14912280702,101.850877192982
"11688","33423","2021",7,7,0,148242.857142857,1538.28571428571,96.8571428571429
"11689","33424","2021",63,50,13,188512.857142857,2159.31746031746,88.2539682539683
"11690","33425","2021",20,20,0,260823.2,2630.95,109.05
"11691","33426","2021",2,2,0,196295,2136.5,92.5
"11692","33427","2021",4,4,0,209027.75,4410,98
"11693","33429","2021",4,4,0,184325,1822.25,110.25
"11694","33431","2021",5,5,0,243824,2546.8,99.4
"11695","33433","2021",99,89,10,277326.505050505,3006.11111111111,95.2020202020202
"11696","33434","2021",22,18,4,190779.727272727,2568.5,77.4090909090909
"11697","33435","2021",42,19,23,133803.571428571,1661.5,83.8333333333333
"11698","33436","2021",16,16,0,238190.375,2434.625,97.125
"11699","33437","2021",33,33,0,220334.636363636,1936,112.393939393939
"11700","33438","2021",26,26,0,204546.153846154,2093.42307692308,99.6153846153846
"11701","33439","2021",20,19,1,189573.75,1966.75,93.7
"11702","33440","2021",3,3,0,239300,1564,146.666666666667
"11703","33441","2021",27,22,5,124757.666666667,1362.2962962963,91.962962962963
"11704","33442","2021",8,8,0,189765,2242.375,91
"11705","33443","2021",2,2,0,238650,1399.5,203
"11706","33444","2021",10,10,0,170262,1517.2,115.4
"11707","33445","2021",6,6,0,289542.166666667,2095,128.166666666667
"11708","33446","2021",2,2,0,195000,1371,132.5
"11709","33447","2021",48,47,1,171323.604166667,1654.0625,112.8125
"11710","33448","2021",37,37,0,357232.054054054,3353.2972972973,107.108108108108
"11711","33449","2021",467,385,82,350883.730192719,3706.13276231263,96.0792291220557
"11712","33450","2021",6,6,0,141940.833333333,1593.66666666667,92.1666666666667
"11713","33451","2021",8,8,0,238181.75,2027.25,116.875
"11714","33452","2021",9,9,0,257620.555555556,2773.11111111111,99.2222222222222
"11715","33453","2021",4,4,0,255483.75,1751,151.5
"11716","33454","2021",18,18,0,365352.777777778,2894.33333333333,129.833333333333
"11717","33456","2021",10,10,0,133824.2,1272.8,129.3
"11718","33457","2021",11,11,0,219386.363636364,2075.18181818182,107.454545454545
"11719","33458","2021",13,13,0,175178.230769231,1728.76923076923,98.7692307692308
"11720","33459","2021",3,3,0,227666.666666667,1935.66666666667,108.666666666667
"11721","33460","2021",7,7,0,184614.285714286,1792.28571428571,111.285714285714
"11722","33461","2021",5,5,0,218850,1685,129.2
"11723","33462","2021",5,5,0,158538,1418.2,122.4
"11724","33463","2021",18,18,0,213825,2057.88888888889,108.666666666667
"11725","33464","2021",6,6,0,238705.5,2182.5,110.5
"11726","33465","2021",12,12,0,262739.75,1842.83333333333,144.833333333333
"11727","33466","2021",99,38,61,148761.393939394,2198.58585858586,66.7676767676768
"11728","33467","2021",6,6,0,207717.666666667,1571.83333333333,116.666666666667
"11729","33468","2021",4,4,0,92100,1013.5,91.5
"11730","33470","2021",8,8,0,358441.75,2745.5,150.5
"11731","33471","2021",23,23,0,174262.130434783,1768.82608695652,101.173913043478
"11732","33472","2021",8,8,0,143081.25,1564.75,92
"11733","33473","2021",51,48,3,168753.725490196,1901.07843137255,96.0196078431373
"11734","33474","2021",64,64,0,345682.875,3224.40625,112.03125
"11735","33475","2021",5,5,0,255748,2127.2,131.4
"11736","33476","2021",9,9,0,92944.4444444444,1060,91.2222222222222
"11737","33477","2021",15,15,0,166152.2,1585.53333333333,106.333333333333
"11738","33478","2021",82,72,10,135636.56097561,1589.51219512195,86.390243902439
"11739","33479","2021",5,5,0,158900,1200.4,135.8
"11740","33480","2021",13,13,0,282653.846153846,2038.53846153846,127.615384615385
"11741","33481","2021",4,4,0,190687.5,1832.75,109.25
"11742","33482","2021",3,3,0,230133.333333333,1993.66666666667,116.666666666667
"11743","33483","2021",50,50,0,335638,2824.48,122.92
"11744","33484","2021",24,23,1,176950,1841.16666666667,100.916666666667
"11745","33485","2021",21,21,0,232584.333333333,1992.52380952381,115.666666666667
"11746","33486","2021",8,8,0,190326.625,1810,106.625
"11747","33487","2021",12,12,0,187650,2142.83333333333,93
"11748","33488","2021",8,8,0,248941.875,1905.625,131.375
"11749","33489","2021",4,4,0,240896.25,1933.25,126.5
"11750","33490","2021",44,42,2,179340.863636364,2213.72727272727,86.3181818181818
"11751","33491","2021",7,7,0,234150.857142857,1531.85714285714,161.571428571429
"11752","33492","2021",39,33,6,177208.282051282,1890.17948717949,93
"11753","33493","2021",11,11,0,150791.090909091,1689.81818181818,101.727272727273
"11754","33494","2021",18,18,0,410502.888888889,3664.16666666667,115.666666666667
"11755","33496","2021",35,34,1,408056.971428571,3298.2,130.2
"11756","33498","2021",130,123,7,310491.784615385,2991.79230769231,108.5
"11757","33499","2021",7,7,0,119428.571428571,1163.14285714286,102.285714285714
"11758","33500","2021",9,9,0,184750,1544.44444444444,124.222222222222
"11759","33501","2021",46,45,1,333576.934782609,3141.54347826087,109.173913043478
"11760","33502","2021",6,6,0,161898.333333333,1518.5,110.833333333333
"11761","33503","2021",6,6,0,336781.666666667,3078.66666666667,111.166666666667
"11762","33504","2021",17,17,0,248598.823529412,1621.11764705882,150.117647058824
"11763","33505","2021",26,26,0,259536.538461538,2585.03846153846,102.192307692308
"11764","33506","2021",24,19,5,145598.75,1412.91666666667,103.833333333333
"11765","33507","2021",3,3,0,162333.333333333,1985.66666666667,80
"11766","33508","2021",9,9,0,269636.555555556,2028,133.444444444444
"11767","33509","2021",10,10,0,260187,1986.8,127.7
"11768","33510","2021",4,4,0,185925,1775.5,120.25
"11769","33511","2021",10,10,0,195570,1771.6,128.2
"11770","33512","2021",5,5,0,142300,1193.6,118.4
"11771","33513","2021",2,2,0,159315,1898.5,81
"11772","33514","2021",191,120,71,214638.219895288,3402.42408376963,67.3612565445026
"11773","33515","2021",4,4,0,198542.5,1260,154.5
"11774","33516","2021",3,3,0,234666.666666667,1411.33333333333,170
"11775","33517","2021",32,31,1,223528.15625,2263.21875,99.5625
"11776","33518","2021",19,19,0,292848.684210526,2530.05263157895,121.842105263158
"11777","33519","2021",133,115,18,369168.714285714,3675.08270676692,103.609022556391
"11778","33520","2021",6,6,0,139894.166666667,1304.16666666667,116.666666666667
"11779","33521","2021",15,14,1,211006.666666667,1929.6,104.866666666667
"11780","33522","2021",691,297,394,308101.283646889,4357.00868306802,71.3314037626628
"11781","33523","2021",21,18,3,184614.80952381,2080.28571428571,96.2857142857143
"11782","33524","2021",2,2,0,316915,2744.5,118.5
"11783","33525","2021",29,29,0,203124.137931034,1979.68965517241,109.413793103448
"11784","33526","2021",1,1,0,198920,1913,104
"11785","33527","2021",174,111,63,322370.908045977,4017.12643678161,83.4252873563218
"11786","33528","2021",4,4,0,296087.5,3631,91
"11787","33529","2021",639,451,188,502211.183098592,5349.73082942097,90.358372456964
"11788","33530","2021",10,10,0,201687,1809.1,113.2
"11789","33531","2021",7,7,0,248928.571428571,2025.28571428571,141.571428571429
"11790","33532","2021",5,5,0,223064,1884,119.4
"11791","33533","2021",41,39,2,182919.048780488,1979.31707317073,92.9268292682927
"11792","33534","2021",16,15,1,247971.4375,2514.25,105.125
"11793","33535","2021",47,45,2,387242.29787234,3526.68085106383,112.021276595745
"11794","33536","2021",8,8,0,253355,2023.375,129.125
"11795","33537","2021",7,7,0,314911.428571429,1867.14285714286,137.428571428571
"11796","33538","2021",15,15,0,208013.533333333,1788.06666666667,128.266666666667
"11797","33539","2021",55,51,4,273691.236363636,2663.30909090909,105.8
"11798","33540","2021",56,53,3,235185.892857143,3128.21428571429,83.4285714285714
"11799","33541","2021",24,23,1,246930.208333333,2667.25,98.7916666666667
"11800","33542","2021",11,11,0,304557.363636364,2505.18181818182,117.636363636364
"11801","33543","2021",20,18,2,200210.05,1741.9,121.9
"11802","33544","2021",95,32,63,126681.705263158,2121.17894736842,59.1578947368421
"11803","33545","2021",15,15,0,220389.666666667,2009.53333333333,120.066666666667
"11804","33546","2021",2,2,0,195000,2670.5,82.5
"11805","33547","2021",16,15,1,193328.125,1834.875,105.125
"11806","33548","2021",19,18,1,247402.315789474,2255.21052631579,112.684210526316
"11807","33549","2021",2,2,0,187345,2650.5,75.5
"11808","33550","2021",573,362,211,297477.811518325,3647.92844677138,81.565445026178
"11809","33551","2021",8,7,1,191522.5,1586.875,125.625
"11810","33552","2021",9,9,0,259422.222222222,2828.55555555556,101.444444444444
"11811","33553","2021",17,17,0,203658.647058824,2217.94117647059,92.8235294117647
"11812","33554","2021",39,27,12,328359.230769231,3059.53846153846,104.923076923077
"11813","33555","2021",88,69,19,288652.102272727,3295.57954545455,89.375
"11814","34001","2021",32,30,2,192005.21875,2003.15625,93.53125
"11815","34002","2021",24,23,1,212649.125,2105.125,100.541666666667
"11816","34003","2021",2526,556,1970,143362.119952494,3432.44338875693,43.8028503562945
"11817","34004","2021",4,4,0,60241.25,756.25,89
"11818","34006","2021",7,7,0,167714.285714286,1785.42857142857,115.428571428571
"11819","34007","2021",8,8,0,136500,1646.75,82.125
"11820","34008","2021",16,16,0,116633.625,1267.0625,87.8125
"11821","34009","2021",41,39,2,236581.024390244,2391.90243902439,98.219512195122
"11822","34010","2021",46,42,4,226259.565217391,2513.86956521739,90.1521739130435
"11823","34011","2021",2,2,0,127000,1622.5,80.5
"11824","34012","2021",19,19,0,341361.736842105,3258.94736842105,102.578947368421
"11825","34013","2021",39,38,1,184262.717948718,2247.51282051282,83.5128205128205
"11826","34014","2021",13,13,0,673586.307692308,3894,172
"11827","34015","2021",4,4,0,185762.5,1780.5,101.5
"11828","34016","2021",10,9,1,255176,2773.7,94
"11829","34017","2021",15,15,0,236166,2246,103.466666666667
"11830","34018","2021",17,17,0,182909.117647059,1692.47058823529,109.764705882353
"11831","34019","2021",9,7,2,106457.777777778,1344.66666666667,81.4444444444444
"11832","34020","2021",10,10,0,117019,1027.3,111.3
"11833","34021","2021",8,8,0,127508.125,1150.625,112
"11834","34022","2021",132,107,25,388998.272727273,3728.04545454545,105.871212121212
"11835","34023","2021",231,68,163,189150.445887446,3827.94372294372,55.2813852813853
"11836","34024","2021",46,40,6,334846.304347826,3788.10869565217,88.1739130434783
"11837","34025","2021",37,35,2,218932.189189189,2101.64864864865,101.594594594595
"11838","34026","2021",6,6,0,180112.5,1806.5,92.5
"11839","34027","2021",25,25,0,371175.52,3353.76,113.52
"11840","34028","2021",121,73,48,106299.603305785,1355.71900826446,81.3801652892562
"11841","34029","2021",12,12,0,231724.166666667,2604.08333333333,86.1666666666667
"11842","34030","2021",5,5,0,136970,1358.2,96
"11843","34031","2021",112,99,13,195347.5,2096.98214285714,94.6428571428571
"11844","34032","2021",1573,629,944,138021.973299428,1756.01398601399,77.4481881754609
"11845","34033","2021",24,21,3,351497.625,3062.625,113.625
"11846","34034","2021",2,2,0,97500,1045,108
"11847","34035","2021",13,13,0,400142.307692308,3172.69230769231,129.769230769231
"11848","34036","2021",22,21,1,245064.863636364,2882.95454545455,106.318181818182
"11849","34037","2021",62,51,11,226589.225806452,2262.11290322581,97.8225806451613
"11850","34038","2021",20,17,3,112487,1423.5,77.6
"11851","34039","2021",30,21,9,280469.5,3408.03333333333,84.3
"11852","34041","2021",17,16,1,243041.647058824,2632,91.1176470588235
"11853","34042","2021",8,8,0,202443.75,2012.125,97.375
"11854","34043","2021",6,5,1,262553.333333333,2630,95.8333333333333
"11855","34044","2021",10,9,1,174202.5,1392,118.3
"11856","34045","2021",10,10,0,175615,1883.3,91.7
"11857","34046","2021",3,3,0,123000,1345,82
"11858","34047","2021",12,11,1,222675,2366.16666666667,98.6666666666667
"11859","34048","2021",1,1,0,362200,4704,77
"11860","34049","2021",13,11,2,76424.6153846154,1030.61538461538,80.2307692307692
"11861","34050","2021",34,20,14,283929.352941176,3492.55882352941,81.4117647058823
"11862","34051","2021",54,54,0,258683.333333333,2414.98148148148,105.555555555556
"11863","34052","2021",57,53,4,187856.561403509,2042.35087719298,89.8771929824561
"11864","34053","2021",5,5,0,281416,2341,114
"11865","34055","2021",4,4,0,76750,1031.75,63
"11866","34056","2021",25,21,4,188538,2040.6,95
"11867","34057","2021",446,152,294,319828.071748879,3956.70627802691,77.4170403587444
"11868","34058","2021",84,74,10,341982.25,3647.14285714286,94.6190476190476
"11869","34059","2021",6,6,0,140458.333333333,1582.83333333333,82.8333333333333
"11870","34060","2021",8,8,0,280265.375,2881.625,100.75
"11871","34061","2021",4,4,0,147250,1542.5,86.75
"11872","34062","2021",1,1,0,327337,2139,153
"11873","34063","2021",48,47,1,291230.520833333,2510.14583333333,109.145833333333
"11874","34064","2021",13,12,1,118945.384615385,1496,83.9230769230769
"11875","34065","2021",8,8,0,165045,1868,87.625
"11876","34066","2021",1,1,0,597600,1712,349
"11877","34067","2021",18,18,0,198984.055555556,2182.16666666667,93.0555555555556
"11878","34068","2021",8,7,1,293212.5,2770.75,107.625
"11879","34069","2021",79,76,3,195182.607594937,1989.12658227848,98.3417721518987
"11880","34070","2021",19,19,0,158316.578947368,1852.52631578947,82.5789473684211
"11881","34071","2021",10,10,0,93408.3,1016.3,87
"11882","34073","2021",43,42,1,232082.558139535,2341.25581395349,99.7441860465116
"11883","34074","2021",38,36,2,163766.868421053,1601.23684210526,96.0263157894737
"11884","34075","2021",7,7,0,117517.142857143,1117.71428571429,118.285714285714
"11885","34076","2021",17,16,1,251622.823529412,2113.41176470588,119.411764705882
"11886","34077","2021",70,52,18,328136.442857143,3594.27142857143,89.4714285714286
"11887","34078","2021",21,21,0,306021.428571429,2691.47619047619,110.333333333333
"11888","34079","2021",183,89,94,168476.923497268,2198.03825136612,75.0601092896175
"11889","34080","2021",4,4,0,159750,1898.5,78.5
"11890","34081","2021",53,47,6,249566.339622642,2299.77358490566,108.358490566038
"11891","34082","2021",17,16,1,348185.058823529,2995.58823529412,114.823529411765
"11892","34083","2021",7,7,0,183507.285714286,2233.85714285714,89.4285714285714
"11893","34084","2021",27,27,0,175894.074074074,1945.33333333333,87.2222222222222
"11894","34085","2021",5,5,0,146680,1473.8,88.8
"11895","34086","2021",14,14,0,170815.714285714,1589.71428571429,93.5
"11896","34087","2021",47,35,12,321123.829787234,3142.72340425532,103.808510638298
"11897","34088","2021",92,80,12,307496.956521739,3246.38043478261,95.7173913043478
"11898","34089","2021",42,42,0,208345.452380952,2101.66666666667,98.0238095238095
"11899","34090","2021",105,68,37,340741.219047619,3878.42857142857,88.7714285714286
"11900","34092","2021",18,18,0,127511.111111111,1430.5,91.7222222222222
"11901","34093","2021",1,1,0,155000,1192,130
"11902","34094","2021",16,16,0,215996.25,2148.5625,100.8125
"11903","34095","2021",110,82,28,299631.763636364,3297.70909090909,89.6272727272727
"11904","34096","2021",17,17,0,232364.882352941,1785.70588235294,116.235294117647
"11905","34097","2021",12,12,0,155090.333333333,1352.91666666667,106
"11906","34098","2021",2,2,0,107750,1422,71.5
"11907","34099","2021",1,1,0,380000,3878,98
"11908","34100","2021",4,4,0,244476.25,1853.5,124.25
"11909","34101","2021",113,105,8,171803.876106195,2057.87610619469,83.0265486725664
"11910","34102","2021",6,6,0,441500,3749.16666666667,119.833333333333
"11911","34103","2021",20,20,0,216393.75,1934,112.15
"11912","34104","2021",2,2,0,129647.5,1760.5,72.5
"11913","34105","2021",5,5,0,212680,1959.8,105.6
"11914","34106","2021",1,1,0,335725,2752,122
"11915","34107","2021",10,10,0,89033,1145.2,82.8
"11916","34108","2021",535,247,288,203132.928971963,3222.04299065421,66
"11917","34109","2021",26,26,0,208712.692307692,1879.65384615385,106.269230769231
"11918","34110","2021",12,12,0,355297.166666667,2990.08333333333,121.25
"11919","34111","2021",59,28,31,129396.050847458,1521.50847457627,86.6271186440678
"11920","34112","2021",1,1,0,2e+05,1754,114
"11921","34113","2021",114,93,21,282928.763157895,3047.63157894737,94.3333333333333
"11922","34114","2021",91,82,9,236032.549450549,2642.89010989011,90.8021978021978
"11923","34115","2021",3,3,0,166813.333333333,2066,78
"11924","34116","2021",178,68,110,241152.915730337,3245.28651685393,71
"11925","34117","2021",19,14,5,63235.2631578947,912.526315789474,73.5263157894737
"11926","34118","2021",4,4,0,555072.25,3204.25,175
"11927","34119","2021",37,32,5,132912.459459459,1554.54054054054,86.5405405405405
"11928","34120","2021",90,60,30,338217.255555556,3800.43333333333,89.6222222222222
"11929","34121","2021",8,8,0,127625,1726.25,79.625
"11930","34122","2021",15,14,1,198940.933333333,2241.86666666667,96.6
"11931","34123","2021",231,149,82,293168.051948052,3223.45021645022,91.4978354978355
"11932","34124","2021",4,4,0,308850,2496.25,125.75
"11933","34125","2021",3,3,0,370333.333333333,3134,111.333333333333
"11934","34126","2021",43,21,22,128072.302325581,1846.97674418605,72.6511627906977
"11935","34127","2021",40,36,4,262349.55,2858.825,94.35
"11936","34128","2021",27,22,5,230594.62962963,2151.85185185185,104.592592592593
"11937","34129","2021",293,126,167,364713.293515358,4539.41296928328,81.3651877133106
"11938","34130","2021",33,32,1,189363.121212121,1899.09090909091,100.939393939394
"11939","34131","2021",5,5,0,343342.6,3713.2,93.6
"11940","34132","2021",2,2,0,153500,1958,77.5
"11941","34133","2021",1,1,0,20000,1000,20
"11942","34134","2021",33,24,9,299089.03030303,3399.33333333333,90.5757575757576
"11943","34135","2021",74,67,7,172513.297297297,1729.5,99.6081081081081
"11944","34136","2021",28,26,2,181981.25,1955.32142857143,94.1785714285714
"11945","34137","2021",2,2,0,414640,3163,145
"11946","34138","2021",4,4,0,265175,2170,118.5
"11947","34139","2021",18,17,1,236681.111111111,2131.88888888889,109.333333333333
"11948","34140","2021",59,58,1,245071.677966102,2320.5593220339,107.593220338983
"11949","34141","2021",14,14,0,124065,1186.85714285714,100.857142857143
"11950","34142","2021",105,51,54,140026.304761905,1690.86666666667,79.9523809523809
"11951","34143","2021",53,50,3,225557.20754717,3068.03773584906,83.6415094339623
"11952","34144","2021",15,14,1,150076.333333333,1331.06666666667,103.866666666667
"11953","34145","2021",481,269,212,189238.975051975,2455.09563409563,77.6632016632017
"11954","34146","2021",42,35,7,254061.095238095,2947.33333333333,89.3571428571429
"11955","34147","2021",60,58,2,230135.433333333,2281,101.4
"11956","34148","2021",83,75,8,211116.879518072,2019.07228915663,102.530120481928
"11957","34149","2021",12,12,0,240330,2232.83333333333,123.916666666667
"11958","34150","2021",448,228,220,184388.227678571,3499.79910714286,56.7834821428571
"11959","34151","2021",140,98,42,205966.264285714,2539.02142857143,83.6214285714286
"11960","34152","2021",5,5,0,446737.6,2774.4,155.6
"11961","34153","2021",22,20,2,372713,3587.18181818182,106.636363636364
"11962","34154","2021",453,158,295,269455.889624724,4387.61589403974,61.7174392935982
"11963","34155","2021",39,38,1,205268.461538462,2085.58974358974,98.3333333333333
"11964","34156","2021",1,1,0,355000,2886,123
"11965","34157","2021",249,160,89,262681.726907631,3227.80722891566,82.7028112449799
"11966","34158","2021",3,3,0,74560,1400,53.6666666666667
"11967","34159","2021",39,31,8,253459.948717949,3229.10256410256,79.2820512820513
"11968","34160","2021",4,4,0,182175,2554.75,75.25
"11969","34161","2021",62,59,3,213111.612903226,2209.5,97.8387096774194
"11970","34162","2021",77,67,10,168640.311688312,2006.28571428571,86.7402597402597
"11971","34163","2021",64,59,5,302639.9375,3177.796875,96.59375
"11972","34164","2021",14,13,1,368706.071428571,3851.78571428571,106.428571428571
"11973","34165","2021",47,36,11,229065.191489362,2674.1914893617,88.8510638297872
"11974","34166","2021",59,56,3,214103.152542373,2219.30508474576,97.0338983050847
"11975","34167","2021",2,2,0,254650,2262.5,115.5
"11976","34169","2021",55,49,6,557159.109090909,4210.01818181818,130.509090909091
"11977","34170","2021",5,4,1,90790,1193.4,78.2
"11978","34172","2021",5571,594,4977,200418.281278047,3320.38951714234,61.3313588224735
"11979","34173","2021",24,21,3,229565.416666667,2191.79166666667,113.875
"11980","34174","2021",11,11,0,398438.181818182,2814.54545454545,120.272727272727
"11981","34176","2021",50,41,9,351716.42,3432.88,97.88
"11982","34177","2021",3,3,0,376088.333333333,3264,115.333333333333
"11983","34178","2021",50,49,1,150146.52,1909.46,82.76
"11984","34179","2021",22,21,1,330465.909090909,2972.81818181818,118.227272727273
"11985","34180","2021",28,25,3,162717.678571429,1858.5,85.9642857142857
"11986","34181","2021",27,27,0,274075.925925926,2531.11111111111,114.037037037037
"11987","34182","2021",38,38,0,265011.315789474,2693.18421052632,99.7105263157895
"11988","34183","2021",73,70,3,177919.369863014,1814.91780821918,100.616438356164
"11989","34184","2021",8,8,0,184150,2299,89.375
"11990","34185","2021",3,3,0,279715,2388.33333333333,121
"11991","34186","2021",4,3,1,131000,2027.75,64.75
"11992","34187","2021",14,13,1,103651.785714286,1202.85714285714,80.2857142857143
"11993","34188","2021",3,3,0,92883.3333333333,2034.33333333333,59.3333333333333
"11994","34189","2021",32,31,1,111902.8125,1211.5,102.84375
"11995","34190","2021",7,7,0,143952.142857143,1646.14285714286,86
"11996","34191","2021",11,11,0,193759.090909091,1739.09090909091,107.363636363636
"11997","34192","2021",340,46,294,231880.511764706,4959.74117647059,47.5529411764706
"11998","34193","2021",7,7,0,227746.428571429,1813.85714285714,108.857142857143
"11999","34194","2021",69,65,4,190914.652173913,2464.59420289855,80.8550724637681
"12000","34196","2021",2,2,0,55500,932,59.5
"12001","34197","2021",21,15,6,171982.619047619,2009.42857142857,85.8571428571429
"12002","34198","2021",125,95,30,395573.944,4336.48,91.048
"12003","34199","2021",145,87,58,203287.234482759,2216.84827586207,85.7793103448276
"12004","34200","2021",6,6,0,165241.666666667,1395,110.333333333333
"12005","34201","2021",2,2,0,272500,1689,149
"12006","34202","2021",120,77,43,290342.2,3255.41666666667,90.5416666666667
"12007","34203","2021",35,34,1,187549.857142857,2194.02857142857,83.9142857142857
"12008","34204","2021",30,28,2,240848.533333333,2509.66666666667,97.4
"12009","34205","2021",7,7,0,136960,2545,56.1428571428571
"12010","34206","2021",6,5,1,210643.333333333,2348.83333333333,88.8333333333333
"12011","34207","2021",84,82,2,200633.511904762,2287.14285714286,89.8095238095238
"12012","34208","2021",8,8,0,283140,2478.875,107.375
"12013","34209","2021",136,117,19,182598.279411765,3271.99264705882,60
"12014","34210","2021",40,34,6,237657.375,2281.2,100.675
"12015","34211","2021",21,20,1,128085.714285714,1578.38095238095,88.0952380952381
"12016","34212","2021",1,1,0,241740,1860,130
"12017","34213","2021",114,88,26,271861.947368421,3010.85087719298,89.1228070175439
"12018","34214","2021",30,29,1,163138.5,2006.73333333333,84.6333333333333
"12019","34215","2021",9,8,1,232203.888888889,2452.22222222222,93.2222222222222
"12020","34216","2021",2,2,0,146500,1115,146.5
"12021","34217","2021",97,72,25,366826.268041237,3921.40206185567,93.4329896907217
"12022","34218","2021",7,7,0,205030.428571429,1772,108.285714285714
"12023","34219","2021",11,10,1,111872.818181818,971.363636363636,111.727272727273
"12024","34220","2021",2,2,0,116595,2906,48.5
"12025","34221","2021",10,10,0,161174.6,1704,89.7
"12026","34222","2021",7,7,0,309598.571428571,2827.85714285714,110.285714285714
"12027","34223","2021",24,23,1,270410.208333333,2075.70833333333,127.458333333333
"12028","34224","2021",36,35,1,235367.638888889,2214.16666666667,101.777777777778
"12029","34225","2021",65,60,5,169265.430769231,1664.83076923077,102.2
"12030","34226","2021",35,35,0,152943.285714286,1685.05714285714,101.228571428571
"12031","34227","2021",37,33,4,380679.918918919,3414.2972972973,114.837837837838
"12032","34228","2021",1,1,0,40000,1111,36
"12033","34229","2021",16,16,0,100752.5,1059.5,90.4375
"12034","34230","2021",2,2,0,72000,1592.5,56.5
"12035","34232","2021",17,17,0,181700,2168,97.7058823529412
"12036","34233","2021",3,3,0,116300,1284.66666666667,83.3333333333333
"12037","34234","2021",5,5,0,149719.8,1591.6,85.4
"12038","34235","2021",8,8,0,110698.875,1761.5,66
"12039","34236","2021",1,0,1,299387,2065,145
"12040","34237","2021",63,61,2,208630.571428571,2076.36507936508,95.3015873015873
"12041","34238","2021",1,1,0,110000,1930,57
"12042","34239","2021",113,98,15,215556.442477876,2335.54867256637,91.4601769911504
"12043","34240","2021",39,35,4,394283.153846154,3819.51282051282,105.974358974359
"12044","34241","2021",8,8,0,191193.75,2060.875,87.875
"12045","34242","2021",21,21,0,351104.238095238,3623.2380952381,110.380952380952
"12046","34243","2021",28,27,1,224202.107142857,2111.96428571429,110.5
"12047","34244","2021",51,35,16,312292.882352941,3503.39215686275,90.3921568627451
"12048","34245","2021",37,37,0,134216.621621622,1460.43243243243,94.0810810810811
"12049","34246","2021",34,30,4,295770.735294118,3011.61764705882,102.764705882353
"12050","34247","2021",69,61,8,586211.057971015,4293.95652173913,139.927536231884
"12051","34248","2021",11,11,0,446466.363636364,3666.09090909091,126.272727272727
"12052","34249","2021",39,35,4,391704.974358974,3398.12820512821,116.076923076923
"12053","34250","2021",7,7,0,103211.428571429,1303.42857142857,85.5714285714286
"12054","34251","2021",9,9,0,151127.777777778,1760.44444444444,78.7777777777778
"12055","34252","2021",13,10,3,94362.3076923077,1207.92307692308,81.3846153846154
"12056","34253","2021",1,1,0,452860,4313,105
"12057","34254","2021",15,14,1,223110,2262.06666666667,98.4
"12058","34255","2021",151,132,19,477326.125827815,3953.13907284768,115.701986754967
"12059","34256","2021",25,24,1,335629.4,3070.6,113.56
"12060","34257","2021",1,1,0,93000,1033,90
"12061","34258","2021",44,44,0,214396.590909091,1966.47727272727,109.613636363636
"12062","34259","2021",57,43,14,328979.192982456,3355.91228070175,98.5789473684211
"12063","34260","2021",15,15,0,61120,873.266666666667,69.6666666666667
"12064","34261","2021",7,6,1,232540,2432.28571428571,106.428571428571
"12065","34262","2021",3,3,0,293046.666666667,1716.33333333333,157.666666666667
"12066","34263","2021",5,5,0,396538.8,3541,112.4
"12067","34264","2021",1,1,0,130000,703,185
"12068","34265","2021",9,9,0,462354,4049,118
"12069","34266","2021",7,7,0,626732.142857143,3879.28571428571,164.714285714286
"12070","34267","2021",29,29,0,210065.896551724,2412.51724137931,92.1034482758621
"12071","34268","2021",7,6,1,234903.571428571,2168,103.857142857143
"12072","34269","2021",2,2,0,195625,1371,145
"12073","34270","2021",150,92,58,332194.46,3768.47333333333,89.6333333333333
"12074","34271","2021",7,7,0,198585,2062.28571428571,96.7142857142857
"12075","34272","2021",38,33,5,300407.921052632,3123.68421052632,95.5789473684211
"12076","34273","2021",4,4,0,162625,1462,108.25
"12077","34274","2021",28,27,1,322376.285714286,3249.5,106.107142857143
"12078","34276","2021",62,56,6,358398.435483871,3524.03225806452,100.112903225806
"12079","34277","2021",5,5,0,174598,2298.2,79
"12080","34278","2021",2,2,0,116500,1598.5,75.5
"12081","34279","2021",10,10,0,80609,1137.6,79.3
"12082","34280","2021",1,1,0,332300,3226,103
"12083","34281","2021",50,49,1,203923.24,2130.52,94.22
"12084","34282","2021",13,11,2,341260,2988.46153846154,116.846153846154
"12085","34283","2021",4,4,0,98891.5,1797,52.75
"12086","34284","2021",32,27,5,112322.59375,1072.6875,102.5625
"12087","34285","2021",12,11,1,240505,2401.91666666667,107.5
"12088","34286","2021",10,10,0,129130,1644.6,84.7
"12089","34287","2021",8,7,1,148835,1431.25,108.375
"12090","34288","2021",15,15,0,425172.4,2871.93333333333,137.733333333333
"12091","34289","2021",59,56,3,200321.796610169,2221.59322033898,88.7627118644068
"12092","34290","2021",8,7,1,519109.375,4419.375,121.875
"12093","34291","2021",7,7,0,170825.714285714,1568.28571428571,104.714285714286
"12094","34292","2021",6,6,0,179431.666666667,2089,81.5
"12095","34293","2021",65,63,2,116318.476923077,1558.4,71.4
"12096","34294","2021",15,13,2,277622.666666667,2937.2,95.3333333333333
"12097","34295","2021",22,21,1,403339.5,3664.31818181818,112.681818181818
"12098","34296","2021",12,12,0,322858.333333333,3279.16666666667,100.833333333333
"12099","34297","2021",7,6,1,288192.857142857,3987.28571428571,79.5714285714286
"12100","34298","2021",96,92,4,246192.3125,2472.375,101.802083333333
"12101","34299","2021",172,139,33,229170.837209302,2668.71511627907,87.6162790697674
"12102","34300","2021",124,117,7,196343.782258065,1973.83870967742,98.8306451612903
"12103","34301","2021",1370,195,1175,205069.819708029,3326.45547445255,60.9715328467153
"12104","34302","2021",20,19,1,196686,2118.25,99.55
"12105","34304","2021",16,15,1,225748.875,2153.5625,101.25
"12106","34305","2021",9,9,0,98561.1111111111,1335.66666666667,88.2222222222222
"12107","34306","2021",2,2,0,212980,2368,93.5
"12108","34307","2021",32,27,5,336942.8125,3162.1875,108.1875
"12109","34308","2021",10,10,0,163645,1308.2,118.4
"12110","34309","2021",57,49,8,455517.315789474,3947.82456140351,118.122807017544
"12111","34310","2021",62,61,1,234631.258064516,2119.90322580645,108.290322580645
"12112","34311","2021",42,39,3,254177.238095238,2606.71428571429,98.4523809523809
"12113","34312","2021",21,19,2,171586.428571429,1857.14285714286,95.5238095238095
"12114","34313","2021",10,10,0,211195,2010.5,96.4
"12115","34314","2021",11,10,1,461567.636363636,3740.81818181818,124.727272727273
"12116","34315","2021",3,3,0,181666.666666667,1809.33333333333,92.3333333333333
"12117","34316","2021",3,3,0,125370,1638.66666666667,72.6666666666667
"12118","34317","2021",6,5,1,119880,1317.33333333333,88.5
"12119","34318","2021",10,10,0,342286.6,3103.9,113
"12120","34320","2021",35,34,1,364960.342857143,3307.68571428571,113.6
"12121","34321","2021",37,33,4,357939.891891892,3353.51351351351,109.972972972973
"12122","34322","2021",6,6,0,425246.666666667,3806,114.833333333333
"12123","34323","2021",1,1,0,421850,2526,167
"12124","34324","2021",419,163,256,166763.109785203,3304.16706443914,52.0859188544153
"12125","34325","2021",41,41,0,241222.12195122,2384.63414634146,99.7317073170732
"12126","34327","2021",95,72,23,329540.378947368,3602.52631578947,93.7894736842105
"12127","34328","2021",12,11,1,224551.666666667,2356.75,94.5
"12128","34329","2021",86,78,8,186335.802325581,3072.45348837209,68.9767441860465
"12129","34331","2021",10,10,0,75075,981.3,76.8
"12130","34332","2021",215,180,35,175721.702325581,2894.51627906977,65.2558139534884
"12131","34333","2021",82,80,2,193038.451219512,5140.93902439024,43.9146341463415
"12132","34334","2021",3,3,0,92500,1506.33333333333,57.6666666666667
"12133","34335","2021",11,11,0,248965.909090909,2297.54545454545,95.4545454545455
"12134","34336","2021",97,71,26,163709.597938144,2002.10309278351,79.4742268041237
"12135","34337","2021",137,105,32,313868.751824818,3597.3795620438,88.6496350364963
"12136","34339","2021",4,4,0,127607.5,1280.25,102.5
"12137","34340","2021",18,17,1,360874.222222222,3158.27777777778,114.833333333333
"12138","34341","2021",57,53,4,242327.263157895,2401.73684210526,100.824561403509
"12139","34342","2021",6,2,4,252850,2207.33333333333,107.333333333333
"12140","34343","2021",13,11,2,341035.923076923,2962.53846153846,109.076923076923
"12141","34344","2021",981,86,895,196900.729867482,4907.20693170234,39.184505606524
"12142","35001","2021",98,65,33,290676.326530612,2944.32653061224,101.591836734694
"12143","35002","2021",27,27,0,193634.703703704,2256.44444444444,88.5555555555556
"12144","35003","2021",9,9,0,227705,2195.11111111111,102.777777777778
"12145","35004","2021",83,82,1,112816.903614458,1191.09638554217,92.1566265060241
"12146","35005","2021",7,7,0,166000,1659.85714285714,102.714285714286
"12147","35006","2021",51,46,5,188980.705882353,1995.6862745098,96.6666666666667
"12148","35007","2021",9,9,0,229083.333333333,2151.22222222222,109.555555555556
"12149","35008","2021",6,6,0,129451.666666667,1632.66666666667,79.3333333333333
"12150","35009","2021",24,23,1,145865,1692.54166666667,90.5416666666667
"12151","35010","2021",30,30,0,208525.133333333,1906.1,104.7
"12152","35012","2021",107,80,27,170196.831775701,1977.23364485981,90.1401869158879
"12153","35013","2021",50,49,1,146250.88,1501.54,94.58
"12154","35014","2021",25,25,0,175026.88,1677.48,106.08
"12155","35015","2021",28,28,0,153834.5,1566.64285714286,97.3214285714286
"12156","35016","2021",35,35,0,178498.142857143,2032.42857142857,94.9428571428571
"12157","35017","2021",8,8,0,235312.5,1912.75,144.25
"12158","35018","2021",18,18,0,118475.722222222,1411.55555555556,86.0555555555556
"12159","35019","2021",34,34,0,111342.088235294,1428.85294117647,80.7647058823529
"12160","35021","2021",17,17,0,165467.647058824,1584.58823529412,107.882352941176
"12161","35022","2021",9,8,1,189294.777777778,1797.22222222222,105.666666666667
"12162","35023","2021",90,76,14,250979.966666667,2447.3,104.533333333333
"12163","35024","2021",186,116,70,292261.344086022,3195.13440860215,93.252688172043
"12164","35025","2021",21,21,0,164391.19047619,1529.42857142857,113.904761904762
"12165","35026","2021",2,2,0,164500,1440.5,116.5
"12166","35027","2021",27,27,0,216551,2051.03703703704,111.518518518519
"12167","35028","2021",14,14,0,163587.857142857,1767.71428571429,92.6428571428571
"12168","35029","2021",24,24,0,167104.75,1778.875,97.9166666666667
"12169","35030","2021",9,9,0,130308.888888889,1485.88888888889,92.5555555555556
"12170","35031","2021",79,73,6,230033.696202532,2253.48101265823,104.607594936709
"12171","35032","2021",61,45,16,238632.098360656,2542.34426229508,94.9344262295082
"12172","35033","2021",42,35,7,223848.547619048,2092.30952380952,110.690476190476
"12173","35034","2021",21,20,1,120714.285714286,1322.28571428571,92
"12174","35035","2021",8,8,0,168183.75,1693.125,110.25
"12175","35037","2021",99,77,22,218416.323232323,2426.32323232323,92.989898989899
"12176","35038","2021",12,12,0,156916.666666667,1672.25,98.0833333333333
"12177","35039","2021",30,13,17,223812.1,2459.93333333333,88.1666666666667
"12178","35040","2021",54,40,14,193873.740740741,2197.25925925926,89.7777777777778
"12179","35041","2021",7,7,0,194500,1806.85714285714,107.142857142857
"12180","35042","2021",13,13,0,154917.692307692,1444.30769230769,109.538461538462
"12181","35044","2021",3,3,0,127500,1258.33333333333,102.333333333333
"12182","35045","2021",11,11,0,134871.727272727,1513.54545454545,93.3636363636364
"12183","35046","2021",10,10,0,123430.7,1406.2,87.7
"12184","35047","2021",284,139,145,256330.718309859,3194.74647887324,82.9119718309859
"12185","35049","2021",145,89,56,287274.144827586,3482.61379310345,86.0344827586207
"12186","35050","2021",10,10,0,239818.3,1917.6,136.4
"12187","35051","2021",281,135,146,335469.957295374,3694.55871886121,89.5978647686833
"12188","35052","2021",9,8,1,210488.888888889,1737.22222222222,115.888888888889
"12189","35054","2021",22,22,0,221514.136363636,2258.40909090909,101.818181818182
"12190","35055","2021",147,54,93,246516.462585034,2979.19047619048,84.5170068027211
"12191","35056","2021",10,10,0,186008.9,2028.2,91.7
"12192","35057","2021",26,21,5,141914.615384615,1766.23076923077,81.4615384615385
"12193","35058","2021",11,11,0,206909.090909091,2032.09090909091,99.1818181818182
"12194","35059","2021",63,46,17,334293.666666667,3187.92063492063,101.349206349206
"12195","35060","2021",14,14,0,193137.071428571,1873.21428571429,104.285714285714
"12196","35061","2021",11,11,0,161292.454545455,1499.18181818182,108.454545454545
"12197","35062","2021",17,17,0,133147.058823529,1361.58823529412,92.5294117647059
"12198","35063","2021",7,7,0,151714.285714286,1464.28571428571,115.714285714286
"12199","35064","2021",35,35,0,119181.285714286,1232.6,91.5142857142857
"12200","35065","2021",23,22,1,238002.608695652,2453.26086956522,97.695652173913
"12201","35066","2021",120,47,73,209178.875,2890.39166666667,73.5416666666667
"12202","35067","2021",16,16,0,259373.8125,2343.6875,111.5
"12203","35068","2021",94,68,26,219430.29787234,2376.1914893617,94.2446808510638
"12204","35069","2021",166,129,37,276061.674698795,2660.31927710843,105.253012048193
"12205","35070","2021",33,24,9,212306,2425.75757575758,90.030303030303
"12206","35071","2021",8,8,0,131312.5,1126.625,113.75
"12207","35072","2021",25,25,0,134552.8,1337.6,104.24
"12208","35075","2021",19,18,1,163694.736842105,1440.63157894737,112.105263157895
"12209","35076","2021",88,48,40,218315.284090909,2550.71590909091,87.2045454545455
"12210","35077","2021",9,9,0,109201.666666667,1308.11111111111,82.5555555555556
"12211","35078","2021",15,14,1,200513.333333333,1907.4,105.933333333333
"12212","35079","2021",29,26,3,289471.103448276,2919.03448275862,99.3103448275862
"12213","35080","2021",38,32,6,217896.657894737,2271.26315789474,97.2105263157895
"12214","35081","2021",5,5,0,197090,2445.2,81.2
"12215","35082","2021",23,23,0,156082.47826087,1386.21739130435,118.04347826087
"12216","35084","2021",15,15,0,116256,1290.53333333333,85.3333333333333
"12217","35085","2021",79,65,14,162677.164556962,1812.64556962025,92.1139240506329
"12218","35086","2021",13,13,0,137365.384615385,1454.46153846154,94.6153846153846
"12219","35087","2021",14,14,0,157766.214285714,1469.35714285714,106
"12220","35088","2021",40,37,3,244486.475,2214.85,110.4
"12221","35089","2021",17,17,0,179558.823529412,1925.17647058824,92.8823529411765
"12222","35090","2021",43,33,10,207415.209302326,2140.41860465116,96.9302325581395
"12223","35091","2021",19,19,0,134094.947368421,1280.10526315789,96.6842105263158
"12224","35092","2021",12,12,0,138816.666666667,1360.16666666667,100
"12225","35093","2021",377,170,207,389016.75066313,5065.60212201592,77.0291777188329
"12226","35094","2021",26,24,2,173860.384615385,1813.07692307692,93.5769230769231
"12227","35095","2021",120,74,46,183126.558333333,2203.525,84.1583333333333
"12228","35096","2021",34,24,10,172837.323529412,2134.5,85.0588235294118
"12229","35097","2021",20,20,0,175825,1680.4,107.25
"12230","35098","2021",19,19,0,141694.736842105,1760.05263157895,82.5789473684211
"12231","35099","2021",59,49,10,259778.983050847,2466.81355932203,105.186440677966
"12232","35101","2021",21,21,0,208133.80952381,1960.52380952381,106.952380952381
"12233","35102","2021",4,4,0,140622.5,1495.5,93.25
"12234","35103","2021",13,13,0,121769.230769231,1259,97.2307692307692
"12235","35104","2021",19,19,0,155045,1459.42105263158,105.421052631579
"12236","35105","2021",22,22,0,168236.5,1652,111.045454545455
"12237","35106","2021",27,27,0,133031.481481481,1299.37037037037,104.592592592593
"12238","35107","2021",25,24,1,239455.2,2174.12,114.64
"12239","35108","2021",18,17,1,173480.555555556,1910,101.611111111111
"12240","35109","2021",36,26,10,177043,1867.41666666667,102.027777777778
"12241","35110","2021",10,10,0,139148.4,1588.3,95.5
"12242","35111","2021",8,8,0,84562.5,931.5,104.375
"12243","35112","2021",15,15,0,163045.333333333,1568.46666666667,115.2
"12244","35114","2021",2,2,0,201500,2542.5,75.5
"12245","35115","2021",366,162,204,134485.986338798,1698.87431693989,80.2786885245902
"12246","35116","2021",41,39,2,199127.780487805,2310.12195121951,91.3170731707317
"12247","35117","2021",22,15,7,91813.8636363636,1146.36363636364,76.4545454545455
"12248","35118","2021",18,18,0,191361.666666667,1711.27777777778,116.111111111111
"12249","35119","2021",12,12,0,142163.5,1268.75,111.166666666667
"12250","35120","2021",81,58,23,233911.567901235,2538.85185185185,91.1234567901235
"12251","35121","2021",18,17,1,225783.333333333,2117.11111111111,109.277777777778
"12252","35122","2021",34,31,3,267269.5,2530.85294117647,104.5
"12253","35123","2021",66,50,16,214010.045454545,2180.09090909091,100.30303030303
"12254","35124","2021",41,40,1,145945.146341463,1360.43902439024,103.731707317073
"12255","35125","2021",84,67,17,127645.976190476,1364.72619047619,93.1190476190476
"12256","35126","2021",123,107,16,252065.487804878,2397.53658536585,108.113821138211
"12257","35127","2021",57,49,8,186878.140350877,2050.42105263158,93.3333333333333
"12258","35128","2021",30,30,0,180587.5,1905.13333333333,98.7666666666667
"12259","35130","2021",39,33,6,192757.461538462,2031.30769230769,94.5384615384615
"12260","35131","2021",66,42,24,235680.060606061,2663.80303030303,90.3030303030303
"12261","35132","2021",24,24,0,186554.791666667,2174.45833333333,94
"12262","35133","2021",61,60,1,179967.032786885,1934.45901639344,97.9672131147541
"12263","35134","2021",2,2,0,202500,2154.5,98.5
"12264","35135","2021",30,28,2,201412.1,2082.53333333333,102.1
"12265","35136","2021",128,76,52,179657.3671875,2240.921875,84.4921875
"12266","35137","2021",27,27,0,193654.555555556,1773.07407407407,112.185185185185
"12267","35138","2021",7,7,0,141214.285714286,1645.85714285714,82.7142857142857
"12268","35139","2021",76,57,19,251453.289473684,2609.14473684211,100.052631578947
"12269","35140","2021",12,12,0,112765.833333333,1229.25,92.1666666666667
"12270","35141","2021",8,8,0,199045,1661.125,119.625
"12271","35142","2021",19,17,2,129131.578947368,1389.26315789474,94.2105263157895
"12272","35143","2021",14,14,0,174155,1488.07142857143,120.285714285714
"12273","35144","2021",19,17,2,211524.473684211,2568.36842105263,86.6315789473684
"12274","35145","2021",36,36,0,113795.083333333,1216.13888888889,91.1944444444444
"12275","35146","2021",7,7,0,194790,2036.57142857143,93.7142857142857
"12276","35148","2021",4,4,0,128693.75,1268.5,99.75
"12277","35149","2021",18,18,0,238146.666666667,2085.94444444444,115.333333333333
"12278","35150","2021",41,40,1,191920.634146341,1925.07317073171,101.390243902439
"12279","35151","2021",11,11,0,132235.454545455,1291.81818181818,98.6363636363636
"12280","35152","2021",104,88,16,252373.211538462,2566.65384615385,99.3653846153846
"12281","35153","2021",7,7,0,190000,1811.71428571429,109.285714285714
"12282","35154","2021",19,19,0,165019.578947368,1716.63157894737,102.578947368421
"12283","35155","2021",7,7,0,226360,2059,123.285714285714
"12284","35156","2021",9,9,0,190839.555555556,1835,110
"12285","35157","2021",11,11,0,96106.6363636364,1176.81818181818,83.4545454545455
"12286","35159","2021",7,7,0,139407.142857143,1254.28571428571,112.428571428571
"12287","35160","2021",5,5,0,107900,1331.8,85.6
"12288","35161","2021",25,25,0,155461.16,1689.72,93.72
"12289","35162","2021",79,74,5,96787.2151898734,1121.39240506329,90.1392405063291
"12290","35163","2021",23,23,0,122173.913043478,1247.52173913043,104.086956521739
"12291","35164","2021",12,12,0,109208.333333333,1391.75,77.0833333333333
"12292","35165","2021",16,16,0,178453.125,1327.8125,144.0625
"12293","35166","2021",6,6,0,202048.333333333,1738.66666666667,118.166666666667
"12294","35167","2021",41,39,2,120992.682926829,1278.36585365854,97.2439024390244
"12295","35168","2021",69,68,1,142641.869565217,1580.52173913043,91.6086956521739
"12296","35169","2021",22,22,0,136020.454545455,1472.27272727273,97.0909090909091
"12297","35170","2021",8,7,1,160531.25,1496.625,108.125
"12298","35171","2021",26,25,1,164066.076923077,1487.57692307692,109.307692307692
"12299","35172","2021",23,23,0,137455.695652174,1628.82608695652,88.2608695652174
"12300","35173","2021",96,77,19,302085.03125,2720.125,112.895833333333
"12301","35174","2021",18,17,1,128705,1252.16666666667,98.7777777777778
"12302","35175","2021",11,11,0,137426.363636364,1694,82.3636363636364
"12303","35176","2021",102,100,2,141327.794117647,1633.27450980392,87.5588235294118
"12304","35177","2021",71,45,26,283853.85915493,2738.15492957746,102.169014084507
"12305","35178","2021",17,17,0,210334.529411765,2077.05882352941,108
"12306","35179","2021",89,74,15,186593.146067416,2082.44943820225,92.5955056179775
"12307","35180","2021",10,10,0,167865,1606.4,101.7
"12308","35181","2021",23,23,0,362450.217391304,3265.5652173913,112.869565217391
"12309","35183","2021",8,8,0,148249.125,1589.875,96.25
"12310","35184","2021",98,86,12,201529.489795918,2038.88775510204,101.714285714286
"12311","35185","2021",7,6,1,91686.2857142857,1231.42857142857,70.8571428571429
"12312","35186","2021",18,18,0,224783.333333333,1963.66666666667,113.777777777778
"12313","35187","2021",16,16,0,179621.875,1830.875,101.875
"12314","35188","2021",97,64,33,207362.886597938,2329.13402061856,91.6082474226804
"12315","35189","2021",52,41,11,319653.384615385,2991.63461538462,108.942307692308
"12316","35190","2021",5,5,0,115700,1564.2,82
"12317","35191","2021",32,32,0,125946.125,1342.40625,96.71875
"12318","35192","2021",4,4,0,216300,1136,182
"12319","35193","2021",21,21,0,237050.857142857,2257.28571428571,106.190476190476
"12320","35194","2021",15,15,0,262972.6,2215.66666666667,120.466666666667
"12321","35195","2021",37,34,3,191454.486486486,1907,102.054054054054
"12322","35196","2021",116,65,51,227481.00862069,2772.93965517241,86.2758620689655
"12323","35197","2021",24,24,0,267035.208333333,2402.66666666667,113.166666666667
"12324","35198","2021",9,8,1,207822.222222222,1811.44444444444,115.333333333333
"12325","35199","2021",5,5,0,196256,1198.8,189.6
"12326","35200","2021",14,14,0,135278.571428571,1246.92857142857,108.071428571429
"12327","35201","2021",17,17,0,153940.588235294,1393.82352941176,116.294117647059
"12328","35202","2021",15,15,0,190345,1617.13333333333,121.533333333333
"12329","35203","2021",2,2,0,374000,2321.5,158
"12330","35204","2021",45,43,2,277351.955555556,2446.64444444444,116.688888888889
"12331","35205","2021",6,6,0,126054.166666667,1149.83333333333,103.5
"12332","35206","2021",114,56,58,234864.956140351,2877.05263157895,82.6578947368421
"12333","35207","2021",94,58,36,258926.5,2783.63829787234,94.2340425531915
"12334","35208","2021",84,64,20,236693.928571429,2414.2380952381,98.5952380952381
"12335","35210","2021",152,75,77,286477.855263158,3069.98026315789,92.2631578947368
"12336","35211","2021",48,47,1,162801.604166667,1710.70833333333,99.25
"12337","35212","2021",18,18,0,135848.833333333,1558.05555555556,89.7222222222222
"12338","35214","2021",19,19,0,165854.578947368,1534.15789473684,106
"12339","35215","2021",16,15,1,144800,1299.9375,116.5625
"12340","35216","2021",31,24,7,229791.903225806,2399.67741935484,103.903225806452
"12341","35217","2021",26,25,1,148865.384615385,1335.46153846154,111.961538461538
"12342","35218","2021",13,13,0,214748.307692308,1879.46153846154,121.230769230769
"12343","35219","2021",63,54,9,139828.682539683,1639.92063492063,86.9206349206349
"12344","35220","2021",45,44,1,209701.666666667,2050.08888888889,104.4
"12345","35221","2021",35,34,1,154928.285714286,1647.51428571429,93.3714285714286
"12346","35222","2021",34,34,0,144273.764705882,1536.91176470588,95.4117647058823
"12347","35223","2021",59,55,4,167319.949152542,1879.86440677966,91.4915254237288
"12348","35224","2021",44,44,0,200363.863636364,2344.13636363636,87.75
"12349","35225","2021",19,18,1,178446.473684211,1535.47368421053,116.105263157895
"12350","35226","2021",44,40,4,165025.25,1795.45454545455,91.5909090909091
"12351","35227","2021",48,42,6,240699.125,2442.20833333333,101.479166666667
"12352","35228","2021",159,90,69,226888.578616352,2716.74842767296,83.3459119496855
"12353","35229","2021",15,15,0,188204.466666667,1801.86666666667,104.066666666667
"12354","35230","2021",5,5,0,128200,1233.8,102.2
"12355","35231","2021",18,13,5,168046.666666667,1961.88888888889,83.9444444444444
"12356","35232","2021",9,9,0,112500,1187.55555555556,92.2222222222222
"12357","35233","2021",19,19,0,170159.210526316,1795.57894736842,98.8947368421053
"12358","35234","2021",23,22,1,132950,1255.34782608696,104.95652173913
"12359","35235","2021",23,23,0,133454.347826087,1311.69565217391,101.782608695652
"12360","35236","2021",181,93,88,147732.883977901,1784.51933701657,84.353591160221
"12361","35237","2021",19,19,0,107332.631578947,1287.94736842105,79.4210526315789
"12362","35238","2021",3954,552,3402,256903.111532625,3902.85128983308,66.6750126454224
"12363","35239","2021",71,64,7,156914.295774648,1670.95774647887,100.718309859155
"12364","35240","2021",150,65,85,233308.053333333,2824.26,85.4133333333333
"12365","35241","2021",40,30,10,276961.3,3088.875,98.425
"12366","35242","2021",7,7,0,115971.428571429,903.571428571429,119.142857142857
"12367","35243","2021",32,31,1,176502.09375,1731.53125,99.90625
"12368","35244","2021",6,6,0,120969.166666667,1067.16666666667,106.166666666667
"12369","35245","2021",60,50,10,214099.416666667,2089.4,103.383333333333
"12370","35246","2021",19,19,0,192473.684210526,1953.05263157895,98.9473684210526
"12371","35247","2021",26,24,2,160834.346153846,1996.15384615385,92.8461538461538
"12372","35248","2021",12,12,0,100241.666666667,1213.25,86.6666666666667
"12373","35249","2021",26,26,0,95938.4615384615,1227.34615384615,79.5384615384615
"12374","35250","2021",46,27,19,201235.934782609,2479.30434782609,83.4565217391304
"12375","35251","2021",52,37,15,193678.423076923,2202.86538461538,88.4615384615385
"12376","35252","2021",11,11,0,216226.363636364,1826,114.454545454545
"12377","35253","2021",41,36,5,181891.707317073,1893.9756097561,99.5121951219512
"12378","35255","2021",24,23,1,200668.25,2081.66666666667,97.3333333333333
"12379","35256","2021",81,60,21,514077.074074074,5141.27160493827,98.8395061728395
"12380","35257","2021",64,58,6,140364.140625,1460.015625,95.59375
"12381","35258","2021",6,6,0,198237.5,2117.66666666667,95.1666666666667
"12382","35259","2021",18,18,0,162738.055555556,1992,89.8888888888889
"12383","35260","2021",13,13,0,115556.307692308,1231.61538461538,96.3846153846154
"12384","35261","2021",2,2,0,174750,1433,141.5
"12385","35262","2021",7,6,1,128157.142857143,1117,119.285714285714
"12386","35263","2021",50,48,2,371237.02,3396.86,110.16
"12387","35264","2021",26,26,0,218445.230769231,2251.73076923077,105.653846153846
"12388","35265","2021",38,32,6,191416.605263158,1990.31578947368,99.6842105263158
"12389","35266","2021",75,48,27,245174.973333333,2594.98666666667,97.56
"12390","35268","2021",9,9,0,86698.8888888889,1138.66666666667,75.8888888888889
"12391","35270","2021",5,5,0,126000,1742.4,80
"12392","35271","2021",34,34,0,114317.647058824,1220.85294117647,95.6176470588235
"12393","35272","2021",10,9,1,154725,1621.2,98.3
"12394","35273","2021",29,29,0,132928.827586207,1459.68965517241,91.6896551724138
"12395","35274","2021",5,5,0,220000,1741.6,127.6
"12396","35275","2021",96,56,40,227435.197916667,2408.70833333333,93.3541666666667
"12397","35276","2021",9,9,0,282703.333333333,2187,134.222222222222
"12398","35277","2021",4,4,0,146500,1668.25,84.25
"12399","35278","2021",121,81,40,399311.537190083,3584.92561983471,112.272727272727
"12400","35279","2021",15,15,0,215135,2258.4,97.2
"12401","35280","2021",15,15,0,130275.133333333,1547.66666666667,95.2666666666667
"12402","35281","2021",290,92,198,225772.75862069,3116.78275862069,72.6344827586207
"12403","35282","2021",29,29,0,157815.206896552,1746.72413793103,93.8275862068966
"12404","35283","2021",10,9,1,229119.2,2362.5,108.7
"12405","35284","2021",27,22,5,347574.703703704,3425.14814814815,101.148148148148
"12406","35285","2021",26,26,0,125769.307692308,1413.80769230769,87.5769230769231
"12407","35286","2021",1,1,0,80000,1250,64
"12408","35287","2021",42,35,7,490359.119047619,4629.90476190476,104.595238095238
"12409","35288","2021",1076,389,687,317571.827137546,4356.02323420074,74.2778810408922
"12410","35289","2021",21,20,1,152433.333333333,1613.09523809524,94.9523809523809
"12411","35290","2021",14,14,0,145864.285714286,1263.21428571429,123.928571428571
"12412","35291","2021",14,14,0,150700,1368.64285714286,113.571428571429
"12413","35292","2021",25,25,0,121166.64,1296.72,92.36
"12414","35294","2021",41,41,0,143021.609756098,1548.60975609756,96.4390243902439
"12415","35295","2021",10,10,0,174800,1768.4,98.7
"12416","35296","2021",24,23,1,239021.791666667,2176.625,111.916666666667
"12417","35297","2021",103,73,30,132636.116504854,1432.43689320388,93.5533980582524
"12418","35299","2021",72,63,9,261373.277777778,2874.13888888889,94.7083333333333
"12419","35300","2021",26,26,0,161332.307692308,1669.92307692308,99.9230769230769
"12420","35302","2021",15,15,0,148593.133333333,1412.66666666667,102.333333333333
"12421","35304","2021",12,12,0,160117.916666667,1720.33333333333,94.1666666666667
"12422","35305","2021",7,7,0,161342.857142857,1595.57142857143,111.428571428571
"12423","35306","2021",28,28,0,264548.214285714,2624.17857142857,106.678571428571
"12424","35307","2021",14,14,0,160118.714285714,1578.28571428571,101.714285714286
"12425","35308","2021",79,77,2,170134.303797468,1810.86075949367,94.9113924050633
"12426","35309","2021",16,16,0,182695,1619.0625,115.9375
"12427","35310","2021",16,16,0,194653.125,1550.125,128.0625
"12428","35311","2021",10,10,0,112663.5,1514.7,69.5
"12429","35312","2021",30,30,0,197356.866666667,1966.43333333333,102
"12430","35314","2021",21,21,0,351036,3932.2380952381,92.1428571428571
"12431","35315","2021",19,18,1,262799.315789474,2555.94736842105,105.052631578947
"12432","35316","2021",17,17,0,130128.235294118,1141.82352941176,112.705882352941
"12433","35317","2021",7,7,0,175285.714285714,2238,81.5714285714286
"12434","35318","2021",20,20,0,234396.4,2222.6,108.65
"12435","35319","2021",37,30,7,186104.864864865,2111.43243243243,88.5405405405405
"12436","35320","2021",5,5,0,210839.8,2101.6,101.2
"12437","35321","2021",10,10,0,180200,1651.5,104.8
"12438","35322","2021",25,25,0,180448.56,1759.48,103.84
"12439","35324","2021",4,4,0,228075,1484,148.75
"12440","35326","2021",32,30,2,172980.15625,1794.21875,99.34375
"12441","35327","2021",70,59,11,281029.857142857,2534.75714285714,112.985714285714
"12442","35328","2021",22,22,0,123409.727272727,1336.95454545455,93.8636363636364
"12443","35329","2021",12,12,0,152383.333333333,1542.16666666667,101.666666666667
"12444","35330","2021",16,15,1,160635.125,1670.875,97.25
"12445","35331","2021",33,31,2,208348.818181818,2133.84848484848,99.1515151515152
"12446","35332","2021",24,24,0,103661.25,1255.54166666667,83.375
"12447","35333","2021",25,25,0,190887,1660.6,113.52
"12448","35334","2021",104,72,32,303617.423076923,2988.06730769231,102.519230769231
"12449","35335","2021",19,19,0,157034.473684211,1421.10526315789,110.315789473684
"12450","35336","2021",2,2,0,96500,836,97.5
"12451","35337","2021",59,50,9,191069.677966102,2048.15254237288,98.9830508474576
"12452","35338","2021",7,6,1,361817.142857143,2776.57142857143,106.428571428571
"12453","35339","2021",8,8,0,79875,928.5,88.75
"12454","35340","2021",19,19,0,204289.473684211,1973.84210526316,108.421052631579
"12455","35342","2021",7,7,0,180714.285714286,2171.14285714286,90.1428571428571
"12456","35343","2021",22,22,0,154737.045454545,1509.18181818182,99.9545454545455
"12457","35345","2021",22,22,0,186002.545454545,1899.95454545455,96.5454545454545
"12458","35346","2021",1,1,0,150700,1693,89
"12459","35347","2021",38,38,0,151290.473684211,1493.28947368421,102.263157894737
"12460","35350","2021",4,4,0,187125,1174.25,170
"12461","35351","2021",13,13,0,173882.923076923,1791,98.3846153846154
"12462","35352","2021",125,86,39,304350.096,2858.072,106.072
"12463","35353","2021",112,47,65,232798.142857143,2692.30357142857,87.3035714285714
"12464","35354","2021",11,11,0,128981.545454545,1180.09090909091,105.454545454545
"12465","35355","2021",24,24,0,146330.041666667,1870.375,102.625
"12466","35356","2021",25,24,1,248984.6,2098.24,120.2
"12467","35357","2021",5,5,0,124412,1336.8,90.6
"12468","35358","2021",13,13,0,216568.076923077,2640.84615384615,89.8461538461538
"12469","35359","2021",12,12,0,139975.083333333,1690.08333333333,92.9166666666667
"12470","35360","2021",265,162,103,209360.490566038,2453.61886792453,90.5132075471698
"12471","35361","2021",23,23,0,207766.739130435,2155.73913043478,102.173913043478
"12472","35362","2021",25,22,3,156667.4,1860.84,82.96
"12473","35363","2021",57,35,22,254921.473684211,2874.66666666667,89.7017543859649
"12474","36001","2021",19,19,0,84328.9473684211,799.210526315789,103.526315789474
"12475","36002","2021",3,3,0,47833.3333333333,851,56
"12476","36003","2021",15,15,0,109906.333333333,992.666666666667,108.333333333333
"12477","36004","2021",5,5,0,115600,1066,115.6
"12478","36005","2021",56,54,2,124100.446428571,1448.26785714286,85.4107142857143
"12479","36006","2021",57,51,6,81624.8771929825,1104.68421052632,76.859649122807
"12480","36007","2021",6,6,0,63632.6666666667,824.333333333333,76
"12481","36008","2021",13,13,0,76214.0769230769,842,89.5384615384615
"12482","36009","2021",15,15,0,140246.6,1482.93333333333,100.733333333333
"12483","36010","2021",15,15,0,122633.333333333,1181.46666666667,116.333333333333
"12484","36011","2021",3,3,0,87366.6666666667,1176,77.3333333333333
"12485","36012","2021",6,6,0,50666.6666666667,907.833333333333,55.5
"12486","36013","2021",10,10,0,71520,720.6,106.9
"12487","36014","2021",5,5,0,83869.6,1008.8,96.6
"12488","36015","2021",4,4,0,139750,776.5,157
"12489","36016","2021",21,21,0,83066.9047619048,809.380952380952,94.2380952380952
"12490","36017","2021",10,10,0,84891.7,950.2,91.4
"12491","36018","2021",93,87,6,90051.5591397849,966.129032258065,92.9354838709677
"12492","36019","2021",8,8,0,155306.25,1061.5,121.375
"12493","36020","2021",2,2,0,117000,987,113
"12494","36021","2021",13,13,0,121007.615384615,1550.38461538462,82.8461538461538
"12495","36022","2021",5,5,0,128500,1337.4,94.8
"12496","36023","2021",10,10,0,63100,681.9,95.1
"12497","36024","2021",2,2,0,112500,835,138.5
"12498","36025","2021",5,5,0,55400,715.2,85.4
"12499","36026","2021",7,7,0,131400,1109.28571428571,116
"12500","36027","2021",5,5,0,83380,1256.4,71.2
"12501","36028","2021",3,3,0,38666.6666666667,499,81.3333333333333
"12502","36029","2021",5,5,0,74800,1054,72.8
"12503","36030","2021",2,2,0,107500,880,121
"12504","36031","2021",56,56,0,89680.0178571429,1014.875,89.3214285714286
"12505","36032","2021",6,6,0,147691,1796.33333333333,94.3333333333333
"12506","36033","2021",10,10,0,82000,799.2,99
"12507","36034","2021",54,54,0,107435.314814815,1102.83333333333,98.8703703703704
"12508","36035","2021",25,25,0,87141.96,967.88,98.24
"12509","36036","2021",3,3,0,125000,1182.33333333333,83.3333333333333
"12510","36037","2021",6,6,0,106166.666666667,1130.83333333333,101.333333333333
"12511","36038","2021",2,2,0,59250,971.5,57.5
"12512","36040","2021",1,1,0,133000,1494,89
"12513","36041","2021",1,1,0,69000,1095,63
"12514","36042","2021",5,5,0,89300,799.6,106.6
"12515","36043","2021",6,6,0,88908.3333333333,1176.66666666667,76.1666666666667
"12516","36044","2021",657,418,239,107399.199391172,1287.67275494673,83.6834094368341
"12517","36045","2021",44,44,0,79771.3409090909,959.159090909091,85.6590909090909
"12518","36046","2021",72,62,10,85868.9305555556,976.486111111111,88.5833333333333
"12519","36047","2021",5,5,0,52400,676.4,79.6
"12520","36048","2021",6,6,0,87846,1017.83333333333,80.5
"12521","36049","2021",3,3,0,79833.3333333333,559,135
"12522","36050","2021",2,2,0,95000,1128.5,84
"12523","36051","2021",3,3,0,38000,554,65.3333333333333
"12524","36052","2021",1,1,0,145000,1959,74
"12525","36053","2021",11,11,0,82901.8181818182,936.545454545455,88.6363636363636
"12526","36054","2021",4,4,0,110487.5,889,141.5
"12527","36055","2021",24,24,0,78148.3333333333,978.958333333333,82.3333333333333
"12528","36056","2021",10,10,0,85755,910.7,100.8
"12529","36057","2021",7,7,0,126857.142857143,1303.85714285714,98.5714285714286
"12530","36058","2021",10,10,0,97862,940.3,104.3
"12531","36059","2021",6,6,0,87550,938.333333333333,87.5
"12532","36060","2021",22,22,0,70266.2272727273,835.318181818182,82.5
"12533","36061","2021",6,6,0,109216.666666667,1476.5,74.1666666666667
"12534","36062","2021",14,14,0,93600,1083.57142857143,92.5
"12535","36063","2021",104,96,8,124701.701923077,1454.65384615385,86.1442307692308
"12536","36064","2021",4,4,0,153250,1314.5,125.25
"12537","36065","2021",6,6,0,77750,839.833333333333,97.3333333333333
"12538","36066","2021",10,10,0,94650,1630.9,69
"12539","36067","2021",4,4,0,66968,776.75,87.5
"12540","36068","2021",12,12,0,84848.4166666667,1016.91666666667,84
"12541","36069","2021",18,18,0,76571.7222222222,795.222222222222,89.3333333333333
"12542","36070","2021",38,38,0,114892.631578947,1112.36842105263,107.631578947368
"12543","36071","2021",12,12,0,127993.75,1322.5,99.8333333333333
"12544","36073","2021",4,4,0,60375,1016,59.25
"12545","36074","2021",12,12,0,112129.166666667,1130.58333333333,108
"12546","36075","2021",3,3,0,60833.3333333333,576.666666666667,102
"12547","36076","2021",3,3,0,60000,858.333333333333,85
"12548","36077","2021",3,3,0,90000,957.666666666667,98.3333333333333
"12549","36078","2021",3,3,0,127500,1310.66666666667,102
"12550","36079","2021",1,1,0,140000,1400,100
"12551","36080","2021",5,5,0,126200,1687.2,82.8
"12552","36081","2021",12,12,0,76250,853.916666666667,91.5
"12553","36082","2021",3,3,0,110333.333333333,1151.33333333333,94.6666666666667
"12554","36083","2021",5,5,0,103400,820.6,128
"12555","36084","2021",6,6,0,144433.333333333,1104.5,131
"12556","36085","2021",2,2,0,60750,990,62.5
"12557","36086","2021",6,6,0,111966.666666667,1228.83333333333,94.6666666666667
"12558","36087","2021",7,7,0,84357.1428571429,794.857142857143,109
"12559","36088","2021",178,172,6,96159.9157303371,1032.93820224719,92.5168539325843
"12560","36089","2021",7,7,0,120102,1539.57142857143,78.1428571428571
"12561","36090","2021",1,1,0,100500,859,117
"12562","36091","2021",12,12,0,145066.666666667,1392.16666666667,103.5
"12563","36092","2021",3,3,0,49666.6666666667,588.333333333333,85
"12564","36093","2021",39,38,1,78571.282051282,955.589743589744,80.9230769230769
"12565","36094","2021",7,7,0,81698.5714285714,781.285714285714,109
"12566","36095","2021",3,3,0,75072.3333333333,901.333333333333,77
"12567","36097","2021",3,3,0,85333.3333333333,1208.33333333333,71.3333333333333
"12568","36099","2021",11,11,0,53941.8181818182,704.090909090909,80.9090909090909
"12569","36100","2021",6,6,0,100583.333333333,941.333333333333,102.166666666667
"12570","36101","2021",20,19,1,141685.65,1488.55,101.6
"12571","36102","2021",2,2,0,53250,650,82.5
"12572","36103","2021",25,25,0,75461.12,1048.92,74.4
"12573","36104","2021",8,8,0,117332.5,1305.375,90
"12574","36105","2021",2,2,0,131519,1080.5,104
"12575","36106","2021",2,2,0,255000,1458,139
"12576","36107","2021",11,11,0,119090.909090909,1251.09090909091,89.9090909090909
"12577","36108","2021",2,2,0,131000,1402,91
"12578","36109","2021",10,10,0,109330,1092.9,97
"12579","36110","2021",8,8,0,53731.25,864.25,63.875
"12580","36111","2021",3,3,0,78000,735,107
"12581","36112","2021",6,6,0,156416.666666667,1350.66666666667,133.833333333333
"12582","36113","2021",14,14,0,68972.8571428571,849.357142857143,84.4285714285714
"12583","36114","2021",3,3,0,103666.666666667,1455.66666666667,80
"12584","36115","2021",1,1,0,60000,732,82
"12585","36116","2021",2,2,0,57000,678,79.5
"12586","36117","2021",6,6,0,50933.3333333333,700.833333333333,79.6666666666667
"12587","36118","2021",6,6,0,93666.6666666667,697.666666666667,117
"12588","36119","2021",5,5,0,111178,1165.8,93
"12589","36120","2021",12,12,0,108150,946.166666666667,105.833333333333
"12590","36121","2021",4,4,0,70370,659.25,99.5
"12591","36122","2021",4,4,0,109750,2901.5,60.5
"12592","36123","2021",21,21,0,96349.0476190476,942.809523809524,106.095238095238
"12593","36124","2021",4,4,0,127438.5,1141.25,92.75
"12594","36125","2021",1,1,0,105000,745,141
"12595","36126","2021",9,9,0,77440.7777777778,742.444444444444,108.888888888889
"12596","36127","2021",23,23,0,116441.173913043,1041.21739130435,112.608695652174
"12597","36128","2021",19,19,0,109215.105263158,1140.05263157895,94.4736842105263
"12598","36129","2021",13,13,0,81307.6923076923,942.846153846154,82
"12599","36130","2021",1,1,0,35000,614,57
"12600","36131","2021",9,9,0,94455.5555555556,1114.55555555556,75.4444444444444
"12601","36132","2021",1,1,0,160000,1702,94
"12602","36133","2021",2,2,0,38750,703,51
"12603","36134","2021",8,8,0,112272.5,968,111.375
"12604","36135","2021",3,3,0,31666.6666666667,494.666666666667,66.6666666666667
"12605","36136","2021",4,4,0,208750,1693.75,129.75
"12606","36137","2021",5,5,0,108800,975.4,103.2
"12607","36138","2021",3,3,0,105328.333333333,1121,93.6666666666667
"12608","36139","2021",14,14,0,85014.2857142857,1125.85714285714,83.0714285714286
"12609","36140","2021",18,18,0,93086.6111111111,1027.11111111111,88.4444444444444
"12610","36141","2021",19,19,0,85215.7894736842,1036.63157894737,82.2105263157895
"12611","36142","2021",23,23,0,133988.695652174,1316.04347826087,99.0434782608696
"12612","36143","2021",12,12,0,98833.3333333333,1130.58333333333,83.5
"12613","36144","2021",6,6,0,132197.5,1363.33333333333,97
"12614","36145","2021",4,4,0,94855,941,113.75
"12615","36146","2021",17,17,0,77967.5882352941,747.352941176471,106.352941176471
"12616","36147","2021",4,4,0,80000,820.5,104.5
"12617","36148","2021",9,9,0,65513.3333333333,741.111111111111,90.5555555555556
"12618","36149","2021",18,18,0,80105.5555555556,862.166666666667,94.5
"12619","36150","2021",14,14,0,80305.2857142857,870.928571428571,95.5714285714286
"12620","36152","2021",7,7,0,81275.7142857143,773,110.142857142857
"12621","36153","2021",5,5,0,97593.8,1025.2,105
"12622","36154","2021",22,22,0,117456.454545455,1231,100.636363636364
"12623","36155","2021",18,18,0,129764.833333333,1209.55555555556,92.9444444444444
"12624","36156","2021",4,4,0,87645,1233.25,73.75
"12625","36157","2021",2,2,0,59500,825.5,72
"12626","36158","2021",12,11,1,69358.3333333333,779.833333333333,88.4166666666667
"12627","36159","2021",72,70,2,178299.583333333,1793.79166666667,103.708333333333
"12628","36160","2021",8,8,0,102687.5,1161.125,96
"12629","36161","2021",11,10,1,106863.636363636,936,115
"12630","36162","2021",16,16,0,62694.75,757.875,88.1875
"12631","36163","2021",16,16,0,93155,949.6875,101.75
"12632","36164","2021",4,4,0,104105,798,121.75
"12633","36165","2021",14,14,0,100035.714285714,1086.21428571429,97.7142857142857
"12634","36166","2021",2,2,0,112000,1136,99.5
"12635","36167","2021",1,1,0,25000,397,63
"12636","36168","2021",14,14,0,147871.571428571,1414.78571428571,96
"12637","36169","2021",17,17,0,97122.2352941177,1003.70588235294,93.8823529411765
"12638","36170","2021",2,2,0,138000,1244.5,113
"12639","36171","2021",40,40,0,82944.975,873.925,96.825
"12640","36172","2021",8,8,0,103600,1032.625,107
"12641","36173","2021",11,11,0,94244.5454545455,1097.09090909091,75.3636363636364
"12642","36174","2021",3,3,0,149492.333333333,1042.66666666667,133.666666666667
"12643","36175","2021",7,7,0,103057.571428571,1000.28571428571,115.428571428571
"12644","36176","2021",5,5,0,67000,901.8,74.2
"12645","36177","2021",5,5,0,97448,847.2,117.8
"12646","36179","2021",1,1,0,120000,1644,73
"12647","36180","2021",18,18,0,116016.666666667,1173.16666666667,101.333333333333
"12648","36181","2021",2,2,0,145000,1405.5,114
"12649","36182","2021",7,7,0,77221.4285714286,901.142857142857,89.4285714285714
"12650","36184","2021",11,11,0,81545.4545454545,889.818181818182,91.5454545454545
"12651","36185","2021",11,11,0,84032.5454545455,846.090909090909,105.636363636364
"12652","36186","2021",8,8,0,78217.625,897.125,84.875
"12653","36187","2021",3,3,0,43666.6666666667,413.333333333333,108.666666666667
"12654","36188","2021",2,2,0,102500,1262.5,81
"12655","36189","2021",17,16,1,81641.7647058823,986.117647058824,86
"12656","36190","2021",4,4,0,53875,604,90.25
"12657","36191","2021",9,9,0,88222.2222222222,1197.22222222222,87.1111111111111
"12658","36192","2021",31,31,0,85560.3225806452,987.677419354839,85.3225806451613
"12659","36193","2021",6,6,0,69782.5,796.833333333333,85
"12660","36194","2021",16,16,0,61031.25,665.125,96.25
"12661","36195","2021",10,10,0,75600,1097.4,73.6
"12662","36196","2021",2,2,0,53500,820.5,69.5
"12663","36197","2021",5,5,0,100600,1155.6,94
"12664","36198","2021",1,1,0,150000,1364,110
"12665","36199","2021",6,6,0,79500,938,82.5
"12666","36200","2021",22,21,1,93431.8181818182,1192.13636363636,79.5909090909091
"12667","36202","2021",40,40,0,162051.5,1619.1,99.125
"12668","36203","2021",2,2,0,132250,1579,97
"12669","36204","2021",4,4,0,112250,1055,100.5
"12670","36205","2021",2,2,0,61250,534.5,109
"12671","36207","2021",18,18,0,54592.5555555556,842.333333333333,69.4444444444444
"12672","36208","2021",14,14,0,78321.4285714286,798.142857142857,99.2142857142857
"12673","36209","2021",6,6,0,102266.666666667,913.666666666667,108
"12674","36210","2021",9,9,0,56888.8888888889,715.666666666667,80.2222222222222
"12675","36211","2021",4,4,0,117100,1022.25,110
"12676","36212","2021",6,6,0,77483.3333333333,858.166666666667,83.1666666666667
"12677","36213","2021",1,1,0,40000,597,67
"12678","36214","2021",7,7,0,71257.1428571429,1034.28571428571,82.5714285714286
"12679","36215","2021",9,9,0,105700,1014.55555555556,105.888888888889
"12680","36216","2021",3,3,0,48833.3333333333,613,81.3333333333333
"12681","36217","2021",1,1,0,110000,1250,88
"12682","36218","2021",5,5,0,92229.6,941.6,106
"12683","36219","2021",10,10,0,128990,1327.6,106.7
"12684","36220","2021",10,10,0,262702.6,2120.2,98.2
"12685","36221","2021",10,10,0,93925.5,1031.5,91.1
"12686","36222","2021",5,5,0,123200,1090,113.2
"12687","36223","2021",4,4,0,34087.75,492.25,69.5
"12688","36224","2021",18,18,0,82594.4444444444,894.777777777778,90.7777777777778
"12689","36225","2021",5,5,0,79000,1003.4,76.4
"12690","36226","2021",9,9,0,89833.3333333333,884.222222222222,103.555555555556
"12691","36227","2021",8,8,0,74079.5,821,98.375
"12692","36228","2021",46,46,0,91127.6086956522,1023.04347826087,90.4782608695652
"12693","36229","2021",20,20,0,88320,1106.05,82.4
"12694","36230","2021",19,19,0,114937.368421053,1070.84210526316,116.526315789474
"12695","36231","2021",5,5,0,126600,1277.8,99.8
"12696","36232","2021",11,11,0,107318.181818182,1038.18181818182,103.545454545455
"12697","36233","2021",13,13,0,85270,954.307692307692,97.0769230769231
"12698","36234","2021",5,5,0,82800,789.8,104.6
"12699","36235","2021",4,4,0,79820,1105.75,71
"12700","36236","2021",6,6,0,76233.3333333333,831,99.6666666666667
"12701","36237","2021",16,16,0,86387.5,981.0625,81.1875
"12702","36238","2021",4,4,0,83875,780.5,101.5
"12703","36239","2021",7,7,0,175285.714285714,1634.42857142857,110.285714285714
"12704","36240","2021",10,10,0,73000,853.7,84.3
"12705","36241","2021",32,31,1,99195.3125,1282.5625,77.84375
"12706","36242","2021",1,1,0,118000,1311,90
"12707","36243","2021",3,3,0,109666.666666667,1148.66666666667,87.3333333333333
"12708","36244","2021",21,20,1,86238.0952380952,868.380952380952,103.190476190476
"12709","36247","2021",15,15,0,115834.266666667,1245.66666666667,95.5333333333333
"12710","36248","2021",4,4,0,97500,1177.75,76
"12711","37001","2021",18,18,0,118847.222222222,1159.05555555556,100.111111111111
"12712","37002","2021",26,26,0,182299.423076923,1876.30769230769,99.7307692307692
"12713","37003","2021",215,138,77,204007.874418605,2354.92093023256,87.6744186046512
"12714","37004","2021",11,11,0,123821.636363636,1150.72727272727,109.454545454545
"12715","37005","2021",8,8,0,91302.125,916.75,103.625
"12716","37006","2021",25,25,0,276222.32,2231.92,124.68
"12717","37007","2021",1,1,0,260000,1512,172
"12718","37008","2021",29,29,0,237661.827586207,2292.06896551724,108.655172413793
"12719","37009","2021",3,3,0,170392,1699.66666666667,102
"12720","37010","2021",29,29,0,165971.827586207,1638,104.48275862069
"12721","37011","2021",18,13,5,136127.777777778,1789.5,86.8333333333333
"12722","37012","2021",10,10,0,127510,1108,128.7
"12723","37013","2021",12,12,0,120366.666666667,1386.75,89.8333333333333
"12724","37014","2021",40,38,2,225304.725,2160.45,97.15
"12725","37015","2021",34,34,0,239070.147058824,2164.08823529412,114.764705882353
"12726","37016","2021",3,3,0,232800,1489.66666666667,147.333333333333
"12727","37018","2021",118,90,28,261170.262711864,2699.85593220339,97.7881355932203
"12728","37019","2021",5,5,0,185408.6,1240.4,137.2
"12729","37020","2021",32,32,0,146002.9375,1645.6875,90.78125
"12730","37021","2021",26,26,0,160296.192307692,1817.53846153846,88.8076923076923
"12731","37022","2021",28,28,0,160692.857142857,1500.10714285714,108.607142857143
"12732","37023","2021",6,6,0,153416.666666667,1293.16666666667,115.5
"12733","37024","2021",15,15,0,158076.666666667,1528.93333333333,100.133333333333
"12734","37025","2021",3,3,0,175333.333333333,2220,68
"12735","37026","2021",12,12,0,104070,1031,96.25
"12736","37027","2021",78,75,3,206239.948717949,2205.20512820513,96.4871794871795
"12737","37028","2021",17,17,0,111611.764705882,1260.05882352941,88.2352941176471
"12738","37029","2021",8,8,0,140755.625,1589.25,92.25
"12739","37030","2021",14,14,0,131897.857142857,1507.57142857143,92.2857142857143
"12740","37031","2021",64,61,3,165285.171875,1587.71875,104.03125
"12741","37032","2021",3,3,0,133083.333333333,1201,110
"12742","37033","2021",4,4,0,81550,1072,74.75
"12743","37034","2021",4,4,0,178725,1325.25,123.25
"12744","37035","2021",2,2,0,66750,1018.5,68.5
"12745","37036","2021",3,3,0,274969,5217.33333333333,188.666666666667
"12746","37037","2021",4,4,0,102500,1168.5,98.75
"12747","37038","2021",11,11,0,174372.727272727,1666.90909090909,105.090909090909
"12748","37039","2021",5,5,0,120000,1177.6,99.2
"12749","37040","2021",3,3,0,30000,694.666666666667,42.3333333333333
"12750","37041","2021",5,5,0,163000,1618.8,98.4
"12751","37042","2021",4,4,0,257557.5,2481,103.25
"12752","37043","2021",15,15,0,213566.666666667,1953.6,106.4
"12753","37044","2021",7,7,0,84500,822.571428571429,100.714285714286
"12754","37045","2021",16,16,0,134627.5,1375.625,99.6875
"12755","37046","2021",10,10,0,141875,1443.1,95.9
"12756","37047","2021",15,15,0,250600.866666667,2350.33333333333,111.666666666667
"12757","37048","2021",5,5,0,80880,974.8,84.6
"12758","37049","2021",18,18,0,184931.222222222,1670.05555555556,110.277777777778
"12759","37050","2021",181,91,90,197237.900552486,2580.37569060773,78.4419889502762
"12760","37051","2021",21,21,0,156959.142857143,1385.66666666667,109.619047619048
"12761","37052","2021",11,11,0,180063.636363636,1725.36363636364,102
"12762","37053","2021",2,2,0,104040,1033,100.5
"12763","37054","2021",24,24,0,234645.583333333,2429.25,98.0833333333333
"12764","37055","2021",21,21,0,140565.238095238,1333.33333333333,106.095238095238
"12765","37056","2021",9,9,0,181685.555555556,1705.77777777778,112.777777777778
"12766","37057","2021",8,8,0,124762.5,1820.625,83.625
"12767","37058","2021",15,15,0,160684,1512.8,109.933333333333
"12768","37059","2021",14,14,0,262496.642857143,2642.57142857143,110.214285714286
"12769","37060","2021",18,18,0,231413.888888889,2088.66666666667,111.277777777778
"12770","37061","2021",8,8,0,71950,846.5,79.25
"12771","37062","2021",33,31,2,123696.96969697,1503.21212121212,93.2121212121212
"12772","37063","2021",69,63,6,114560.144927536,1303.28985507246,90.0579710144928
"12773","37064","2021",2,2,0,43000,775.5,57.5
"12774","37065","2021",4,4,0,153250,1654.75,81.75
"12775","37066","2021",11,11,0,194155.454545455,1648.81818181818,122.363636363636
"12776","37067","2021",15,15,0,187859.333333333,1933.53333333333,100.066666666667
"12777","37068","2021",11,11,0,166545.454545455,1349.45454545455,126.727272727273
"12778","37069","2021",5,5,0,143500,1427.4,113.4
"12779","37070","2021",7,7,0,207728.571428571,2325.14285714286,88.1428571428571
"12780","37071","2021",3,3,0,209666.666666667,1705.33333333333,118.666666666667
"12781","37072","2021",150,117,33,146474.12,1628.10666666667,88.92
"12782","37073","2021",9,9,0,195405.555555556,1911.44444444444,96
"12783","37074","2021",24,24,0,131413.583333333,1263.33333333333,102.208333333333
"12784","37075","2021",9,9,0,172050.666666667,1491,113
"12785","37076","2021",6,6,0,164555,1447.66666666667,107.5
"12786","37077","2021",61,61,0,196759.836065574,2060.14754098361,96.1311475409836
"12787","37078","2021",3,3,0,110000,1391,77.6666666666667
"12788","37079","2021",31,31,0,227766.774193548,2165.38709677419,114.322580645161
"12789","37080","2021",3,3,0,119333.333333333,921.666666666667,123.333333333333
"12790","37081","2021",29,29,0,168393.068965517,1609.37931034483,107.896551724138
"12791","37082","2021",11,11,0,145420.454545455,1383.45454545455,101.909090909091
"12792","37083","2021",33,29,4,191939.787878788,1870.36363636364,102.787878787879
"12793","37084","2021",6,6,0,128433.333333333,1305,103.166666666667
"12794","37085","2021",7,7,0,263742.857142857,2095.14285714286,137.714285714286
"12795","37086","2021",7,7,0,130215.428571429,1789.57142857143,70.4285714285714
"12796","37087","2021",2,2,0,204300,1286.5,176.5
"12797","37088","2021",1,1,0,250000,1724,145
"12798","37089","2021",6,6,0,148750,1409.33333333333,109.166666666667
"12799","37090","2021",5,5,0,135440,1816.8,83.2
"12800","37091","2021",40,40,0,199657.5,1971.775,103.425
"12801","37092","2021",5,5,0,220900,2307.4,96.6
"12802","37093","2021",7,7,0,119214.285714286,1377.71428571429,92.7142857142857
"12803","37094","2021",11,11,0,145036.363636364,1448.18181818182,102
"12804","37095","2021",7,7,0,191607.142857143,1477.85714285714,140
"12805","37096","2021",17,17,0,227864.705882353,2422.47058823529,106
"12806","37097","2021",7,7,0,150952.857142857,1307.85714285714,122.285714285714
"12807","37098","2021",6,6,0,180470.833333333,1728,104.666666666667
"12808","37099","2021",6,6,0,265301.666666667,2484.66666666667,109
"12809","37100","2021",7,7,0,146121.428571429,1401.57142857143,106
"12810","37101","2021",7,7,0,175785.714285714,1922.14285714286,101.714285714286
"12811","37103","2021",7,7,0,145146.714285714,1479,98.4285714285714
"12812","37104","2021",76,73,3,262582.789473684,2436.85526315789,111.065789473684
"12813","37105","2021",3,3,0,148166.666666667,907.333333333333,163.333333333333
"12814","37106","2021",5,5,0,173950,1488.2,113.4
"12815","37107","2021",3,3,0,226500,1440,134.666666666667
"12816","37108","2021",8,8,0,204250,1936.625,105.25
"12817","37109","2021",108,100,8,334438.953703704,2952.19444444444,113.824074074074
"12818","37110","2021",28,28,0,213390.464285714,2039.96428571429,108.607142857143
"12819","37111","2021",25,25,0,121105.96,1410.32,85.28
"12820","37112","2021",9,9,0,89838.8888888889,1068.55555555556,83.2222222222222
"12821","37113","2021",20,20,0,79733.5,875.8,91.15
"12822","37114","2021",10,10,0,71000,1126.7,64.9
"12823","37115","2021",48,41,7,97255.2083333333,1048.39583333333,87.4166666666667
"12824","37116","2021",13,13,0,154934.615384615,1624.46153846154,102.538461538462
"12825","37117","2021",14,14,0,119642.857142857,1207.64285714286,101.571428571429
"12826","37118","2021",24,24,0,129234.958333333,1534.58333333333,90.2916666666667
"12827","37119","2021",19,18,1,91947.3684210526,1160.21052631579,83.3157894736842
"12828","37121","2021",6,6,0,107816.666666667,1257,85.6666666666667
"12829","37122","2021",578,262,316,170519.830449827,2253.73010380623,74.3114186851211
"12830","37123","2021",50,50,0,153291.98,1617.68,94.12
"12831","37124","2021",38,38,0,275527.921052632,2555.15789473684,111.105263157895
"12832","37125","2021",5,5,0,134000,1474,86
"12833","37126","2021",3,3,0,77666.6666666667,922.333333333333,81.3333333333333
"12834","37127","2021",6,6,0,147166.666666667,1382.83333333333,108.666666666667
"12835","37128","2021",16,16,0,164520.875,1565.0625,101.125
"12836","37129","2021",12,12,0,133625,1313.83333333333,99.3333333333333
"12837","37130","2021",32,31,1,117428,1245.8125,96.875
"12838","37131","2021",25,24,1,173794.8,1888.4,93.68
"12839","37132","2021",96,83,13,166137.291666667,1870.82291666667,95.1770833333333
"12840","37133","2021",7,7,0,146200,1263,114
"12841","37134","2021",11,11,0,150663.636363636,1646.18181818182,93.6363636363636
"12842","37136","2021",11,11,0,158454.545454545,1435.72727272727,106.818181818182
"12843","37137","2021",5,5,0,148641.6,1549.2,89.6
"12844","37138","2021",13,12,1,287987.692307692,2738.53846153846,102.846153846154
"12845","37139","2021",53,50,3,250330.056603774,2234.41509433962,113.962264150943
"12846","37140","2021",4,4,0,174625,2132,89
"12847","37141","2021",20,20,0,122825,1327.7,101.25
"12848","37142","2021",3,3,0,162233.333333333,1994.66666666667,86.3333333333333
"12849","37143","2021",32,32,0,174638.125,1696.71875,102.8125
"12850","37144","2021",2,2,0,177000,2293.5,77.5
"12851","37145","2021",3,3,0,70898.6666666667,1168.33333333333,55.3333333333333
"12852","37146","2021",5,5,0,84800,691.8,118
"12853","37147","2021",8,8,0,132457.5,1784.875,79.5
"12854","37148","2021",9,9,0,127800,1685.11111111111,77.1111111111111
"12855","37149","2021",8,8,0,175266,1818,98.5
"12856","37150","2021",17,17,0,190917.647058824,2058.41176470588,92.5294117647059
"12857","37151","2021",27,23,4,269490.740740741,2409.44444444444,114.925925925926
"12858","37152","2021",22,22,0,241122.727272727,2185.68181818182,111.181818181818
"12859","37153","2021",53,53,0,253316.188679245,2316.66037735849,111.905660377358
"12860","37154","2021",60,59,1,273340.316666667,2564.65,110.85
"12861","37155","2021",9,9,0,112825,1465.11111111111,74.5555555555556
"12862","37156","2021",128,114,14,229806.9921875,2416.078125,99.5
"12863","37157","2021",2,2,0,93975.5,1555.5,60.5
"12864","37158","2021",14,14,0,174238.571428571,1890.57142857143,95.2857142857143
"12865","37159","2021",101,89,12,218568.940594059,2324.53465346535,95.0693069306931
"12866","37160","2021",6,6,0,143666.666666667,1644.5,88.6666666666667
"12867","37161","2021",15,15,0,174583.333333333,1756.33333333333,108.4
"12868","37162","2021",6,6,0,188458.333333333,1475.16666666667,124.166666666667
"12869","37163","2021",57,57,0,171614.649122807,2158.87719298246,83.859649122807
"12870","37165","2021",10,10,0,230860,2643.8,84.5
"12871","37166","2021",13,13,0,240523.076923077,1778.07692307692,134.230769230769
"12872","37167","2021",32,32,0,215709.21875,2114.8125,104.71875
"12873","37168","2021",4,4,0,164750,1458.5,105
"12874","37169","2021",11,11,0,190841.818181818,2014.36363636364,99.9090909090909
"12875","37170","2021",11,11,0,108181.818181818,1304.18181818182,86.9090909090909
"12876","37171","2021",10,10,0,138200,1472.9,94.8
"12877","37172","2021",53,46,7,255391.113207547,2607.88679245283,99.5849056603774
"12878","37173","2021",16,16,0,94486.375,1016,96.125
"12879","37174","2021",16,16,0,121711.8125,1441.4375,84.0625
"12880","37175","2021",13,13,0,232346.153846154,2310.23076923077,106.923076923077
"12881","37176","2021",14,14,0,177946.428571429,1831.92857142857,103.571428571429
"12882","37177","2021",5,5,0,133910,1180.8,120.8
"12883","37178","2021",8,8,0,170562.5,1577.875,103.75
"12884","37179","2021",24,21,3,285110.833333333,2577.66666666667,109.375
"12885","37180","2021",6,6,0,113166.666666667,1034.16666666667,108.833333333333
"12886","37181","2021",2,2,0,81500,885.5,87
"12887","37182","2021",28,28,0,225883.892857143,2115.92857142857,102.678571428571
"12888","37183","2021",12,12,0,156021.75,1493.5,99.9166666666667
"12889","37184","2021",5,5,0,135070,1474.6,89.6
"12890","37185","2021",24,23,1,226394.583333333,2117.66666666667,110.875
"12891","37186","2021",12,12,0,229105.833333333,1923.83333333333,126.5
"12892","37187","2021",7,7,0,77285.7142857143,933.428571428571,89
"12893","37188","2021",12,12,0,132033.333333333,1367.83333333333,103.25
"12894","37189","2021",16,16,0,111665,956.5,112.6875
"12895","37190","2021",2,2,0,224000,1194,185
"12896","37191","2021",1,1,0,180000,1837,98
"12897","37192","2021",17,17,0,210365.647058824,1711.70588235294,139.941176470588
"12898","37193","2021",23,23,0,178561.956521739,1555,116.95652173913
"12899","37194","2021",25,25,0,238032,2149.36,118.4
"12900","37195","2021",192,58,134,179772.578125,2642.77604166667,69.0833333333333
"12901","37196","2021",45,31,14,85835.1333333333,940.111111111111,84.7777777777778
"12902","37197","2021",13,13,0,202061.846153846,2010.53846153846,104.615384615385
"12903","37198","2021",3,3,0,195830,1775,109.333333333333
"12904","37199","2021",6,6,0,109500,1501.66666666667,80.3333333333333
"12905","37200","2021",17,17,0,195913.823529412,1938.82352941176,106.294117647059
"12906","37201","2021",7,7,0,215000,1841,114
"12907","37202","2021",6,6,0,163766.666666667,1524.5,117.166666666667
"12908","37203","2021",41,35,6,373492.512195122,3085.9512195122,119.951219512195
"12909","37204","2021",20,20,0,227324.95,2106.55,108.85
"12910","37205","2021",14,14,0,201482.142857143,2092.71428571429,98.8571428571429
"12911","37206","2021",31,28,3,259961.290322581,2496.41935483871,106.064516129032
"12912","37207","2021",4,4,0,144125,1014.5,118.75
"12913","37208","2021",197,163,34,317159.659898477,2938.65989847716,108.53807106599
"12914","37211","2021",36,35,1,211139.361111111,1985.27777777778,103.722222222222
"12915","37212","2021",11,11,0,149545.454545455,1423.72727272727,106.090909090909
"12916","37213","2021",19,19,0,115842.105263158,1235.73684210526,94.8421052631579
"12917","37214","2021",265,124,141,289927.320754717,3078.8679245283,91.9396226415094
"12918","37216","2021",24,24,0,158441.666666667,1458.875,105.416666666667
"12919","37217","2021",29,29,0,223426.517241379,2094.24137931034,104.413793103448
"12920","37218","2021",7,7,0,99142.8571428571,1070.14285714286,80
"12921","37219","2021",10,10,0,218526,2107.5,105.5
"12922","37220","2021",8,8,0,99038.125,1235,85.25
"12923","37221","2021",10,10,0,133142.9,1228.4,107.9
"12924","37222","2021",8,8,0,143812.5,1617.625,96.75
"12925","37223","2021",6,6,0,102000,1233.16666666667,86.1666666666667
"12926","37224","2021",11,11,0,234936.363636364,1965.36363636364,127.727272727273
"12927","37225","2021",38,37,1,229084.210526316,2467.84210526316,99.1842105263158
"12928","37226","2021",50,48,2,157996.5,1639.08,96.22
"12929","37228","2021",10,10,0,184730,1762.6,116
"12930","37229","2021",8,8,0,163187.5,1698,100.25
"12931","37230","2021",17,17,0,232997.823529412,2067.47058823529,117.117647058824
"12932","37231","2021",30,28,2,152080.766666667,1640.83333333333,92.7333333333333
"12933","37232","2021",29,29,0,175497,1435.58620689655,123.275862068966
"12934","37233","2021",187,110,77,171304.64171123,2156.32085561497,80.3582887700535
"12935","37234","2021",5,5,0,136703.6,1309.2,100.4
"12936","37236","2021",6,6,0,350083.333333333,2680.83333333333,141
"12937","37237","2021",13,13,0,244596.538461538,2230.53846153846,117.538461538462
"12938","37238","2021",5,5,0,143502.8,1597.4,87.6
"12939","37240","2021",10,10,0,160285,1465.2,111.4
"12940","37241","2021",16,16,0,172535.625,1653.5,107.75
"12941","37242","2021",16,16,0,170147.25,1554.875,117.1875
"12942","37243","2021",39,37,2,298575.179487179,2553.5641025641,121.461538461538
"12943","37244","2021",2,2,0,125325,1219.5,104.5
"12944","37245","2021",18,18,0,256696.5,2777.27777777778,103.388888888889
"12945","37246","2021",2,2,0,167000,1302.5,99
"12946","37247","2021",7,7,0,150314.714285714,1457.71428571429,102.428571428571
"12947","37248","2021",7,7,0,177214.285714286,1444.42857142857,131.571428571429
"12948","37249","2021",15,15,0,146050.2,1676.13333333333,91.6666666666667
"12949","37250","2021",35,35,0,230048.742857143,2290.08571428571,107
"12950","37251","2021",14,14,0,144365.642857143,1472.85714285714,100.285714285714
"12951","37252","2021",6,5,1,161000,1497,110.833333333333
"12952","37253","2021",3,3,0,171666.666666667,1900.66666666667,89.6666666666667
"12953","37254","2021",15,15,0,192621.666666667,2083.6,93
"12954","37255","2021",6,6,0,134291.833333333,1305.33333333333,111.666666666667
"12955","37256","2021",3,3,0,96666.6666666667,1111.33333333333,101.666666666667
"12956","37257","2021",16,16,0,229564.6875,1972.0625,117.625
"12957","37258","2021",3,3,0,223233.333333333,1595.66666666667,137.333333333333
"12958","37259","2021",7,7,0,109428.571428571,1080.42857142857,104.571428571429
"12959","37260","2021",11,11,0,138938,1303.63636363636,102.727272727273
"12960","37261","2021",2205,520,1685,199922.070294785,2954.2843537415,67.3111111111111
"12961","37262","2021",8,8,0,97112.5,1203.625,78.125
"12962","37263","2021",29,29,0,205068.75862069,2286.58620689655,93.6206896551724
"12963","37264","2021",17,17,0,170493.470588235,1783.29411764706,103.470588235294
"12964","37265","2021",4,4,0,157500,1457,108
"12965","37266","2021",99,95,4,256712.141414141,2463.27272727273,110.090909090909
"12966","37267","2021",45,45,0,282218.2,2519.15555555556,115.6
"12967","37268","2021",5,5,0,120680,994,111
"12968","37269","2021",13,13,0,137269.230769231,1494.61538461538,88.7692307692308
"12969","37270","2021",41,39,2,207744.902439024,2241.34146341463,92.1707317073171
"12970","37271","2021",12,12,0,141770,1624.58333333333,88.8333333333333
"12971","37272","2021",19,19,0,193391.894736842,2134.63157894737,89.9473684210526
"12972","37273","2021",64,59,5,219326.265625,2453.765625,93.203125
"12973","37274","2021",4,4,0,68232.5,1152.5,58.5
"12974","37275","2021",1,1,0,1e+05,1282,78
"12975","37276","2021",17,17,0,196696.411764706,1783.11764705882,111.470588235294
"12976","37277","2021",23,23,0,92021.7391304348,1301.08695652174,78.0869565217391
"12977","37278","2021",14,14,0,179407.142857143,1941.07142857143,101.928571428571
"12978","37279","2021",9,9,0,139233.333333333,1410.55555555556,102.666666666667
"12979","37280","2021",3,3,0,199404,1789.33333333333,138.666666666667
"12980","37281","2021",40,37,3,289471.575,2939.1,107.9
"12981","37282","2021",20,19,1,106627.1,1013.5,108.9
"12982","38001","2021",62,48,14,163687.564516129,1840.88709677419,92.0322580645161
"12983","38002","2021",65,5,60,126828.292307692,2909.70769230769,40.4307692307692
"12984","38003","2021",10,10,0,280103,2820.5,102
"12985","38004","2021",16,15,1,228817.5,2352.4375,98.25
"12986","38005","2021",19,10,9,175198.105263158,2504.36842105263,74.6315789473684
"12987","38006","2021",91,30,61,116346.351648352,1873.10989010989,60.4505494505495
"12988","38008","2021",1,1,0,180000,2571,70
"12989","38009","2021",6,6,0,352575,2877.83333333333,128.833333333333
"12990","38010","2021",12,12,0,291412.5,2822.66666666667,106
"12991","38011","2021",11,9,2,307934,3265.18181818182,96.1818181818182
"12992","38012","2021",31,24,7,160986.677419355,1804,90.7096774193548
"12993","38013","2021",28,25,3,250357.142857143,2354.25,109.392857142857
"12994","38015","2021",10,8,2,216660.7,2293.3,98.9
"12995","38017","2021",11,11,0,256515.909090909,2765,97.2727272727273
"12996","38018","2021",3,3,0,188713.333333333,1470.33333333333,119
"12997","38019","2021",15,14,1,198004,2268.93333333333,85.5333333333333
"12998","38020","2021",29,3,26,111630.344827586,3098.13793103448,39.4827586206897
"12999","38022","2021",89,83,6,203028.011235955,2050.70786516854,102.898876404494
"13000","38023","2021",1,1,0,242300,2991,81
"13001","38026","2021",10,4,6,178322.8,2060,82.5
"13002","38027","2021",22,19,3,256510.7,2566.5,104.2727
"13003","38029","2021",24,22,2,220385.5,2093.333,107.9167
"13004","38030","2021",9,8,1,271190.9,2659.444,101.5556
"13005","38032","2021",4,4,0,215285,2292.75,96.5
"13006","38033","2021",1,1,0,276000,2060,134
"13007","38034","2021",63,51,12,169193.6,1664.365,104.1746
"13008","38035","2021",11,10,1,290453.3,2666,111.8182
"13009","38037","2021",5,5,0,224360,2116.4,106.8
"13010","38038","2021",5,5,0,250824.2,1895.8,137
"13011","38039","2021",33,26,7,463100.3,3790.545,130.1515
"13012","38040","2021",8,5,3,103925,1906.75,61.25
"13013","38041","2021",2,2,0,230000,2233,103
"13014","38042","2021",6,5,1,239681.7,2345.667,105.3333
"13015","38043","2021",16,16,0,305528.1,2615.375,115.8125
"13016","38044","2021",13,12,1,212738.5,2247.846,94.07692
"13017","38045","2021",20,17,3,526012.1,4492.3,117.75
"13018","38046","2021",4,4,0,242325,2058,115.5
"13019","38047","2021",2,2,0,130000,1808.5,71.5
"13020","38048","2021",4,4,0,268300,2761.75,97.5
"13021","38049","2021",1,1,0,199000,1531,130
"13022","38050","2021",6,6,0,197253.3,2274.333,92.16667
"13023","38051","2021",10,8,2,213198.4,2094.3,107.3
"13024","38052","2021",36,20,16,166667.9,2133.75,81.02778
"13025","38053","2021",325,98,227,181360.7,2400.622,76.13231
"13026","38054","2021",8,8,0,195562.5,2119.375,99.25
"13027","38055","2021",6,6,0,181623.3,1997.333,89.33333
"13028","38056","2021",2,2,0,166000,2069,82.5
"13029","38057","2021",3,3,0,301066.7,3644.667,96.66667
"13030","38058","2021",18,16,2,191031.9,2034.444,94.44444
"13031","38059","2021",21,16,5,446422.6,3546.238,127.4286
"13032","38060","2021",1,1,0,375600,2504,150
"13033","38061","2021",55,33,22,274889,2877.545,94.03636
"13034","38062","2021",7,7,0,191948.6,1984.143,94.71429
"13035","38063","2021",1,1,0,275600,3029,91
"13036","38064","2021",30,27,3,248803.5,2272.067,116.3333
"13037","38065","2021",13,13,0,245658.8,2198.538,108.8462
"13038","38067","2021",10,10,0,344789.5,3191.2,111.9
"13039","38068","2021",13,13,0,502399.4,4195.231,118.5385
"13040","38069","2021",12,12,0,206195.8,1846.333,118.25
"13041","38070","2021",17,10,7,228430,2520.765,85.52941
"13042","38071","2021",43,26,17,239177.8,3016,79.72093
"13043","38072","2021",28,26,2,224170,2132.929,106.1071
"13044","38073","2021",6,6,0,113333.3,1497.833,93.16667
"13045","38074","2021",2,2,0,207064.5,1901,112.5
"13046","38075","2021",29,23,6,272240.9,2595.586,105.8966
"13047","38076","2021",21,21,0,267894.1,2407.333,110.4762
"13048","38077","2021",7,7,0,237121.4,1994,118.5714
"13049","38078","2021",9,8,1,228334.8,2136.111,104.7778
"13050","38080","2021",4,4,0,209232.5,1871.25,114.25
"13051","38081","2021",12,12,0,284550,2671.583,108.0833
"13052","38082","2021",14,11,3,189242.1,2247.929,86.5
"13053","38083","2021",2,2,0,165825,2431.5,72.5
"13054","38084","2021",9,9,0,308648.7,2332.444,130.6667
"13055","38085","2021",80,72,8,291554.6,3024.525,98.0625
"13056","38086","2021",2,1,1,258770,2229.5,121.5
"13057","38087","2021",61,51,10,273306.4,2975.721,92.59016
"13058","38089","2021",2,2,0,186000,1377.5,133.5
"13059","38090","2021",4,3,1,181392.5,2228.75,81.75
"13060","38091","2021",1,1,0,160000,2424,66
"13061","38092","2021",1,1,0,224200,1884,119
"13062","38093","2021",5,5,0,146500,2019,89
"13063","38094","2021",25,22,3,219314,2213.6,108.28
"13064","38095","2021",22,20,2,205296.8,2146.318,97.72727
"13065","38097","2021",47,39,8,293040,3052.34,99.6383
"13066","38098","2021",10,10,0,190625.5,1889.2,103.1
"13067","38099","2021",7,6,1,252260.9,2557.286,100.7143
"13068","38100","2021",15,10,5,218680.1,2844.467,80
"13069","38101","2021",5,5,0,244000,2942,84.2
"13070","38102","2021",6,5,1,271475,2585.333,104.5
"13071","38103","2021",10,8,2,159825,2213.4,85.6
"13072","38104","2021",12,12,0,184430.8,2045.917,89.58333
"13073","38105","2021",28,27,1,278155.9,2727.893,109.3929
"13074","38107","2021",14,9,5,257221.4,2754,91.78571
"13075","38108","2021",2,2,0,203250,2665.5,77
"13076","38109","2021",7,7,0,303392.9,2981.286,110.8571
"13077","38110","2021",16,15,1,361783.8,2923.375,126.125
"13078","38111","2021",97,60,37,377045.5,3650.67,103.0825
"13079","38112","2021",1,1,0,167000,2257,74
"13080","38113","2021",9,9,0,215816.6,2431.333,95.88889
"13081","38114","2021",9,8,1,287328.3,2508.222,111.5556
"13082","38115","2021",4,4,0,378637.5,2745,141.75
"13083","38116","2021",1,1,0,103000,2020,51
"13084","38117","2021",7,7,0,189702.9,1684.286,127.8571
"13085","38118","2021",14,14,0,267635.7,2483.929,106.5714
"13086","38120","2021",8,8,0,293968.8,2996.25,101.625
"13087","38124","2021",22,21,1,196762.4,1903,105.6818
"13088","38126","2021",51,35,16,555671.4,4726.608,123.9412
"13089","38127","2021",1,1,0,141315,673,210
"13090","38128","2021",9,7,2,94166.67,1526.333,65.55556
"13091","38129","2021",18,5,13,154822.8,3393.556,43.27778
"13092","38130","2021",47,29,18,167290.3,1924.617,88.85106
"13093","38131","2021",8,8,0,333602.5,2820.125,120.25
"13094","38133","2021",48,36,12,315341.4,3056.083,103.4375
"13095","38134","2021",13,13,0,267556.2,2367.846,115.3077
"13096","38135","2021",8,7,1,215093.8,2155.5,101.125
"13097","38136","2021",1,1,0,477000,2806,170
"13098","38137","2021",1,1,0,438050,2282,192
"13099","38138","2021",41,14,27,192158.5,2530.707,77.70732
"13100","38139","2021",15,15,0,247581.1,1951.467,123.0667
"13101","38140","2021",55,38,17,349903.5,3748.727,94.45455
"13102","38141","2021",10,10,0,289964.1,2680.7,109.7
"13103","38144","2021",18,16,2,233062.8,2392.556,96.5
"13104","38146","2021",12,11,1,274059.2,2159.667,131.4167
"13105","38147","2021",6,4,2,208508.3,2012.833,103
"13106","38148","2021",25,24,1,239472.4,2111.28,115.24
"13107","38149","2021",23,21,2,282925.3,2512.565,114.0435
"13108","38150","2021",90,19,71,179699.3,2687.6,65.31111
"13109","38151","2021",443,54,389,148917.8,2028.095,74.18059
"13110","38152","2021",20,20,0,202540,2116,96.25
"13111","38153","2021",4,4,0,380265,3526.25,111.25
"13112","38154","2021",8,8,0,108437.5,1395.375,79.125
"13113","38155","2021",29,26,3,178987.9,2060.724,88.24138
"13114","38156","2021",10,10,0,226964,2299.9,100
"13115","38157","2021",22,20,2,293162.8,2995.455,98.81818
"13116","38158","2021",164,40,124,233742.3,3095.713,76.79878
"13117","38160","2021",15,13,2,317223.3,2680.467,122.6667
"13118","38161","2021",5,5,0,207300,1509,143.6
"13119","38162","2021",9,9,0,234076.7,2149.333,109
"13120","38163","2021",36,13,23,81925.14,1958.361,42.02778
"13121","38166","2021",2,2,0,185000,2244,82
"13122","38167","2021",7,7,0,164604,1984.714,91.42857
"13123","38169","2021",318,50,268,152529.4,2188.248,68.78302
"13124","38170","2021",35,15,20,282383.7,3370.486,81.28571
"13125","38171","2021",4,4,0,203437.5,1663,122
"13126","38172","2021",23,16,7,267397.4,2684.696,101.5217
"13127","38173","2021",4,4,0,197150,2291.75,82.5
"13128","38174","2021",15,14,1,161976.6,1817.333,89.4
"13129","38175","2021",37,21,16,251065.9,3406.486,79.13514
"13130","38176","2021",19,19,0,291317.6,2842.316,103.2632
"13131","38177","2021",2,1,1,125890,3065.5,39.5
"13132","38179","2021",98,21,77,231806,3152.888,72.55102
"13133","38180","2021",10,10,0,207414,1752.1,122.3
"13134","38181","2021",24,17,7,240463.3,2836.458,90.45833
"13135","38182","2021",37,31,6,198750.3,1965.297,101.7027
"13136","38183","2021",2,2,0,226213.5,2860,78.5
"13137","38184","2021",14,12,2,385877.6,3202.5,122.5714
"13138","38185","2021",3006,81,2925,159272.8,2660.228,62.05788
"13139","38186","2021",46,8,38,80790.41,2139.957,39.97826
"13140","38187","2021",34,22,12,183839.3,2218.676,77.76471
"13141","38188","2021",8,6,2,386400,3397.75,113.5
"13142","38189","2021",42,34,8,302337.4,3174.238,98.35714
"13143","38190","2021",10,9,1,205485,2637.4,77.8
"13144","38191","2021",171,9,162,263492.2,5910.216,40.49708
"13145","38193","2021",160,91,69,212305.1,2566.781,83.475
"13146","38194","2021",25,23,2,208234.4,2131.84,99.84
"13147","38195","2021",9,8,1,234188.9,2333.222,102.4444
"13148","38197","2021",22,16,6,338685.7,3396.409,102.2273
"13149","38198","2021",10,9,1,196694.8,1960.2,100.6
"13150","38199","2021",19,18,1,343442.6,2867.368,125.3684
"13151","38200","2021",41,26,15,331514.3,3205.293,101
"13152","38203","2021",4,3,1,132325,2295,60
"13153","38204","2021",7,6,1,128328.6,1441,93.14286
"13154","38205","2021",47,12,35,169588.5,3516.319,46.80851
"13155","38206","2021",6,6,0,268508.3,2936.667,107
"13156","38207","2021",2,2,0,167422.5,1314,126
"13157","38208","2021",4,4,0,188350,1536.5,96.5
"13158","38209","2021",1,1,0,255000,2161,118
"13159","38210","2021",3,3,0,153500,2267,74
"13160","38211","2021",6,6,0,149170,1623.667,95.16667
"13161","38212","2021",15,10,5,121034,1452.6,90.53333
"13162","38213","2021",9,9,0,239707.2,2111.333,120.7778
"13163","38214","2021",20,18,2,353457.6,3050.55,113.25
"13164","38215","2021",21,19,2,300087.9,3278.381,91.95238
"13165","38216","2021",1,1,0,195000,1950,100
"13166","38217","2021",1,1,0,1e+05,467,214
"13167","38218","2021",11,11,0,215272.7,1665.182,132
"13168","38219","2021",9,9,0,152615.6,1755.889,89.22222
"13169","38221","2021",2,2,0,186500,1909.5,97.5
"13170","38222","2021",7,7,0,262654.3,2071.429,131.1429
"13171","38223","2021",7,7,0,341372.9,4632,91.42857
"13172","38224","2021",1,1,0,296000,3020,98
"13173","38225","2021",72,32,40,197678.9,3259.736,61.02778
"13174","38226","2021",18,17,1,109761.1,1477.278,80
"13175","38228","2021",2,2,0,219250,2006.5,111
"13176","38229","2021",268,63,205,326763.8,3683.325,87.27612
"13177","38230","2021",7,7,0,294400,2842.143,106.2857
"13178","38231","2021",9,8,1,202344.4,1898.444,108.5556
"13179","38232","2021",7,7,0,244827.1,2175.714,116
"13180","38235","2021",5,5,0,313230,2843,114
"13181","38236","2021",15,15,0,219590,2342.2,96.26667
"13182","38237","2021",4,3,1,137500,2600.5,50.75
"13183","38238","2021",21,20,1,312432.4,2779.476,117.2381
"13184","38239","2021",72,44,28,222737,2430.194,90.65278
"13185","38240","2021",7,6,1,203488,1888,108.1429
"13186","38241","2021",2,2,0,160936.5,1476,103.5
"13187","38242","2021",13,9,4,182794.6,2524.308,83.07692
"13188","38243","2021",2,1,1,111000,1309.5,85
"13189","38244","2021",4,4,0,240067.5,1856.25,130
"13190","38245","2021",2,2,0,78722.5,1300.5,52
"13191","38246","2021",9,7,2,160275,2245.556,77.33333
"13192","38247","2021",43,37,6,158768.6,1875.907,87.95349
"13193","38248","2021",1,1,0,260000,4262,61
"13194","38249","2021",70,29,41,367569.7,4015.029,90.9
"13195","38250","2021",1,1,0,297500,1983,150
"13196","38252","2021",2,2,0,344190,3196.5,105
"13197","38253","2021",286,15,271,163971.1,4184.591,37.4965
"13198","38254","2021",12,12,0,227390.8,2469.417,93.66667
"13199","38255","2021",1,1,0,265000,1373,193
"13200","38256","2021",16,15,1,218012,2081.75,106.9375
"13201","38257","2021",2,2,0,166685,3210,48.5
"13202","38258","2021",3,3,0,173633.3,2041.667,90.33333
"13203","38259","2021",10,9,1,240335.2,2352.1,102.7
"13204","38260","2021",3,3,0,311933.3,3400.333,89.33333
"13205","38261","2021",62,35,27,191254.7,2156.452,88.53226
"13206","38263","2021",2,2,0,285000,2295,134
"13207","38264","2021",25,5,20,77280,2260.32,32.04
"13208","38265","2021",22,18,4,156212.5,1868.364,87.36364
"13209","38266","2021",7,7,0,133400,1416.429,96.71429
"13210","38267","2021",8,8,0,193343.8,2080,92.25
"13211","38268","2021",5,4,1,188818.6,1910,94.8
"13212","38269","2021",69,29,40,116800.6,1607.841,70.95652
"13213","38270","2021",15,11,4,198051.7,2296.133,85
"13214","38271","2021",11,9,2,299454.5,3896.909,81.63636
"13215","38272","2021",5,5,0,289230,2161.2,143.8
"13216","38273","2021",3,3,0,117333.3,1547.667,74.33333
"13217","38275","2021",2,2,0,93000,2069,67.5
"13218","38276","2021",29,26,3,241159.1,2589,93.55172
"13219","38277","2021",4,4,0,312865,2277.25,142.5
"13220","38278","2021",2,2,0,85000,1007.5,83
"13221","38279","2021",9,8,1,260294.4,2718.333,95.11111
"13222","38280","2021",4,4,0,105862.5,1250.5,90.25
"13223","38281","2021",28,20,8,340827.4,3396.964,97.96429
"13224","38282","2021",9,9,0,237972.2,2636.333,94
"13225","38283","2021",2,1,1,103750,1230.5,83
"13226","38284","2021",10,10,0,240633.5,1967.5,122.3
"13227","38285","2021",7,5,2,146164.3,2318.143,66.14286
"13228","38287","2021",9,8,1,170443.3,1537.111,111.3333
"13229","38288","2021",11,11,0,301992.7,2858.273,109.1818
"13230","38289","2021",29,6,23,250889,4237.897,55.44828
"13231","38290","2021",12,12,0,235766.7,2272.917,110.9167
"13232","38291","2021",19,19,0,201435.4,1749,116.6842
"13233","38292","2021",20,19,1,231675,2290.85,106.45
"13234","38294","2021",3,2,1,225000,2401,93
"13235","38295","2021",6,6,0,178971.7,1710.5,110.3333
"13236","38296","2021",5,5,0,215250,1759.2,129.8
"13237","38297","2021",8,8,0,223775,2095.5,109.375
"13238","38298","2021",85,45,40,138514.4,1703.741,83.78824
"13239","38299","2021",4,4,0,103392.5,1527.5,68.75
"13240","38300","2021",5,5,0,206855,2173.6,104.4
"13241","38301","2021",2,2,0,197500,1091,200
"13242","38303","2021",6,6,0,347386.3,3079,112.1667
"13243","38304","2021",17,16,1,204904.7,1969,103.0588
"13244","38307","2021",5,5,0,171060,1670.4,105
"13245","38308","2021",2,2,0,202350,1383.5,151
"13246","38309","2021",22,14,8,286996.4,3144.091,91.22727
"13247","38310","2021",10,10,0,269957,2577.4,106.2
"13248","38311","2021",9,9,0,177302.2,1681.222,101
"13249","38313","2021",2,2,0,214000,1558,128.5
"13250","38314","2021",92,54,38,205573.1,2563.13,81.03261
"13251","38315","2021",48,28,20,179565.9,2199.875,81.83333
"13252","38316","2021",76,33,43,191498.6,2548.184,77.17105
"13253","38317","2021",142,15,127,126620.2,1922.507,67.61972
"13254","38318","2021",55,20,35,180839.3,2290.564,77.78182
"13255","38319","2021",11,6,5,110800,1113.909,97.09091
"13256","38320","2021",19,19,0,206377.4,2520.368,85.05263
"13257","38321","2021",3,3,0,119000,1692,81
"13258","38322","2021",1,0,1,175000,2917,60
"13259","38323","2021",11,11,0,229925.9,2371,99
"13260","38324","2021",7,7,0,295116.7,2242.857,129.2857
"13261","38325","2021",1,1,0,85000,1062,80
"13262","38326","2021",2,1,1,276625,1945.5,142.5
"13263","38328","2021",3,3,0,247000,3894.667,58.66667
"13264","38329","2021",1,1,0,65000,774,84
"13265","38330","2021",1,1,0,161550,1077,150
"13266","38331","2021",11,10,1,301813.6,2690.455,113.9091
"13267","38332","2021",33,17,16,147573.4,1777.333,87.30303
"13268","38333","2021",3,3,0,144500,2297,103.6667
"13269","38334","2021",12,10,2,287396.6,2548.417,116.8333
"13270","38335","2021",10,9,1,203323,2085.5,105.1
"13271","38336","2021",23,18,5,261581.5,2559.739,104.7826
"13272","38337","2021",82,33,49,181234,2110.61,87.04878
"13273","38338","2021",5,5,0,229600,2310.2,98.6
"13274","38339","2021",11,11,0,329758.2,2879.273,115.3636
"13275","38340","2021",24,11,13,168121.2,2268.042,79.66667
"13276","38341","2021",9,9,0,243644.4,2173.333,117.2222
"13277","38342","2021",4,4,0,257850,2071.75,122.25
"13278","38343","2021",10,10,0,217309,2075.9,112.1
"13279","38344","2021",88,52,36,175095.9,1920.818,91.28409
"13280","38345","2021",2,2,0,212625,1997,107
"13281","38346","2021",2,2,0,202250,1890.5,106
"13282","38347","2021",10,10,0,117125,1946.3,82
"13283","38348","2021",34,33,1,323152.8,2777.294,117.3824
"13284","38349","2021",14,13,1,200928.1,2286,88.78571
"13285","38351","2021",9,9,0,323638.9,2782.778,117.4444
"13286","38352","2021",18,14,4,266897.4,2896.444,91.16667
"13287","38353","2021",6,6,0,207041.7,2128.333,96.66667
"13288","38354","2021",4,4,0,205920.8,1669.5,130.5
"13289","38355","2021",2,2,0,197400,2035.5,136
"13290","38356","2021",3,3,0,83111.67,1249.667,61
"13291","38357","2021",24,23,1,239935.2,2333.333,104.25
"13292","38358","2021",5,5,0,271228,2779,98.8
"13293","38359","2021",12,11,1,208795.8,1931.667,121.3333
"13294","38360","2021",4,3,1,226500,2076.25,124.75
"13295","38361","2021",2,2,0,199500,2149.5,93
"13296","38362","2021",4,4,0,288922,1979.25,144.75
"13297","38363","2021",7,7,0,189600,1604.429,122.2857
"13298","38364","2021",7,7,0,209162.9,2333.286,88.14286
"13299","38365","2021",3,3,0,252600,2454.333,100
"13300","38366","2021",2,2,0,215750,3002,75.5
"13301","38368","2021",9,9,0,308594.4,2481.889,126.7778
"13302","38369","2021",4,4,0,187500,2539,79.25
"13303","38370","2021",5,5,0,251224,2269.2,123.2
"13304","38372","2021",2,2,0,277800,2397,124
"13305","38373","2021",8,7,1,222450,2193.5,103.125
"13306","38374","2021",30,28,2,263836.5,2327.833,118.0667
"13307","38375","2021",2,2,0,397635,5852.5,61.5
"13308","38376","2021",12,11,1,182183.3,2026.417,95.5
"13309","38377","2021",37,26,11,168689.4,1947.405,88.10811
"13310","38378","2021",34,30,4,258797.4,2805.941,95.32353
"13311","38379","2021",5,5,0,211681,1926.8,110.6
"13312","38380","2021",1,1,0,171000,1487,115
"13313","38381","2021",20,20,0,265654.4,2245.6,121.55
"13314","38382","2021",209,58,151,228965.5,2887.517,78.73206
"13315","38383","2021",31,29,2,322132.6,2876.839,116.4839
"13316","38384","2021",24,19,5,273118.8,2630.833,104.375
"13317","38386","2021",14,10,4,160426.4,1590.786,103.7143
"13318","38387","2021",4,2,2,159355,1612,103.75
"13319","38388","2021",26,18,8,284182.5,2910.577,95.07692
"13320","38389","2021",37,33,4,314102.3,3202.757,101.1622
"13321","38390","2021",4,3,1,211235,2280.25,93.5
"13322","38391","2021",3,3,0,274666.7,1920.667,137
"13323","38392","2021",7,7,0,307442.6,2743.286,112.4286
"13324","38393","2021",13,13,0,228438.8,2288.538,105.9231
"13325","38394","2021",13,12,1,221780,2658.923,91.15385
"13326","38395","2021",25,21,4,272123,3289.24,88.16
"13327","38396","2021",16,5,11,107231.2,1456.188,63.625
"13328","38397","2021",78,59,19,521873.1,4430.051,120.3333
"13329","38398","2021",12,11,1,190916.7,1842.417,110.5833
"13330","38399","2021",50,39,11,212972.8,2376.24,95.44
"13331","38400","2021",30,24,6,304853.2,2659.067,112.5
"13332","38401","2021",15,14,1,225740,2136,108.4667
"13333","38402","2021",8,7,1,163250,1724.375,93
"13334","38403","2021",3,3,0,110000,1293.333,90
"13335","38404","2021",2,2,0,447625,4433,104
"13336","38405","2021",12,10,2,185332.5,1966.167,95.5
"13337","38406","2021",1,1,0,180000,2500,72
"13338","38407","2021",4,4,0,349011.8,2284,160.25
"13339","38408","2021",14,14,0,385059.9,3492.929,112.3571
"13340","38409","2021",15,13,2,218533.1,1934.067,118.7333
"13341","38410","2021",11,11,0,183394.5,1808.818,100.5455
"13342","38412","2021",39,26,13,165519.8,1994.667,85.69231
"13343","38413","2021",6,6,0,177633.3,2218.833,85.5
"13344","38415","2021",7,7,0,298815.7,3113.429,111.5714
"13345","38416","2021",122,43,79,139694.4,1938.705,74.07377
"13346","38417","2021",4,4,0,360700,3836.75,104.25
"13347","38418","2021",3,3,0,322333.3,3175,112.3333
"13348","38419","2021",2,2,0,109000,1916.5,70.5
"13349","38421","2021",515,61,454,158093.9,2317.27,68.06796
"13350","38422","2021",54,32,22,328639,3390.87,95.94444
"13351","38423","2021",77,27,50,256430,2784.597,88.44156
"13352","38424","2021",2,2,0,112500,1384.5,87.5
"13353","38425","2021",62,53,9,211397.8,2114.484,99.75806
"13354","38426","2021",5,5,0,346750,2761.2,147.6
"13355","38427","2021",4,4,0,288427.5,2549.5,111.5
"13356","38429","2021",2,2,0,245500,2831,87.5
"13357","38430","2021",1,1,0,3e+05,2913,103
"13358","38431","2021",39,29,10,449751.8,4115.128,108.4615
"13359","38432","2021",6,6,0,231666.7,2206,107
"13360","38433","2021",15,9,6,266147,3113.733,83.06667
"13361","38434","2021",7,7,0,268326,2164.143,128.5714
"13362","38436","2021",16,14,2,387896.4,3559.812,115.6875
"13363","38438","2021",3,3,0,130500,1560.333,84
"13364","38439","2021",30,27,3,220936.8,2289,95.83333
"13365","38440","2021",5,5,0,202920,1972.4,99.4
"13366","38442","2021",23,11,12,178263.3,2402.435,72.69565
"13367","38443","2021",1,1,0,224000,1600,140
"13368","38444","2021",1,1,0,255000,1425,179
"13369","38445","2021",11,11,0,239631.8,3301.909,83.09091
"13370","38446","2021",10,9,1,166638,1938.7,83
"13371","38448","2021",6,4,2,243441.7,2744.667,91.33333
"13372","38449","2021",46,44,2,244199.3,2570.087,94.84783
"13373","38450","2021",11,11,0,299899,2956.455,102.5455
"13374","38451","2021",33,31,2,280170.5,3200.333,90.15152
"13375","38452","2021",2,2,0,202200,2345.5,85
"13376","38453","2021",17,14,3,218697.4,2100.176,105.4118
"13377","38454","2021",17,15,2,225518,2257.176,100.7059
"13378","38455","2021",39,37,2,283340.3,2507.385,115.0769
"13379","38456","2021",5,5,0,151570,2014.4,86
"13380","38457","2021",38,34,4,194377.8,1959.974,101.0263
"13381","38458","2021",4,4,0,208079.2,1789.25,122
"13382","38459","2021",10,10,0,287303,2693.6,109.4
"13383","38460","2021",6,6,0,178951.7,2313,82.16667
"13384","38462","2021",5,5,0,180600,2211.4,78.2
"13385","38463","2021",10,8,2,234460,2129.3,112.1
"13386","38464","2021",15,12,3,207923.3,2348.4,88.26667
"13387","38465","2021",12,12,0,172320.1,1515.667,120.8333
"13388","38466","2021",14,8,6,265680,3854.5,72.57143
"13389","38467","2021",15,15,0,269793.3,2341.867,116.6667
"13390","38468","2021",59,46,13,204595.1,2094.627,100.7627
"13391","38469","2021",3,3,0,80566.67,1404.667,56.66667
"13392","38470","2021",9,9,0,150949.9,1981.889,90.66667
"13393","38471","2021",10,6,4,332010,3386.4,91.9
"13394","38472","2021",4,4,0,191000,1831.75,90.25
"13395","38473","2021",13,13,0,219941.8,2281.385,102.3846
"13396","38474","2021",169,43,126,215283,2827.45,76.1716
"13397","38475","2021",14,12,2,390335.7,3380,116.5714
"13398","38476","2021",6,6,0,246586.7,2387.667,108.3333
"13399","38478","2021",7,7,0,160421.4,2088.714,74.85714
"13400","38479","2021",10,10,0,206865,1852.4,114
"13401","38480","2021",21,10,11,242309.9,3160.238,89.2381
"13402","38481","2021",5,5,0,218120,2493.2,89.4
"13403","38483","2021",9,9,0,293738.9,2583,111.7778
"13404","38484","2021",29,24,5,276009.6,3083.103,89.89655
"13405","38485","2021",189,31,158,194376,2556.19,73.36508
"13406","38486","2021",102,45,57,324603.1,3463.755,92.22549
"13407","38487","2021",15,9,6,307146.7,3236.333,93.46667
"13408","38488","2021",6,6,0,238066.8,2065.5,115.8333
"13409","38489","2021",1,1,0,135000,1144,118
"13410","38490","2021",11,10,1,188159.1,2058.182,91.18182
"13411","38492","2021",4,4,0,186110.2,2770.75,68.75
"13412","38494","2021",11,11,0,263421.5,2223.545,117.6364
"13413","38495","2021",6,5,1,136550,1496.5,95.66667
"13414","38496","2021",7,7,0,171142.9,1775.714,99
"13415","38497","2021",2,2,0,156700,1365,94
"13416","38498","2021",6,5,1,254555,2151.333,124.5
"13417","38499","2021",9,8,1,105166.7,1388.111,76
"13418","38500","2021",5,5,0,201307.8,1852.4,111.8
"13419","38501","2021",49,17,32,228708.7,3086.122,74.32653
"13420","38503","2021",27,17,10,269541.5,3246.111,81.59259
"13421","38504","2021",12,11,1,361884.2,3057.833,117.0833
"13422","38505","2021",7,7,0,209252.9,1961.714,106.5714
"13423","38507","2021",61,51,10,296546.4,3062.016,97.52459
"13424","38508","2021",3,3,0,491750,2220.667,204.3333
"13425","38509","2021",101,37,64,141965.2,1886.455,76.35644
"13426","38511","2021",30,18,12,251527.8,2806.233,89.8
"13427","38512","2021",9,9,0,322861.1,3139.111,102.8889
"13428","38513","2021",2,2,0,281465,3159,89
"13429","38514","2021",3,3,0,132000,1889.333,71.66667
"13430","38515","2021",23,23,0,270337.3,2725.13,108.9565
"13431","38516","2021",82,19,63,294299.5,3616.305,79.97561
"13432","38517","2021",86,42,44,186353,2238.535,80.94186
"13433","38518","2021",5,5,0,163529,1394.6,125.8
"13434","38519","2021",23,19,4,356481,3345.304,108.9565
"13435","38520","2021",3,3,0,199600,1417.667,158.6667
"13436","38522","2021",4,4,0,98000,1519.75,64.75
"13437","38523","2021",8,8,0,233456.2,1896.375,130
"13438","38524","2021",80,42,38,296686.6,3412.375,86.2875
"13439","38525","2021",7,5,2,194370,1806.857,110.8571
"13440","38526","2021",4,4,0,329737.5,2570.75,144.5
"13441","38527","2021",6,3,3,355011.7,5075,78.5
"13442","38528","2021",14,13,1,333186.9,3288.929,102.5714
"13443","38529","2021",55,30,25,260131.8,3330.873,78.83636
"13444","38530","2021",23,16,7,287184,2803.739,105.4348
"13445","38531","2021",4,4,0,193497.5,1902,103.25
"13446","38532","2021",9,8,1,289096.7,3041.111,95.33333
"13447","38533","2021",4,3,1,499322.5,4377,117.5
"13448","38535","2021",1,1,0,390000,2868,136
"13449","38536","2021",6,6,0,230500,2279.833,103.1667
"13450","38537","2021",68,34,34,212076.4,2869.721,75.83824
"13451","38538","2021",46,29,17,288107.8,3183.739,90.82609
"13452","38539","2021",4,4,0,163456.2,1588.75,103.75
"13453","38540","2021",20,18,2,278178.2,2875.9,97.85
"13454","38542","2021",3,3,0,376966.7,3208.667,117.3333
"13455","38543","2021",17,16,1,205072.1,2301.059,91.41176
"13456","38544","2021",334,88,246,191060,2337.964,80.35329
"13457","38545","2021",93,51,42,276519.8,3269.516,85.25806
"13458","38546","2021",12,12,0,237358.3,2137.833,112.25
"13459","38547","2021",112,51,61,212082.9,2800.312,76.76786
"13460","38548","2021",181,23,158,156585.7,3341.232,44.70166
"13461","38551","2021",1,1,0,1e+05,1000,100
"13462","38552","2021",3,3,0,254200,2220.333,113.3333
"13463","38553","2021",133,88,45,200675.8,2363.85,84.57895
"13464","38554","2021",10,10,0,296287.5,3122,94.2
"13465","38555","2021",12,12,0,288616.7,2885.833,108.5833
"13466","38556","2021",7,7,0,294525,1816.143,145
"13467","38557","2021",50,39,11,384885.8,3813.12,106.2
"13468","38558","2021",11,8,3,384976.4,3610.364,108.0909
"13469","38559","2021",56,36,20,195068.2,2092.054,90.35714
"13470","38560","2021",20,17,3,163737.5,1769.3,95.55
"13471","38561","2021",19,18,1,178669.5,1587.579,114.4737
"13472","38562","2021",101,39,62,166390.5,2272.327,73.22772
"13473","38563","2021",335,76,259,186734.2,2421.612,75.89851
"13474","38564","2021",3,3,0,159833.3,1884.333,87.33333
"13475","38565","2021",108,57,51,257380.3,2814.315,89.83333
"13476","38566","2021",11,8,3,272411.9,2601.182,104.3636
"13477","38567","2021",99,5,94,92020.84,2401.879,38.11111
"13478","39001","2021",17,17,0,174161.4,1590.412,111.1176
"13479","39002","2021",1,1,0,125000,2500,50
"13480","39004","2021",1,1,0,125000,1603,78
"13481","39006","2021",3,3,0,196891.7,1659.333,122
"13482","39008","2021",5,5,0,130460,1539.4,92.6
"13483","39009","2021",5,4,1,107720,1217.6,95.2
"13484","39010","2021",1,1,0,22000,611,36
"13485","39011","2021",9,8,1,116166.7,1156,105.2222
"13486","39013","2021",41,30,11,172436.6,1536.707,111.1707
"13487","39014","2021",3,3,0,228316.7,1721,133
"13488","39015","2021",3,2,1,101126.7,1111.333,83.66667
"13489","39016","2021",15,15,0,106427.3,911.9333,118.4
"13490","39017","2021",17,17,0,146815.5,1414.765,103.4118
"13491","39018","2021",5,5,0,196800,1386,139.8
"13492","39019","2021",3,3,0,136666.7,1340,120.6667
"13493","39020","2021",1,1,0,163000,1032,158
"13494","39021","2021",10,10,0,153648.1,1321,112.5
"13495","39022","2021",13,13,0,153015.4,1583,104.6923
"13496","39024","2021",6,3,3,110570.8,1368.833,73.83333
"13497","39025","2021",4,4,0,86750,981.75,90.25
"13498","39026","2021",10,6,4,155040,1355.3,114.4
"13499","39027","2021",2,2,0,69750,959.5,73.5
"13500","39028","2021",3,3,0,193266.7,1646.667,115.3333
"13501","39029","2021",2,2,0,167350,1590.5,107
"13502","39030","2021",6,5,1,150133.3,1552.333,102.5
"13503","39031","2021",2,2,0,184150,1106,171.5
"13504","39032","2021",8,7,1,150000,1483.375,101.5
"13505","39034","2021",3,3,0,165333.3,1315,127.6667
"13506","39035","2021",2,2,0,99000,1242.5,68
"13507","39037","2021",2,2,0,158750,1524,107
"13508","39038","2021",3,3,0,246000,2569,105.3333
"13509","39039","2021",1,1,0,80000,650,123
"13510","39040","2021",2,2,0,155000,902,164.5
"13511","39041","2021",1,1,0,247390,3806,65
"13512","39042","2021",7,7,0,226857.1,1876.429,117.7143
"13513","39043","2021",27,25,2,157221.5,1847.259,97.7037
"13514","39045","2021",3,3,0,95133.33,1126,96
"13515","39046","2021",3,3,0,219683.3,1629.333,139.3333
"13516","39047","2021",7,4,3,151678.6,2214.429,69.14286
"13517","39048","2021",6,6,0,179583.3,1405.5,140.1667
"13518","39049","2021",3,3,0,114633.3,763,146.3333
"13519","39050","2021",1,1,0,26875,448,60
"13520","39051","2021",5,5,0,192151,1688.4,116.4
"13521","39052","2021",2,2,0,80000,698.5,114.5
"13522","39053","2021",2,2,0,165000,1379,124
"13523","39054","2021",1,1,0,145500,1347,108
"13524","39055","2021",1,1,0,230000,1643,140
"13525","39056","2021",30,26,4,150354.2,1550,103
"13526","39057","2021",2,2,0,176750,1277.5,135.5
"13527","39059","2021",39,14,25,182236.6,2445.308,72.74359
"13528","39060","2021",1,1,0,105660,1016,104
"13529","39061","2021",2,2,0,280000,6866.5,57.5
"13530","39063","2021",9,7,2,147188.9,1698.556,91
"13531","39065","2021",1,1,0,107500,1265,85
"13532","39066","2021",1,1,0,150950,1887,80
"13533","39068","2021",6,6,0,190491.7,2169.667,106
"13534","39070","2021",1,1,0,286000,1713,167
"13535","39072","2021",3,2,1,107833.3,1373.667,83
"13536","39073","2021",1,1,0,205550,1581,130
"13537","39074","2021",3,3,0,164000,2146.667,81.66667
"13538","39076","2021",2,2,0,176575,2294.5,77
"13539","39078","2021",11,9,2,173322.7,2107.727,82.81818
"13540","39080","2021",1,1,0,63000,724,87
"13541","39081","2021",3,3,0,129000,1383.667,96.66667
"13542","39083","2021",10,10,0,212865,1956.5,116.3
"13543","39086","2021",2,2,0,108250,941,112.5
"13544","39088","2021",3,3,0,159566.7,1648.667,91.66667
"13545","39090","2021",1,1,0,118000,1475,80
"13546","39091","2021",1,1,0,39309,562,70
"13547","39092","2021",4,4,0,70625,549.5,125.75
"13548","39093","2021",3,3,0,166466.7,1458,124.6667
"13549","39094","2021",1,1,0,140000,1261,111
"13550","39095","2021",2,2,0,136500,1262.5,110
"13551","39096","2021",5,5,0,158260,1568.4,109.2
"13552","39097","2021",124,58,66,140148.6,1647.935,88.35484
"13553","39099","2021",3,3,0,156333.3,1342.667,125
"13554","39101","2021",10,10,0,129795,1172.7,111.1
"13555","39102","2021",1,1,0,390000,2955,132
"13556","39103","2021",5,5,0,196375,1706.2,118.6
"13557","39104","2021",13,13,0,123536.2,1195.923,100.7692
"13558","39105","2021",4,4,0,189225,1816,107
"13559","39106","2021",1,1,0,140000,1591,88
"13560","39107","2021",2,2,0,199155,802.5,245.5
"13561","39108","2021",2,2,0,177325,1151,153
"13562","39111","2021",2,2,0,70000,884.5,82.5
"13563","39112","2021",3,3,0,105000,1017,105.3333
"13564","39114","2021",3,3,0,385000,2044.333,165
"13565","39116","2021",2,2,0,141507,1265,112.5
"13566","39117","2021",7,6,1,137028.6,1502.857,90.14286
"13567","39119","2021",1,1,0,125000,1096,114
"13568","39120","2021",2,2,0,107125,924.5,137
"13569","39121","2021",6,6,0,272933.3,1668.167,164.6667
"13570","39122","2021",2,2,0,146500,1326,111.5
"13571","39124","2021",5,5,0,89780,1179.4,76.6
"13572","39126","2021",2,2,0,282110,2720,103.5
"13573","39128","2021",27,25,2,141215.9,1288.741,114.963
"13574","39129","2021",5,5,0,202824,2320.4,113.2
"13575","39130","2021",7,6,1,121707.1,1279.143,101.8571
"13576","39131","2021",1,1,0,69500,781,89
"13577","39132","2021",1,1,0,32000,1600,20
"13578","39133","2021",1,0,1,50000,435,115
"13579","39134","2021",1,1,0,183500,2294,80
"13580","39137","2021",3,3,0,99166.67,1002.333,110.3333
"13581","39138","2021",3,3,0,122333.3,1516.667,83.66667
"13582","39139","2021",1,1,0,290000,6170,47
"13583","39140","2021",2,2,0,221430,2098.5,120
"13584","39141","2021",4,4,0,203600,1349.25,162.25
"13585","39142","2021",2,2,0,118000,1795,63
"13586","39145","2021",2,2,0,217100,1836,118.5
"13587","39146","2021",7,6,1,170557.1,1928.571,93.85714
"13588","39147","2021",2,2,0,124150,1759.5,71
"13589","39149","2021",2,2,0,482225,3331.5,133
"13590","39150","2021",14,12,2,145320.7,1589.071,96.21429
"13591","39151","2021",5,5,0,140400,1507.6,102.2
"13592","39153","2021",10,10,0,207420,1938,109
"13593","39154","2021",16,10,6,169053.8,2105.188,84.6875
"13594","39156","2021",3,3,0,143333.3,1674,82.33333
"13595","39159","2021",7,7,0,151642.9,1620.429,107.1429
"13596","39160","2021",14,14,0,123596.4,1375,100.2143
"13597","39162","2021",2,2,0,117000,1222.5,94
"13598","39163","2021",1,1,0,59000,1283,46
"13599","39164","2021",11,11,0,144376,1490.636,94.09091
"13600","39165","2021",1,1,0,115202,1129,102
"13601","39166","2021",9,9,0,89790.33,942.4444,100.5556
"13602","39167","2021",6,6,0,120000,1254.167,97.66667
"13603","39169","2021",5,5,0,192920,1830.4,111.8
"13604","39170","2021",9,8,1,200140,1847.222,112.7778
"13605","39171","2021",6,6,0,217733.3,1865,124
"13606","39172","2021",6,6,0,163714,1712.667,99.16667
"13607","39173","2021",32,26,6,118280.6,1410.281,88.875
"13608","39176","2021",7,7,0,135435.7,1211.571,123.5714
"13609","39177","2021",6,6,0,131920,1125.5,115.8333
"13610","39178","2021",1,1,0,117700,1401,84
"13611","39179","2021",2,2,0,341500,2367,144.5
"13612","39180","2021",3,3,0,118700,1246,105.3333
"13613","39182","2021",5,5,0,224106,2116.2,107
"13614","39183","2021",6,6,0,153311.7,1443,110.3333
"13615","39184","2021",5,5,0,218460,1543.8,118.8
"13616","39185","2021",3,3,0,199000,1512,132
"13617","39187","2021",3,3,0,195516.7,1242.333,161.6667
"13618","39188","2021",2,2,0,172100,1790.5,100
"13619","39189","2021",53,49,4,138278,1551.66,92.22642
"13620","39190","2021",16,14,2,188127.4,1643.562,113.25
"13621","39191","2021",1,1,0,120000,638,188
"13622","39192","2021",3,3,0,138800,1589,84
"13623","39193","2021",18,18,0,161141.7,1377.333,121.2778
"13624","39194","2021",2,2,0,230325,1645,140
"13625","39196","2021",3,3,0,254963.3,1440.333,180.3333
"13626","39197","2021",6,6,0,142916.7,1548,93.5
"13627","39198","2021",379,181,198,138304.7,1575.763,88.80739
"13628","39199","2021",14,14,0,164157.1,1661.571,104.2857
"13629","39201","2021",9,9,0,217481.1,2588.111,106.8889
"13630","39202","2021",2,2,0,137242.5,1070,131.5
"13631","39205","2021",6,6,0,200941.7,1575.167,131
"13632","39206","2021",2,2,0,51000,1103.5,50.5
"13633","39207","2021",1,1,0,96500,1892,51
"13634","39208","2021",2,2,0,160525,1008.5,136
"13635","39209","2021",7,7,0,103618.3,1138.286,93.85714
"13636","39210","2021",7,7,0,192792.9,1554.143,132.2857
"13637","39211","2021",4,4,0,110412.5,1209.5,91.75
"13638","39216","2021",5,5,0,152138,1546.8,101.4
"13639","39217","2021",5,5,0,165450,1095.4,152
"13640","39218","2021",7,7,0,160628.6,1611.571,107
"13641","39219","2021",5,3,2,216685,1946.6,110.8
"13642","39220","2021",3,3,0,160640,1283,130.3333
"13643","39225","2021",4,4,0,162137.5,1385.25,113.75
"13644","39227","2021",6,3,3,97088.33,1209.167,79.5
"13645","39228","2021",18,17,1,244156.4,2061,113.6111
"13646","39229","2021",2,2,0,80000,1189.5,69
"13647","39230","2021",2,2,0,213534,1659.5,110.5
"13648","39232","2021",1,1,0,119700,2784,43
"13649","39233","2021",25,18,7,170353.2,1828.68,92
"13650","39235","2021",23,16,7,155800,1568,97.26087
"13651","39236","2021",1,1,0,175600,1476,119
"13652","39237","2021",2,2,0,133250,1345,98.5
"13653","39238","2021",5,5,0,118660,900,123
"13654","39240","2021",1,0,1,181500,1621,112
"13655","39241","2021",6,6,0,174891.7,1549,106.5
"13656","39244","2021",3,3,0,175500,1642,102.6667
"13657","39245","2021",10,10,0,148415,1499.4,100.6
"13658","39246","2021",4,3,1,138962.5,1430.75,95.75
"13659","39247","2021",1,1,0,125000,1250,100
"13660","39251","2021",7,5,2,126520,1429.143,85.57143
"13661","39252","2021",10,10,0,157690,1421.5,111.8
"13662","39253","2021",3,3,0,87000,696.6667,121
"13663","39254","2021",1,1,0,260000,2500,104
"13664","39255","2021",6,5,1,68071,1297.667,56.5
"13665","39258","2021",9,9,0,208391.1,2117,101.7778
"13666","39261","2021",1,1,0,90000,947,95
"13667","39262","2021",1,1,0,169000,1657,102
"13668","39263","2021",4,4,0,238912.5,1591.25,156.75
"13669","39265","2021",1,1,0,115000,1250,92
"13670","39266","2021",5,5,0,163100,1636,100.6
"13671","39267","2021",1,1,0,130000,1074,121
"13672","39269","2021",3,3,0,135000,1346.333,105.6667
"13673","39270","2021",10,10,0,193605,1568.9,129.9
"13674","39271","2021",3,3,0,169858.3,1666.667,119.3333
"13675","39272","2021",1,1,0,118000,1180,100
"13676","39273","2021",6,6,0,148741.7,1425.667,107.6667
"13677","39274","2021",8,4,4,279617.8,3751.5,68.625
"13678","39275","2021",26,13,13,209584.2,2635.885,81.30769
"13679","39277","2021",1,1,0,297500,1859,160
"13680","39278","2021",1,1,0,175000,1423,123
"13681","39279","2021",10,10,0,184217,1745.3,108.1
"13682","39281","2021",1,1,0,209148,1423,147
"13683","39282","2021",2,2,0,132500,1064.5,124
"13684","39283","2021",3,3,0,196000,2273.333,85.33333
"13685","39284","2021",5,5,0,203670,1444.6,141
"13686","39285","2021",8,8,0,185875,1979.625,97.5
"13687","39286","2021",18,12,6,131591.9,1255.389,101.5
"13688","39288","2021",4,4,0,154725,1090.5,134.75
"13689","39289","2021",7,7,0,101178.6,1156,86.57143
"13690","39290","2021",6,6,0,155833.3,1472.667,110
"13691","39291","2021",5,5,0,161640,1222.4,129.8
"13692","39293","2021",1,1,0,131000,897,146
"13693","39295","2021",2,2,0,84100,758,112.5
"13694","39296","2021",7,7,0,199807.3,1670.429,124.1429
"13695","39297","2021",21,16,5,234877.1,2430.381,98.90476
"13696","39299","2021",9,9,0,131550,1445.667,101.4444
"13697","39300","2021",290,58,232,122265.4,1591.945,77.45862
"13698","39301","2021",3,3,0,162666.7,2042,77.33333
"13699","39302","2021",3,3,0,91500,1486,71.66667
"13700","39304","2021",4,4,0,272525,2236,127.5
"13701","39305","2021",6,6,0,139583.3,1371,97.66667
"13702","39306","2021",5,5,0,169100,1508.4,116.6
"13703","39307","2021",3,3,0,231133.3,2476,107
"13704","39308","2021",2,2,0,212675,1263.5,178.5
"13705","39310","2021",7,7,0,173821.4,1310.857,129.2857
"13706","39312","2021",3,3,0,122211.7,1269,86.66667
"13707","39313","2021",3,3,0,204700,1919.667,133
"13708","39314","2021",1,1,0,127500,996,128
"13709","39315","2021",3,3,0,119000,1314.333,90.66667
"13710","39317","2021",4,4,0,93375,855,114.75
"13711","39318","2021",2,2,0,142500.5,1372.5,95
"13712","39319","2021",3,3,0,193000,1261,138.3333
"13713","39320","2021",3,3,0,73000,844,92.33333
"13714","39322","2021",2,2,0,165500,1214.5,132.5
"13715","39323","2021",2,2,0,74000,940.5,80
"13716","39325","2021",10,8,2,107450,1086.6,98.6
"13717","39326","2021",1,1,0,75000,600,125
"13718","39327","2021",18,18,0,166068.3,1721.889,100.9444
"13719","39328","2021",5,5,0,123380,1099.8,110.2
"13720","39329","2021",2,2,0,57500,541.5,111.5
"13721","39331","2021",8,8,0,146673.8,1689,89.25
"13722","39333","2021",23,13,10,128707.4,1351.783,95.73913
"13723","39334","2021",2,2,0,221825,1684,132
"13724","39335","2021",4,4,0,130292.5,1297.25,98.25
"13725","39338","2021",4,4,0,106875,1163.25,93.5
"13726","39339","2021",8,6,2,160646.2,1518.125,109.375
"13727","39342","2021",3,3,0,83000,1285.333,72
"13728","39343","2021",1,1,0,80000,1290,62
"13729","39344","2021",2,2,0,162325,1837,88.5
"13730","39345","2021",4,4,0,192362.5,1646.75,120.75
"13731","39346","2021",1,1,0,51000,425,120
"13732","39348","2021",8,8,0,143812.5,1339.25,117.25
"13733","39349","2021",4,4,0,335325,1667.25,198
"13734","39350","2021",11,11,0,149513.6,1521.909,99.72727
"13735","39351","2021",1,1,0,344500,3076,112
"13736","39352","2021",2,2,0,207250,1877,115.5
"13737","39353","2021",6,6,0,50983.33,1189.833,60.83333
"13738","39354","2021",5,4,1,155554,1324.6,122.2
"13739","39355","2021",3,1,2,98666.67,1146.667,87.33333
"13740","39356","2021",1,1,0,135000,1038,130
"13741","39359","2021",1,1,0,45000,381,118
"13742","39360","2021",2,2,0,172300,1049,164.5
"13743","39361","2021",2,2,0,131950,1507.5,87
"13744","39362","2021",49,36,13,148298.8,1642.571,90.67347
"13745","39363","2021",3,3,0,106000,721,135.6667
"13746","39364","2021",7,6,1,179171.4,1507.571,122
"13747","39365","2021",14,12,2,222667.2,1835.5,108.4286
"13748","39366","2021",2,2,0,31666.5,423,74
"13749","39367","2021",35,21,14,198778.1,2038.714,99.31429
"13750","39368","2021",84,19,65,101171,1251.429,81.42857
"13751","39370","2021",10,10,0,124572,1255.6,100.7
"13752","39373","2021",4,4,0,82387.25,1849.75,62
"13753","39375","2021",2,2,0,180750,1262,134.5
"13754","39377","2021",2,2,0,147000,1443.5,101.5
"13755","39378","2021",15,15,0,205848.3,1546.933,124.2667
"13756","39379","2021",9,9,0,154118.9,1453.667,101.4444
"13757","39381","2021",1,1,0,1e+05,704,142
"13758","39385","2021",10,10,0,108945,1328.4,86
"13759","39386","2021",2,2,0,132757,1033.5,122.5
"13760","39387","2021",1,1,0,184000,2453,75
"13761","39388","2021",5,5,0,156110,1658.2,93.2
"13762","39389","2021",11,8,3,164718.2,1614.909,101.6364
"13763","39390","2021",2,2,0,176350,1585.5,115
"13764","39391","2021",4,2,2,142095,1046,136.75
"13765","39392","2021",1,1,0,80000,667,120
"13766","39393","2021",2,2,0,169200,1071,151.5
"13767","39394","2021",1,1,0,193500,2449,79
"13768","39396","2021",13,11,2,108153.8,1321.615,79.76923
"13769","39397","2021",20,17,3,167382.5,1728.2,107.25
"13770","39398","2021",9,9,0,175822.2,1556.778,119
"13771","39399","2021",3,3,0,134950,1291.667,108.6667
"13772","39400","2021",3,3,0,139066.7,1567.667,94.66667
"13773","39401","2021",2,2,0,96000,1082,86.5
"13774","39402","2021",7,6,1,157592.9,1771.857,92.28571
"13775","39403","2021",4,4,0,160625,1859.5,92.5
"13776","39404","2021",6,1,5,58000,594.8333,95.33333
"13777","39405","2021",6,6,0,146908.3,1297,115.5
"13778","39406","2021",2,2,0,227480,2206,106.5
"13779","39407","2021",7,7,0,125828.6,874.7143,146.1429
"13780","39409","2021",3,3,0,68333.33,654.3333,92.33333
"13781","39411","2021",28,23,5,162594.6,1643.964,100.4643
"13782","39412","2021",5,5,0,151000,1505.8,108
"13783","39413","2021",6,5,1,306000,2751,104.5
"13784","39415","2021",11,11,0,146759.1,1672.909,90.18182
"13785","39418","2021",2,2,0,74209,718,103.5
"13786","39420","2021",5,5,0,103400,1036.4,100
"13787","39421","2021",3,3,0,273166.7,2026,132.6667
"13788","39422","2021",3,3,0,220673.3,1616,138
"13789","39424","2021",1,1,0,106500,1805,59
"13790","39425","2021",1,1,0,45000,341,132
"13791","39426","2021",8,8,0,148618.8,1212,122.625
"13792","39427","2021",1,1,0,50000,500,100
"13793","39429","2021",5,5,0,149200,1723.4,95.4
"13794","39430","2021",4,4,0,106150,1120.75,95.5
"13795","39432","2021",2,2,0,154975,1245.5,122
"13796","39434","2021",36,26,10,133237.5,1572.056,98.80556
"13797","39435","2021",11,10,1,138100.9,1186.273,126.7273
"13798","39436","2021",3,3,0,124333.3,1388.667,83.33333
"13799","39437","2021",2,1,1,140000,1553,90
"13800","39439","2021",10,10,0,143830,1223.9,115.7
"13801","39441","2021",51,11,40,158944.5,2888.941,50.7451
"13802","39443","2021",3,3,0,129633.3,1218.667,111.6667
"13803","39445","2021",1,1,0,110000,1019,108
"13804","39446","2021",1,1,0,143000,1233,116
"13805","39447","2021",3,3,0,149333.3,916,165
"13806","39448","2021",5,5,0,176610,1815.4,99
"13807","39449","2021",2,2,0,133549,1150,132
"13808","39451","2021",4,4,0,175150,1665.25,110.5
"13809","39452","2021",16,14,2,185953.1,1665.562,123.375
"13810","39453","2021",8,8,0,189281.2,1499.25,127.375
"13811","39454","2021",1,1,0,25000,385,65
"13812","39456","2021",2,2,0,98247,1024,98
"13813","39458","2021",2,2,0,138050,1164.5,108
"13814","39460","2021",5,5,0,141970.2,1244.8,140.2
"13815","39461","2021",1,1,0,162000,1266,128
"13816","39462","2021",7,7,0,185456.4,2344.429,90.71429
"13817","39463","2021",7,7,0,219714.3,1919.429,116.2857
"13818","39464","2021",5,5,0,178900,1533.6,108.8
"13819","39465","2021",2,2,0,216000,1563,124.5
"13820","39466","2021",1,1,0,80000,860,93
"13821","39467","2021",1,1,0,220000,1164,189
"13822","39468","2021",3,3,0,161333.3,1481.333,120.6667
"13823","39469","2021",1,1,0,218400,1933,113
"13824","39470","2021",27,4,23,153774.8,2883.037,64.55556
"13825","39471","2021",10,9,1,170339,1497.5,123.5
"13826","39472","2021",6,6,0,106766.7,1079.667,89.5
"13827","39474","2021",7,6,1,211428.6,1798.714,115.5714
"13828","39475","2021",31,29,2,133958.7,1261.806,104.3548
"13829","39476","2021",23,23,0,140228.3,1533.87,94.34783
"13830","39477","2021",2,2,0,79000,894,88.5
"13831","39478","2021",102,25,77,85783.56,1028.382,81.7451
"13832","39479","2021",3,3,0,157000,1758.333,85
"13833","39480","2021",1,1,0,171500,1559,110
"13834","39481","2021",1,1,0,162000,1296,125
"13835","39485","2021",21,21,0,102151.5,993.4286,105.2381
"13836","39486","2021",2,2,0,213175,1904,113.5
"13837","39487","2021",33,20,13,172833.5,2152.636,85.18182
"13838","39489","2021",7,7,0,117371.4,1136.857,99.57143
"13839","39490","2021",3,3,0,123666.7,1170,113.3333
"13840","39491","2021",18,13,5,146172.5,1462.667,104.0556
"13841","39492","2021",4,4,0,147350,1145,128
"13842","39494","2021",1,1,0,1e+05,1389,72
"13843","39498","2021",7,7,0,185592.9,1715.429,109.7143
"13844","39499","2021",6,6,0,195303.3,1421.833,143.1667
"13845","39500","2021",36,15,21,106287.8,1120,87.97222
"13846","39501","2021",13,10,3,171824.2,1792.385,98
"13847","39502","2021",3,3,0,148433.3,1426.333,102.6667
"13848","39503","2021",2,0,2,103250,1228.5,85.5
"13849","39504","2021",4,4,0,163750,1734.25,96
"13850","39505","2021",3,3,0,122973.3,1312.667,92.33333
"13851","39507","2021",1,1,0,150000,1163,129
"13852","39508","2021",18,18,0,146077.8,1319.389,113.7222
"13853","39510","2021",11,10,1,245886.4,2771.818,103.0909
"13854","39512","2021",3,3,0,104333.3,1220.667,79.66667
"13855","39513","2021",6,6,0,159266.7,1819.167,97.83333
"13856","39514","2021",2,2,0,130000,1196.5,106.5
"13857","39517","2021",1,1,0,169100,1551,109
"13858","39518","2021",1,1,0,145000,1986,73
"13859","39519","2021",3,3,0,202460,2224.667,94
"13860","39520","2021",11,11,0,199854.5,1574.182,136.0909
"13861","39522","2021",2,1,1,64950,691,130.5
"13862","39523","2021",3,3,0,158283.3,1730.333,97.33333
"13863","39525","2021",8,8,0,143312.5,1155.125,131
"13864","39526","2021",57,48,9,137890.4,1499.07,94.40351
"13865","39527","2021",4,4,0,215825,1905,125.75
"13866","39528","2021",4,4,0,137000,1217.5,123.25
"13867","39529","2021",2,2,0,83450,790.5,107.5
"13868","39530","2021",21,20,1,126590.5,1680.81,81.47619
"13869","39531","2021",2,2,0,132787,1194,118.5
"13870","39532","2021",1,1,0,140000,2222,63
"13871","39533","2021",6,6,0,128166.7,1354.5,102.3333
"13872","39534","2021",5,5,0,174966,2271.4,80.8
"13873","39535","2021",5,5,0,152084,1592,95
"13874","39537","2021",8,8,0,153227.5,1367.875,115.625
"13875","39538","2021",4,4,0,120312.5,957.25,139
"13876","39539","2021",1,1,0,90000,1169,77
"13877","39540","2021",3,3,0,138333.3,1367.667,115
"13878","39543","2021",3,3,0,143650.7,865.3333,166.3333
"13879","39545","2021",1,1,0,238870,1257,190
"13880","39546","2021",7,7,0,142074.3,1361.429,107.2857
"13881","39547","2021",3,3,0,238333.3,2045.667,117.3333
"13882","39548","2021",3,3,0,197566.7,1681,114
"13883","39550","2021",1,1,0,135000,2015,67
"13884","39551","2021",6,6,0,72500,769.3333,95.33333
"13885","39552","2021",5,5,0,136740,1381.6,98.8
"13886","39557","2021",4,4,0,135125,1386.5,102.25
"13887","39558","2021",1,1,0,107000,892,120
"13888","39559","2021",10,10,0,135549.8,1202,106.6
"13889","39560","2021",6,4,2,132100,1533.167,80.5
"13890","39561","2021",7,6,1,131962.9,1464.571,89.14286
"13891","39565","2021",1,1,0,80000,825,97
"13892","39567","2021",3,3,0,202483.3,1674.333,121.3333
"13893","39568","2021",1,1,0,309500,1223,253
"13894","39569","2021",6,6,0,113450,1202.5,99.66667
"13895","39570","2021",7,7,0,185157.1,1518.429,118.4286
"13896","39571","2021",2,2,0,269350,1827,199.5
"13897","39572","2021",7,7,0,208200,1706.429,124.4286
"13898","39573","2021",13,10,3,156438.5,1682.615,91.46154
"13899","39574","2021",7,7,0,114371.4,1228.286,98.57143
"13900","39576","2021",14,13,1,148011.4,1337.143,103.8571
"13901","39577","2021",8,8,0,137473.8,1437.25,95
"13902","39579","2021",9,9,0,202330.6,1867.333,109.3333
"13903","39581","2021",4,3,1,137137.5,1356.25,111.75
"13904","39582","2021",8,8,0,148502.5,1559.25,100.375
"13905","39583","2021",5,5,0,104320,1145.4,93.8
"13906","39584","2021",2,2,0,236800,1705,136.5
"13907","39586","2021",1,1,0,229000,2290,100
"13908","40001","2021",146,111,35,132672.4,1492.068,90.25342
"13909","40002","2021",11,9,2,175083.3,1595.455,113
"13910","40003","2021",1,1,0,80000,2000,40
"13911","40004","2021",31,21,10,459890.6,4282.484,105.7419
"13912","40005","2021",2,2,0,50000,359,140
"13913","40006","2021",6,6,0,211233.3,2015.167,106.3333
"13914","40007","2021",2,2,0,96075,1386,64
"13915","40008","2021",1,1,0,150000,2083,72
"13916","40011","2021",4,4,0,156068.8,1576,95.75
"13917","40012","2021",6,6,0,292500,2545.167,103.6667
"13918","40013","2021",2,2,0,150000,1113.5,140
"13919","40014","2021",6,6,0,208280,1814,115.8333
"13920","40015","2021",2,2,0,57160,1128,48
"13921","40016","2021",6,6,0,140589.7,1446.667,101.8333
"13922","40017","2021",3,3,0,116000,1050.667,112.6667
"13923","40018","2021",8,8,0,182833.8,2019.75,114.875
"13924","40019","2021",52,28,24,167453.7,2504.404,69.92308
"13925","40020","2021",12,12,0,177170.8,1551.583,115.5833
"13926","40021","2021",24,23,1,291775.1,3404.292,81.16667
"13927","40022","2021",6,6,0,235658.3,1867.833,127.6667
"13928","40023","2021",6,6,0,138148.3,1222.167,132.3333
"13929","40024","2021",8,8,0,188831.2,1375,139.25
"13930","40025","2021",9,9,0,182166.9,1746,105.6667
"13931","40026","2021",3,3,0,239183.3,2518,100
"13932","40027","2021",2,2,0,117500,916,119
"13933","40028","2021",5,5,0,175775.6,1610,112.8
"13934","40029","2021",9,9,0,128387.7,1243.444,106.7778
"13935","40031","2021",19,19,0,175017.8,1953.684,90.63158
"13936","40032","2021",3,3,0,190000,1874,105
"13937","40033","2021",2,2,0,187750,1531,140
"13938","40034","2021",6,6,0,317333.3,2675.667,114.8333
"13939","40035","2021",5,5,0,251730,2094.4,122
"13940","40036","2021",70,43,27,282982,3425.357,85.65714
"13941","40037","2021",36,36,0,229407.6,1994.25,118.7778
"13942","40038","2021",3,3,0,252251.3,1747.333,140.3333
"13943","40039","2021",5,5,0,176464,1615.2,104.6
"13944","40040","2021",3,3,0,258342,2669.333,101.3333
"13945","40042","2021",8,8,0,292491.5,3024,98.875
"13946","40043","2021",39,33,6,171736.1,2266.077,78.05128
"13947","40044","2021",10,10,0,368217.3,2600.6,152.3
"13948","40046","2021",523,301,222,303799.6,3857.163,82.04207
"13949","40047","2021",1,1,0,320000,1778,180
"13950","40049","2021",6,6,0,172645,1612.5,108.5
"13951","40050","2021",1,1,0,150000,1596,94
"13952","40051","2021",6,6,0,218600,2072.167,105.3333
"13953","40052","2021",4,4,0,159360,1505.5,116.5
"13954","40053","2021",7,7,0,191900,1847.143,104.5714
"13955","40054","2021",3,3,0,99350,841.3333,120.3333
"13956","40055","2021",25,25,0,265324,2156.12,125.64
"13957","40056","2021",12,11,1,184860.3,1711.833,108.8333
"13958","40057","2021",9,9,0,131645.1,1738.333,103
"13959","40058","2021",1,1,0,181000,1534,118
"13960","40059","2021",12,11,1,227943.8,2203.167,106.75
"13961","40060","2021",5,5,0,162400,1298.8,138.4
"13962","40061","2021",19,18,1,217781.1,2036.842,112.1053
"13963","40062","2021",8,8,0,201976.1,1950.75,102.375
"13964","40063","2021",16,16,0,273840.6,2140.312,130.875
"13965","40064","2021",2,2,0,211000,1873.5,113.5
"13966","40065","2021",389,154,235,367221.8,6079.265,62.44216
"13967","40066","2021",7,7,0,146367.1,1327,107.5714
"13968","40067","2021",9,8,1,178277.8,1527.111,114.6667
"13969","40068","2021",24,19,5,182548.3,1844.125,99.33333
"13970","40069","2021",3,3,0,155000,1887.333,89.33333
"13971","40070","2021",3,3,0,156333.3,1084,155.6667
"13972","40071","2021",6,6,0,172115.8,1548.667,113.8333
"13973","40072","2021",3,3,0,223636,1092,200.6667
"13974","40073","2021",1,1,0,2e+05,870,230
"13975","40074","2021",10,10,0,198873,1739.5,116.1
"13976","40075","2021",42,39,3,221393.4,2278.19,97.64286
"13977","40076","2021",6,6,0,154600,1424.333,109.5
"13978","40077","2021",18,18,0,213563.1,1851.333,116.3889
"13979","40078","2021",3,3,0,153771.7,1626,116
"13980","40079","2021",3,3,0,127500,892.6667,164.3333
"13981","40080","2021",29,29,0,147228.1,1437.862,112.5517
"13982","40081","2021",7,7,0,217857.1,2173.714,100.7143
"13983","40082","2021",4,4,0,152625,1800.5,85.5
"13984","40083","2021",2,2,0,192250,1684.5,117
"13985","40084","2021",17,17,0,223548.7,1955.824,117.0588
"13986","40085","2021",12,12,0,250826.7,2026.917,121.5833
"13987","40086","2021",3,3,0,261666.7,2142.667,125
"13988","40087","2021",5,5,0,152900,1484.2,105
"13989","40088","2021",600,203,397,151014.4,2321.985,65.975
"13990","40089","2021",9,9,0,151656.9,1196.556,130.7778
"13991","40090","2021",3,3,0,159122,1385.333,109.3333
"13992","40091","2021",6,6,0,142808.3,1519.5,91
"13993","40092","2021",5,5,0,151240,1505,98.4
"13994","40093","2021",2,2,0,171870,1667,100.5
"13995","40094","2021",13,13,0,174564.8,1716.538,106.3846
"13996","40095","2021",11,10,1,220500,1625.636,133.6364
"13997","40096","2021",1,1,0,76000,1013,75
"13998","40097","2021",13,6,7,117387.3,1991.231,66.84615
"13999","40098","2021",4,4,0,149775,1052.25,153
"14000","40099","2021",5,5,0,227590,1770.2,128.2
"14001","40100","2021",10,10,0,152965,1476.1,102.4
"14002","40101","2021",7,7,0,211029,1686.143,136.2857
"14003","40102","2021",24,24,0,125855,1190.625,105.7917
"14004","40103","2021",10,10,0,218470,1869.9,130.6
"14005","40104","2021",27,27,0,229214.7,1937,120.6296
"14006","40105","2021",9,8,1,194155.6,1665.667,127.5556
"14007","40106","2021",2,2,0,321950,2114,158.5
"14008","40108","2021",14,14,0,239526.3,2686.786,89.57143
"14009","40109","2021",3,3,0,183566.7,1103.667,155.6667
"14010","40110","2021",9,9,0,122010,1254.222,110.5556
"14011","40111","2021",12,12,0,197171.6,1831.167,109.3333
"14012","40112","2021",2,2,0,145500,1167.5,138.5
"14013","40113","2021",8,8,0,229081.9,1927.25,122
"14014","40114","2021",7,7,0,293287.1,2240.857,135
"14015","40115","2021",5,5,0,126400,1220.6,104.4
"14016","40116","2021",4,4,0,161125,1581.75,104.75
"14017","40117","2021",34,32,2,160827.2,1605.206,102.2941
"14018","40118","2021",17,15,2,183050,1696.294,116.4118
"14019","40119","2021",85,82,3,156001.1,1523.047,107.4
"14020","40120","2021",9,9,0,294318.8,2135.667,141
"14021","40121","2021",7,7,0,123785.7,1353,88.71429
"14022","40122","2021",10,10,0,183135,1677.9,106.9
"14023","40123","2021",14,14,0,319838.1,2753.5,117.5714
"14024","40124","2021",6,6,0,205305,1841.5,142.8333
"14025","40125","2021",13,11,2,284066.9,2869.769,102.8462
"14026","40126","2021",42,41,1,195889.9,2091.714,94.16667
"14027","40127","2021",10,10,0,156475,1536.7,97
"14028","40128","2021",5,5,0,204232,1766,118.2
"14029","40129","2021",12,12,0,319617.8,2621.75,123.9167
"14030","40131","2021",12,11,1,128150,1172.083,106.75
"14031","40132","2021",20,19,1,199099.1,1846.15,110.45
"14032","40133","2021",133,97,36,376203.2,4232.105,90.03759
"14033","40134","2021",35,35,0,199733.3,2103.6,97.42857
"14034","40135","2021",13,12,1,151230.8,1497.077,105.6154
"14035","40136","2021",3,3,0,215268.3,1569.333,142.6667
"14036","40137","2021",4,4,0,215625,1758,130.75
"14037","40138","2021",3,3,0,158600,1402.667,113.6667
"14038","40139","2021",13,13,0,225459.2,1656.077,139.2308
"14039","40140","2021",2,2,0,210600,1553,136.5
"14040","40141","2021",4,4,0,244600,2119.25,107.25
"14041","40142","2021",19,19,0,190911.6,1865.684,108.6316
"14042","40143","2021",1,1,0,228849,1658,138
"14043","40144","2021",3,3,0,249666.7,2075.667,115.6667
"14044","40145","2021",14,14,0,163690.1,1338.071,128.7857
"14045","40146","2021",2,2,0,107500,1066,107.5
"14046","40147","2021",5,5,0,141547,1831.8,86.2
"14047","40148","2021",1,1,0,102000,1020,100
"14048","40149","2021",7,7,0,158895.7,1722.857,91.28571
"14049","40150","2021",60,37,23,257786.7,3086.633,77.4
"14050","40151","2021",4,4,0,187975,1850,103.5
"14051","40152","2021",16,16,0,210353.1,1822.5,115.5
"14052","40153","2021",4,4,0,234870.2,1641.75,146.5
"14053","40154","2021",4,4,0,218250,3468.25,80
"14054","40155","2021",45,42,3,262879,2562.8,105.1111
"14055","40156","2021",4,4,0,273122.5,2414.25,115.5
"14056","40157","2021",55,32,23,250123.5,2797.2,82.14545
"14057","40158","2021",3,3,0,92933.33,1014.333,98.33333
"14058","40159","2021",11,10,1,181948.5,2042.545,90.72727
"14059","40160","2021",2,2,0,323500,2075,163
"14060","40161","2021",4,4,0,145691.2,1322.5,120
"14061","40162","2021",11,11,0,181545.5,1606.273,113.6364
"14062","40163","2021",13,13,0,265878.8,2351.615,109.9231
"14063","40164","2021",4,4,0,139075,1105,136.5
"14064","40165","2021",9,9,0,194337.8,1806.667,114.2222
"14065","40167","2021",9,9,0,123111.1,1232.889,100.5556
"14066","40168","2021",31,29,2,324081.2,2910.806,110.3871
"14067","40169","2021",1,1,0,118000,825,143
"14068","40170","2021",4,4,0,300250,1961,144
"14069","40171","2021",3,3,0,194683,1867.333,100.3333
"14070","40172","2021",5,5,0,218750,1726.8,129.8
"14071","40175","2021",7,7,0,174285.7,1462.143,115.4286
"14072","40177","2021",3,3,0,216666.7,1775,124.3333
"14073","40178","2021",9,9,0,267080,1925.222,141.3333
"14074","40179","2021",29,26,3,318515.5,2683.31,115.0345
"14075","40180","2021",16,16,0,204064.1,1685.688,130.125
"14076","40181","2021",31,30,1,417006.4,4595.806,96.87097
"14077","40182","2021",17,17,0,256656.2,2441.235,104.8824
"14078","40183","2021",14,14,0,279947,2035.429,145.4286
"14079","40184","2021",262,149,113,218594.2,3326.817,71.44656
"14080","40185","2021",4,4,0,151725,1250.25,119.75
"14081","40186","2021",9,9,0,177055.6,1666,112.4444
"14082","40187","2021",174,77,97,251983.6,4301.006,58.1954
"14083","40188","2021",6,6,0,169971.8,1227.5,143.5
"14084","40190","2021",1,1,0,188000,1607,117
"14085","40191","2021",8,8,0,153933.4,1235.5,127.25
"14086","40192","2021",556,324,232,164518.1,2059.878,81.14928
"14087","40193","2021",1,1,0,161000,1193,135
"14088","40194","2021",33,32,1,175443,1543.242,118.697
"14089","40195","2021",8,8,0,132897.6,1229,110.875
"14090","40196","2021",13,13,0,150153.5,1361.231,113.5385
"14091","40197","2021",76,75,1,169385.7,1786.368,100.8158
"14092","40198","2021",6,6,0,125241.7,1151.167,109
"14093","40199","2021",2,2,0,181500,1720.5,109.5
"14094","40200","2021",9,9,0,318431.1,3038.333,119.4444
"14095","40201","2021",11,11,0,160565,1515,107.0909
"14096","40202","2021",44,41,3,244366.8,2358.205,107.7045
"14097","40203","2021",8,8,0,118954.9,1195.5,100.375
"14098","40204","2021",4,4,0,176350.2,1503.25,121.5
"14099","40205","2021",6,5,1,173983.3,1585.167,113.6667
"14100","40206","2021",8,8,0,209404.4,2074.375,106.875
"14101","40207","2021",15,15,0,263550.7,2517.533,108
"14102","40208","2021",7,7,0,176878.6,1456,127.2857
"14103","40209","2021",103,56,47,317681.1,3901.379,82.35922
"14104","40210","2021",22,22,0,232693.6,2567.136,90.77273
"14105","40211","2021",12,12,0,266837.5,2383.583,112.9167
"14106","40212","2021",17,17,0,225017.6,2194.765,113.5294
"14107","40213","2021",5,4,1,380350,2622.6,159.2
"14108","40214","2021",8,8,0,180957.5,1672,120.625
"14109","40215","2021",5,5,0,386850.4,1907,202
"14110","40216","2021",3,3,0,100166.7,1050.333,97.33333
"14111","40217","2021",165,132,33,247622.4,2802.636,89.33333
"14112","40218","2021",9,9,0,151611.1,1291.222,122.8889
"14113","40220","2021",3,3,0,237708.3,2273.333,104.3333
"14114","40221","2021",1,1,0,160000,899,178
"14115","40222","2021",7,7,0,302123.6,2018.143,146.2857
"14116","40223","2021",3,3,0,159300,982,182.6667
"14117","40224","2021",72,56,16,206261.8,2062.153,103.2361
"14118","40225","2021",1,1,0,179075,1279,140
"14119","40227","2021",15,15,0,200620,2068.2,101.6667
"14120","40228","2021",24,22,2,185550,1689.083,115.5
"14121","40229","2021",23,23,0,307716.5,2550.696,120.6957
"14122","40230","2021",49,46,3,200042.6,1948.327,103.3265
"14123","40231","2021",21,21,0,284020,2487.286,121.7619
"14124","40232","2021",5,5,0,183448,1841,109.8
"14125","40233","2021",43,43,0,221398.6,1939.605,118.7209
"14126","40234","2021",18,18,0,151669.4,1479,104.1667
"14127","40235","2021",6,6,0,170325,1424.167,121.1667
"14128","40236","2021",11,11,0,173204.5,1683.909,103.0909
"14129","40237","2021",12,12,0,199667.7,1855.833,111.1667
"14130","40238","2021",14,14,0,209282.2,1913.786,116.6429
"14131","40240","2021",7,7,0,149486.4,1359.714,117.1429
"14132","40243","2021",60,55,5,188619.1,1830.917,107.3667
"14133","40244","2021",18,18,0,276365.4,2412,116.7222
"14134","40245","2021",38,36,2,128698.6,1440.632,92.84211
"14135","40246","2021",22,22,0,224806.8,1897.409,124.3182
"14136","40248","2021",26,23,3,366550.3,3505.654,106.2308
"14137","40249","2021",8,8,0,167222,1611.75,102.125
"14138","40250","2021",7,7,0,240885.7,2252,114.8571
"14139","40251","2021",3,3,0,504373.3,2792.667,191
"14140","40252","2021",10,10,0,170942.6,1542.3,117.8
"14141","40253","2021",8,8,0,117000,1121.75,112.625
"14142","40254","2021",6,6,0,176685.5,2272.167,84.5
"14143","40255","2021",4,4,0,224075,2171.25,102
"14144","40256","2021",9,8,1,321111.1,2968.111,123.1111
"14145","40257","2021",31,31,0,249709.7,2550.097,104.3548
"14146","40258","2021",6,6,0,178442.5,1573.5,111.6667
"14147","40259","2021",3,3,0,113433.3,1157.333,93
"14148","40260","2021",13,13,0,186430.8,1970.846,105.5385
"14149","40261","2021",39,38,1,314928.3,3070.538,105.3846
"14150","40262","2021",5,5,0,127310,1181.4,108.8
"14151","40263","2021",5,5,0,129000,1131.2,114.8
"14152","40264","2021",18,17,1,423052.8,3084.167,139.6111
"14153","40265","2021",2,2,0,182350,1166.5,139.5
"14154","40266","2021",46,34,12,257837,3250.891,86.34783
"14155","40267","2021",8,7,1,137639,1202.875,117.625
"14156","40268","2021",11,11,0,357293.6,2877.909,122.6364
"14157","40269","2021",16,16,0,336671.2,2294.562,155.5
"14158","40270","2021",11,11,0,140490.9,1280.273,115.9091
"14159","40271","2021",14,14,0,291126.4,2645.429,113.5
"14160","40272","2021",30,19,11,306516.7,3127.9,93.06667
"14161","40273","2021",90,53,37,328672,3237.589,107.8889
"14162","40274","2021",25,25,0,189330.2,1738.24,108.08
"14163","40275","2021",8,8,0,191225.8,2124,92
"14164","40276","2021",4,4,0,380375,3426.25,113.25
"14165","40277","2021",4,4,0,289472.5,1895,167
"14166","40278","2021",14,13,1,218042.9,2295.643,99.14286
"14167","40279","2021",314,162,152,188615,2383.631,80.39172
"14168","40280","2021",39,17,22,125129.8,1785.692,69.17949
"14169","40281","2021",203,115,88,158022.2,2017.527,78.98522
"14170","40282","2021",104,83,21,156631,1667.442,97.11538
"14171","40283","2021",51,38,13,220007.1,2321.02,92.90196
"14172","40284","2021",178,90,88,232285,3036.365,77.85955
"14173","40285","2021",16,16,0,200528.1,1514.5,140.9375
"14174","40286","2021",7,7,0,212854.3,1558,142.8571
"14175","40287","2021",96,81,15,361007.8,3693.906,102.2708
"14176","40288","2021",21,21,0,159405,1629.714,98.19048
"14177","40289","2021",3,3,0,206613.3,2114,106
"14178","40290","2021",1,1,0,2e+05,1739,115
"14179","40291","2021",21,19,2,355245.2,3917.381,89.95238
"14180","40292","2021",28,28,0,406474.5,3365.286,127.6429
"14181","40293","2021",19,19,0,293929.8,2814.579,111.2105
"14182","40294","2021",23,23,0,261286.1,2119.261,124.4783
"14183","40295","2021",19,18,1,257086.8,2403.474,111.8947
"14184","40296","2021",245,78,167,358257.9,5489,61.26939
"14185","40297","2021",2,2,0,114500,1218,97
"14186","40298","2021",10,10,0,186950,1576.1,129.8
"14187","40299","2021",1,1,0,35000,376,93
"14188","40300","2021",13,12,1,255811.5,2532.846,102.9231
"14189","40301","2021",4,4,0,230055,2099.25,113.75
"14190","40303","2021",5,5,0,200344.4,1876,122
"14191","40304","2021",165,88,77,741950,7395.994,97.52727
"14192","40305","2021",3,3,0,136733.3,1507,94.66667
"14193","40306","2021",12,12,0,214179.3,1693.667,130.3333
"14194","40307","2021",27,26,1,203577.8,1877.593,114.7778
"14195","40308","2021",9,9,0,228469.4,1953.889,118.1111
"14196","40309","2021",14,14,0,163993.6,1503,102.7143
"14197","40310","2021",249,177,72,275993,3579.562,77.93976
"14198","40311","2021",10,9,1,208096.2,1918.3,107.7
"14199","40312","2021",202,90,112,276556.7,3538.248,79.87624
"14200","40313","2021",56,47,9,149203.6,1651.464,98.60714
"14201","40314","2021",11,10,1,259704.1,2279.818,118.3636
"14202","40315","2021",8,8,0,200695.9,1736.5,140.5
"14203","40316","2021",13,13,0,131935.6,1333,108.3077
"14204","40317","2021",66,61,5,428986.4,4127.061,104.8939
"14205","40318","2021",2,2,0,180550,1837.5,99.5
"14206","40319","2021",4,4,0,212425,2271.25,98.25
"14207","40320","2021",13,13,0,243940.5,1999.692,128.6923
"14208","40321","2021",3,3,0,99500,1040,86.33333
"14209","40322","2021",2,2,0,169357.5,2371.5,71
"14210","40323","2021",3,3,0,221949.7,3372.667,90
"14211","40324","2021",4,4,0,255875,1418.25,170.5
"14212","40325","2021",5,5,0,123904.6,911.6,135
"14213","40326","2021",45,38,7,317470.6,3177.933,101.1778
"14214","40327","2021",3,3,0,218260,1429,150.6667
"14215","40328","2021",147,45,102,243022.2,4801.204,52.38095
"14216","40329","2021",9,9,0,152213.9,1384.889,108
"14217","40330","2021",6,6,0,194550,1633.5,123.1667
"14218","40331","2021",38,36,2,164516.1,1540.526,108.2632
"14219","40332","2021",40,40,0,238919,2696.025,90.4
"14220","40333","2021",17,17,0,152669.4,1557.176,95.47059
"14221","40334","2021",8,8,0,203915,1923.25,106.5
"14222","41001","2021",7,7,0,148392.9,1238.143,126
"14223","41002","2021",16,16,0,126161.6,1270.125,102.5
"14224","41003","2021",5,5,0,137720,1067.2,133.4
"14225","41004","2021",7,7,0,101445.7,1316,88.28571
"14226","41006","2021",9,9,0,116388.9,1207.111,96.33333
"14227","41007","2021",19,18,1,114188.2,1157.421,96.42105
"14228","41008","2021",8,7,1,88543.75,1224.375,73.875
"14229","41009","2021",12,12,0,161863.5,1544.583,104.9167
"14230","41010","2021",11,11,0,201227.3,1642.455,119.9091
"14231","41012","2021",5,5,0,143600,1403.4,110.8
"14232","41013","2021",4,4,0,225112.5,2196.5,101
"14233","41014","2021",3,3,0,55000,980.3333,62.33333
"14234","41016","2021",26,25,1,146781.6,1353.346,109.1154
"14235","41017","2021",18,18,0,133752.8,1502.111,95.16667
"14236","41018","2021",778,272,506,133041.4,1764.918,76.34319
"14237","41019","2021",1,1,0,103000,1537,67
"14238","41020","2021",12,12,0,80705.83,856.3333,95.33333
"14239","41022","2021",5,5,0,129370,1448.2,107.2
"14240","41024","2021",7,7,0,129128.6,998,133.4286
"14241","41025","2021",25,25,0,148835.2,1474.84,105
"14242","41026","2021",2,2,0,31500,734.5,64
"14243","41027","2021",3,3,0,185349.3,1454,123.6667
"14244","41028","2021",10,10,0,153075,1466.4,103
"14245","41029","2021",14,14,0,136380,1479.643,95.28571
"14246","41030","2021",3,3,0,96833.33,924.6667,105.3333
"14247","41031","2021",29,29,0,220684.5,1998.379,112.5862
"14248","41032","2021",33,31,2,169776.9,1613.788,103.2727
"14249","41035","2021",6,6,0,130666.7,1397,91
"14250","41036","2021",9,9,0,143777.8,1311.556,119.4444
"14251","41037","2021",4,4,0,129800,1241.5,103.5
"14252","41038","2021",7,7,0,107935.7,1327.571,85.42857
"14253","41039","2021",7,7,0,115606.9,1119.429,104.8571
"14254","41040","2021",9,9,0,165222.2,1694,97.88889
"14255","41041","2021",6,6,0,67912.33,785,91.16667
"14256","41042","2021",8,8,0,49125,712.375,67.375
"14257","41043","2021",40,40,0,105249.4,1177.3,90.725
"14258","41044","2021",18,18,0,88272.22,970.6667,88.66667
"14259","41045","2021",16,15,1,146490,1624.938,95.9375
"14260","41046","2021",10,10,0,192569.2,1624.8,121.9
"14261","41047","2021",84,51,33,160625.8,1872.476,87.36905
"14262","41048","2021",8,8,0,72689.38,766.875,92.875
"14263","41049","2021",11,11,0,135977.5,1313.545,102
"14264","41050","2021",21,21,0,207195,1956.429,108.9048
"14265","41051","2021",17,17,0,195135.3,1539.118,125.4706
"14266","41052","2021",11,11,0,223100.7,2200.182,107.5455
"14267","41053","2021",15,15,0,107300,995.2,108.7333
"14268","41054","2021",8,8,0,147418.8,1551.5,100
"14269","41055","2021",48,48,0,176107.2,1706.854,103.0833
"14270","41057","2021",6,6,0,141750,1265.333,111.6667
"14271","41058","2021",2,2,0,218250,1241,175.5
"14272","41059","2021",99,98,1,163452,1629.828,104.0202
"14273","41060","2021",14,13,1,59113.57,763.2143,77.28571
"14274","41061","2021",29,29,0,204817.4,1741.931,125.8621
"14275","41062","2021",7,7,0,140357.1,1241.857,107.1429
"14276","41063","2021",10,10,0,122528.7,1341.1,96
"14277","41065","2021",6,6,0,197708.3,1487.333,125.3333
"14278","41066","2021",13,8,5,121508.2,1174.385,110
"14279","41067","2021",52,51,1,193993.8,1902.538,104.4231
"14280","41068","2021",9,9,0,161772.2,1654.111,91.33333
"14281","41069","2021",3,3,0,151666.7,1381.667,126
"14282","41070","2021",20,20,0,128890,1148.5,105.65
"14283","41071","2021",8,8,0,142162.5,2193,78.625
"14284","41072","2021",4,4,0,156000,1206.5,111.5
"14285","41073","2021",14,14,0,122078.6,1207.571,103
"14286","41074","2021",14,14,0,137148.6,1430.643,94.14286
"14287","41075","2021",21,21,0,92137.86,1002.238,92.80952
"14288","41077","2021",2,2,0,65000,711.5,89.5
"14289","41078","2021",20,20,0,127939.2,1283.05,101.3
"14290","41079","2021",2,2,0,54000,1077.5,49
"14291","41080","2021",27,27,0,170138.9,1603.148,105.7778
"14292","41081","2021",4,4,0,172750,1214.25,132
"14293","41083","2021",11,10,1,118509.1,1218.182,96.18182
"14294","41084","2021",21,21,0,172743.7,1703.429,102.2857
"14295","41085","2021",19,19,0,162989.5,1578.474,114.7895
"14296","41086","2021",8,8,0,176075,1652,109.25
"14297","41087","2021",11,10,1,111845.5,1176.364,99
"14298","41088","2021",11,11,0,101431.8,1210.727,91.45455
"14299","41089","2021",5,5,0,123076.4,951,133.4
"14300","41090","2021",9,9,0,119088.9,1215.333,98.66667
"14301","41091","2021",21,21,0,180634.9,1793.476,102.0952
"14302","41093","2021",5,5,0,120620,1131,101.8
"14303","41094","2021",15,15,0,146240,1644.8,84.13333
"14304","41095","2021",22,22,0,96071.82,1154.5,85.81818
"14305","41096","2021",6,6,0,98062.5,1108.167,89
"14306","41097","2021",39,39,0,124950.1,1083.179,104.641
"14307","41098","2021",1,1,0,1e+05,769,130
"14308","41099","2021",6,6,0,163991.7,1583.833,98.66667
"14309","41100","2021",6,6,0,134916.7,1525.5,90.16667
"14310","41101","2021",22,21,1,142057.5,1592.727,95.45455
"14311","41102","2021",9,9,0,120347.2,1181.556,110.4444
"14312","41103","2021",6,6,0,133000,1204.167,121
"14313","41104","2021",46,44,2,169220.4,1733.804,99.65217
"14314","41105","2021",22,22,0,139723.9,1179,128.7727
"14315","41106","2021",64,64,0,143352.3,1660,91.6875
"14316","41107","2021",7,7,0,116000,1505.857,85.14286
"14317","41108","2021",2,2,0,182000,1435.5,128.5
"14318","41109","2021",6,6,0,141275,1072.5,127.1667
"14319","41110","2021",14,14,0,158407,1689.571,99.21429
"14320","41112","2021",5,5,0,186502,1449.2,135.2
"14321","41113","2021",14,14,0,197532.1,1796.357,103.0714
"14322","41114","2021",4,4,0,345450,1831.25,199.75
"14323","41115","2021",5,5,0,114952,1281.6,89.6
"14324","41116","2021",3,3,0,105166.7,693,146
"14325","41118","2021",7,7,0,279271.4,2682.571,108.8571
"14326","41119","2021",14,14,0,143660.7,1417.571,109
"14327","41120","2021",25,25,0,129238,1399.52,98.52
"14328","41122","2021",4,4,0,59500,815,78.25
"14329","41123","2021",16,16,0,104031.2,1190.062,86.1875
"14330","41124","2021",2,2,0,153500,1334.5,104
"14331","41125","2021",19,19,0,136995.5,1312.316,101.1053
"14332","41126","2021",22,22,0,113631.5,1141.409,103.4545
"14333","41127","2021",14,14,0,114759.3,1475.143,80.85714
"14334","41128","2021",11,11,0,136600,1526.182,92.81818
"14335","41129","2021",12,12,0,246318.3,1890.833,134
"14336","41130","2021",6,6,0,131116.7,1122.167,117
"14337","41131","2021",19,19,0,114453.2,1337.105,90.47368
"14338","41132","2021",3,3,0,103333.3,1234.667,72.66667
"14339","41134","2021",10,10,0,240350,1541.2,144.9
"14340","41135","2021",33,32,1,83915.15,1080.545,83.45455
"14341","41136","2021",98,89,9,132967.6,1544.122,87.78571
"14342","41137","2021",10,10,0,172530,1291.8,125.1
"14343","41138","2021",6,6,0,135671.7,1375.333,96.5
"14344","41139","2021",23,23,0,107272.6,1080.348,105.6522
"14345","41140","2021",18,18,0,120397.2,1213.222,103.3889
"14346","41141","2021",6,6,0,126000,1697.667,75.33333
"14347","41142","2021",33,33,0,198827.1,1860.576,116.7879
"14348","41143","2021",27,27,0,83748.15,952.8148,88.48148
"14349","41144","2021",9,9,0,116822.2,1286.222,89
"14350","41145","2021",10,10,0,110342.5,1353.9,85.8
"14351","41146","2021",21,21,0,165422.9,1417.19,110.381
"14352","41147","2021",26,26,0,170924,1686.654,105.9615
"14353","41148","2021",22,22,0,163227.7,1688.682,98.72727
"14354","41149","2021",87,82,5,125106,1221.793,102.3678
"14355","41150","2021",44,43,1,215556.4,1997.182,110.8182
"14356","41151","2021",103,82,21,126699.2,1503.592,82.19417
"14357","41152","2021",18,17,1,187486.1,1660.389,107.5
"14358","41153","2021",2,2,0,126500,906,128
"14359","41154","2021",23,23,0,114065.7,1228.261,94.21739
"14360","41155","2021",24,24,0,160729.2,1587.5,99.16667
"14361","41156","2021",6,6,0,197358.5,1758.667,113.5
"14362","41157","2021",23,23,0,173909.3,1962.522,113.5217
"14363","41158","2021",31,31,0,176906.1,1682.29,107.4839
"14364","41159","2021",24,24,0,212332.9,1987.125,107.625
"14365","41160","2021",5,5,0,130500,1459.4,90.8
"14366","41161","2021",35,35,0,132224.2,1479.4,92.65714
"14367","41163","2021",2,2,0,131500,1362.5,96.5
"14368","41164","2021",48,47,1,113126.2,1276.375,88.83333
"14369","41166","2021",4,4,0,79750,930.75,78.75
"14370","41167","2021",61,60,1,151580.9,1489.213,100.8197
"14371","41168","2021",6,6,0,79250,821.3333,89
"14372","41171","2021",24,24,0,103561.7,994.875,109.2917
"14373","41172","2021",4,4,0,69000,780,88.25
"14374","41173","2021",56,55,1,127562,1288.964,102.0357
"14375","41174","2021",7,7,0,167985.7,1470,121
"14376","41175","2021",25,25,0,93957.2,1212.44,83.2
"14377","41176","2021",23,23,0,117504.3,1428.087,84.04348
"14378","41177","2021",6,6,0,104916.7,1007.833,104.3333
"14379","41178","2021",1,1,0,156900,1890,83
"14380","41179","2021",4,4,0,100037.5,1486,73
"14381","41180","2021",3,3,0,75000,1025,65.33333
"14382","41181","2021",19,19,0,108178.9,1198.895,91.73684
"14383","41182","2021",10,10,0,144345,1320.9,116.4
"14384","41184","2021",10,10,0,168915.8,1673,106.9
"14385","41185","2021",39,39,0,150991.3,1295.744,113.4359
"14386","41186","2021",4,4,0,175250,885.5,171.5
"14387","41187","2021",5,5,0,170200,1639.4,116.8
"14388","41188","2021",2,2,0,123000,1253.5,105
"14389","41189","2021",5,5,0,118130,1118.4,97.8
"14390","41190","2021",4,4,0,126237.5,1573.75,78.5
"14391","41191","2021",2,2,0,132675,1380.5,95
"14392","41192","2021",7,7,0,98214.29,1297.714,74.71429
"14393","41193","2021",1,1,0,18000,333,54
"14394","41194","2021",310,282,28,133943.5,1401.158,94.78065
"14395","41195","2021",2,2,0,214361,1232,171
"14396","41196","2021",3,3,0,64833.33,978.3333,69.66667
"14397","41198","2021",58,52,6,110846.6,1198.586,89.67241
"14398","41199","2021",18,17,1,166450,2021.833,113.6667
"14399","41200","2021",9,9,0,212713.3,1710.111,125.7778
"14400","41201","2021",3,3,0,85666.67,1307.667,57.66667
"14401","41203","2021",7,7,0,187957.1,1563.571,119.5714
"14402","41204","2021",11,11,0,201476.4,1641.182,127.1818
"14403","41205","2021",2,2,0,82500,1023.5,84
"14404","41206","2021",12,12,0,270145,2079.583,125.3333
"14405","41207","2021",11,11,0,168909.1,1682.364,100
"14406","41208","2021",2,2,0,180000,1357.5,135.5
"14407","41209","2021",14,14,0,143549.3,1403.5,107.7857
"14408","41211","2021",52,51,1,191686,1767.192,105.7692
"14409","41212","2021",50,50,0,193432.2,2045.92,97.3
"14410","41213","2021",3,3,0,126666.7,1244,135.6667
"14411","41214","2021",7,7,0,95442.86,1242.571,77
"14412","41215","2021",4,4,0,99137.5,948.75,109.5
"14413","41216","2021",14,14,0,92705.71,1013.857,97.71429
"14414","41217","2021",20,20,0,152665.5,1628.25,94.5
"14415","41218","2021",6,6,0,107333.3,1204.167,96
"14416","41219","2021",6,6,0,126753.3,1508.167,92.16667
"14417","41220","2021",74,73,1,143444.4,1675.73,92.24324
"14418","41221","2021",8,8,0,76875,894.625,83.5
"14419","41222","2021",3,3,0,1e+05,1505.667,65.33333
"14420","41223","2021",19,19,0,201211.1,1649.105,117.5263
"14421","41224","2021",9,9,0,82116.67,894.8889,87.44444
"14422","41225","2021",8,8,0,131512.5,1248.125,108.25
"14423","41226","2021",44,43,1,171772,1607.068,109.4318
"14424","41228","2021",8,8,0,87485.88,975.5,89.125
"14425","41229","2021",26,26,0,153536.9,1501.769,110.1538
"14426","41230","2021",29,26,3,178658.1,1823.552,102.0345
"14427","41231","2021",14,14,0,191692.9,2732.786,92.92857
"14428","41232","2021",93,86,7,113420.5,1173.226,90.46237
"14429","41233","2021",14,14,0,154887.6,1233.429,121.5
"14430","41234","2021",3,3,0,144666.7,1264.333,120
"14431","41235","2021",23,23,0,134243.5,1228.174,113.087
"14432","41236","2021",3,3,0,170466.7,1488.333,116.3333
"14433","41237","2021",17,17,0,159718.6,1610.118,100.8235
"14434","41238","2021",45,44,1,97002.58,1081.511,94.28889
"14435","41239","2021",24,24,0,120708.8,1182.708,97.91667
"14436","41241","2021",27,27,0,135470.4,1303.037,104.1481
"14437","41242","2021",77,74,3,96865.4,1115.364,88.11688
"14438","41243","2021",14,14,0,111631.4,1143.714,97
"14439","41245","2021",7,7,0,157385.7,1392,116.4286
"14440","41246","2021",9,9,0,282644.4,2479.778,113.2222
"14441","41247","2021",20,20,0,143955.5,1667.45,93.3
"14442","41248","2021",35,35,0,100528.6,1091.971,94.45714
"14443","41249","2021",27,27,0,143916.7,1426.963,92.96296
"14444","41250","2021",9,9,0,112666.7,1077.111,101.4444
"14445","41251","2021",7,6,1,157485.7,1578.143,102.8571
"14446","41252","2021",27,27,0,151815.8,1689.37,92.74074
"14447","41253","2021",3,3,0,108500,1275.333,107.6667
"14448","41254","2021",2,2,0,68000,922,72.5
"14449","41255","2021",9,9,0,123763.1,1188.556,102
"14450","41256","2021",19,18,1,125395.8,1080.684,115.5789
"14451","41258","2021",14,13,1,145107.1,1501.929,99.35714
"14452","41259","2021",10,10,0,131350,1215.7,108.1
"14453","41260","2021",9,9,0,114144.4,1404.111,78.77778
"14454","41261","2021",4,4,0,129750,1476.25,90.75
"14455","41262","2021",12,12,0,251083.3,2129.583,112.6667
"14456","41265","2021",13,13,0,132838.5,1513.769,94.53846
"14457","41266","2021",1,1,0,77000,786,98
"14458","41267","2021",14,14,0,163696.4,1556.714,114.2857
"14459","41268","2021",2,2,0,208215,1421,174.5
"14460","41269","2021",267,164,103,145482.1,1675.288,83.72285
"14461","41271","2021",7,7,0,109677.1,1301.143,84.14286
"14462","41273","2021",16,16,0,106012.5,1309.25,84.5625
"14463","41274","2021",2,2,0,72500,917,75
"14464","41275","2021",17,16,1,109264.7,1265.882,91.94118
"14465","41276","2021",40,28,12,145429.5,1575.75,95.025
"14466","41278","2021",5,5,0,116700,1118.6,101.2
"14467","41279","2021",10,10,0,137140.4,1375.6,107.7
"14468","41280","2021",53,53,0,109710.3,1137.547,88.67925
"14469","41281","2021",7,7,0,154957.4,1783,86.14286
"14470","41282","2021",3,3,0,206866.7,1770.667,108.6667
"14471","41283","2021",4,4,0,128025,858.75,139.75
"14472","41284","2021",2,2,0,107500,1444.5,74.5
"14473","41285","2021",12,12,0,209112.4,1906.75,102.8333
"14474","41286","2021",1,1,0,160000,1290,124
"14475","41287","2021",10,10,0,146135,1425.3,108.8
"14476","41288","2021",3,3,0,124000,1580.667,78.33333
"14477","41289","2021",4,4,0,99000,853.5,120.5
"14478","41290","2021",4,4,0,111375,875,106
"14479","41291","2021",7,7,0,187373.7,1323,149.4286
"14480","41292","2021",3,3,0,150000,1387,105
"14481","41293","2021",1,1,0,211000,1055,200
"14482","41294","2021",17,17,0,151917,1677.647,88.82353
"14483","41295","2021",99,93,6,195082.3,1992.99,98.41414
"14484","41296","2021",20,19,1,208688.1,1891.05,110.4
"14485","41297","2021",14,14,0,169593.8,1939.857,96.21429
"14486","42001","2021",3,3,0,221466.7,1863.667,126.6667
"14487","42003","2021",35,35,0,148444.3,1443.486,103.8857
"14488","42005","2021",130,72,58,194537.9,2044.485,93.76923
"14489","42006","2021",6,6,0,194866.7,2158.833,106.5
"14490","42007","2021",4,4,0,177726.5,1294.75,138.5
"14491","42008","2021",1,1,0,121000,931,130
"14492","42009","2021",6,6,0,229306.7,1748.333,119.3333
"14493","42010","2021",11,9,2,189311.4,1919.091,96.09091
"14494","42011","2021",38,28,10,141636.4,1843.553,82.15789
"14495","42012","2021",5,5,0,201620,2156.4,90.2
"14496","42013","2021",25,25,0,166135.4,1856.92,91.28
"14497","42014","2021",3,3,0,86746.67,864.6667,101.3333
"14498","42015","2021",32,32,0,116947.2,1226.844,94.59375
"14499","42016","2021",6,6,0,174574.2,1519,123.5
"14500","42017","2021",5,5,0,173600,2373.8,80.6
"14501","42018","2021",2,2,0,277150,2666,103.5
"14502","42019","2021",48,40,8,126691.1,1358.938,97.5
"14503","42020","2021",17,16,1,239561.8,2316.471,111.4706
"14504","42021","2021",13,13,0,202245.6,2166.154,104.7692
"14505","42022","2021",55,49,6,214855.3,2122.382,100.5455
"14506","42023","2021",25,14,11,116000.6,1179.52,92.44
"14507","42026","2021",22,20,2,140460.5,1394.818,101.5
"14508","42027","2021",8,8,0,97918.75,1157.5,81.625
"14509","42028","2021",3,3,0,75666.67,915.3333,84
"14510","42029","2021",25,25,0,147714,1344.64,108.88
"14511","42030","2021",5,5,0,164210,1327.2,117.2
"14512","42031","2021",5,5,0,283700,2338.2,112.4
"14513","42032","2021",18,17,1,276011.7,2548.556,104
"14514","42033","2021",7,7,0,147914.3,1342.571,118.4286
"14515","42034","2021",2,2,0,148100,832,171.5
"14516","42035","2021",1,1,0,97000,1212,80
"14517","42036","2021",6,6,0,287900,2927.333,97.16667
"14518","42037","2021",2,2,0,194750,1320.5,131.5
"14519","42038","2021",4,4,0,323900,3019.75,104.25
"14520","42039","2021",18,18,0,122861.1,1309.667,98.55556
"14521","42040","2021",1,1,0,52000,1733,30
"14522","42041","2021",4,4,0,218337.5,2262.75,100
"14523","42042","2021",9,9,0,283070.8,2601.111,107.5556
"14524","42043","2021",16,16,0,294883.1,2515.875,117.0625
"14525","42044","2021",126,67,59,130632.6,1510.77,87.70635
"14526","42045","2021",2,2,0,75250,920,85
"14527","42046","2021",25,22,3,170273.2,1761.72,98.88
"14528","42047","2021",9,8,1,113277.8,1100.556,100.2222
"14529","42048","2021",16,16,0,161305.9,1638.688,109.125
"14530","42049","2021",15,14,1,120030.3,1169.733,103.1333
"14531","42050","2021",3,3,0,194500,2457,87.66667
"14532","42051","2021",5,5,0,299620,2313.6,139.8
"14533","42052","2021",69,31,38,125797,1392.522,93.78261
"14534","42053","2021",19,18,1,272481.1,2757.368,99.68421
"14535","42054","2021",1,1,0,96000,857,112
"14536","42055","2021",1,1,0,333000,1914,174
"14537","42056","2021",40,38,2,192887.6,2170.775,90.075
"14538","42058","2021",5,5,0,99180,1032.4,97.4
"14539","42059","2021",66,54,12,189461.9,2019.242,94.27273
"14540","42060","2021",14,14,0,182473.9,1969.786,97.28571
"14541","42061","2021",6,6,0,175933.3,1725,104.8333
"14542","42062","2021",10,9,1,160337,1867.3,90.8
"14543","42063","2021",9,9,0,91988.89,1262.556,73
"14544","42064","2021",5,5,0,197400,2158.6,91
"14545","42065","2021",17,17,0,225052.9,1994.882,114.7647
"14546","42066","2021",6,6,0,249566.7,1998.667,122.8333
"14547","42067","2021",2,2,0,111500,1215,87.5
"14548","42068","2021",5,5,0,223200,1974,122.4
"14549","42069","2021",34,34,0,204927.9,1848.971,115.9706
"14550","42070","2021",17,17,0,183388.8,1690.941,107.6471
"14551","42071","2021",146,53,93,115315.1,1373.116,80.33562
"14552","42072","2021",1,1,0,160000,1905,84
"14553","42073","2021",14,14,0,160400.7,1411.5,133
"14554","42074","2021",15,14,1,152441.3,1538.667,105.2
"14555","42075","2021",11,11,0,250577.3,2137.818,117.0909
"14556","42076","2021",9,9,0,146800,1313.667,109.6667
"14557","42077","2021",4,4,0,143158.8,904,149
"14558","42078","2021",6,6,0,57901.67,772.3333,78.5
"14559","42079","2021",20,20,0,125000.1,1220.3,107.5
"14560","42081","2021",20,19,1,241447.2,2381.95,111.95
"14561","42083","2021",4,4,0,323675,2644.75,116.75
"14562","42084","2021",1,1,0,85000,1417,60
"14563","42085","2021",11,9,2,204945.5,2284.091,90.81818
"14564","42086","2021",9,9,0,143295.6,1327.667,114.6667
"14565","42087","2021",13,13,0,276126.6,2192.231,124.2308
"14566","42088","2021",12,12,0,196641.7,1895.583,102.5833
"14567","42089","2021",3,3,0,83666.67,2007,78.66667
"14568","42090","2021",8,7,1,174162.5,1784.875,94.75
"14569","42091","2021",12,12,0,158983.3,1608.417,115.8333
"14570","42092","2021",42,17,25,262528,2794.286,93.16667
"14571","42093","2021",14,14,0,248939.3,2553.286,96.64286
"14572","42094","2021",124,74,50,158062.2,1792.048,88.75806
"14573","42095","2021",188,53,135,113578.9,1344.665,83.55851
"14574","42096","2021",3,3,0,289866.7,2617.667,109.6667
"14575","42097","2021",74,50,24,248810.9,2279.865,105.7162
"14576","42098","2021",11,11,0,133460,1555.727,87
"14577","42099","2021",61,36,25,147861.1,1595.902,93.36066
"14578","42100","2021",1,1,0,316010,2273,139
"14579","42101","2021",1,1,0,268600,1852,145
"14580","42102","2021",7,7,0,173235.7,1492.143,107.2857
"14581","42103","2021",43,28,15,211496.3,2208.814,94.88372
"14582","42104","2021",13,13,0,135289.2,1245.154,112.1538
"14583","42105","2021",3,3,0,278132.7,1496,174
"14584","42106","2021",5,5,0,68000,803.4,94.2
"14585","42107","2021",8,8,0,145908,1525.625,99.875
"14586","42108","2021",11,11,0,245310.9,2602,94.63636
"14587","42109","2021",6,5,1,82916.67,846.6667,109.1667
"14588","42110","2021",63,42,21,224376.2,2254.127,92.30159
"14589","42112","2021",7,7,0,114270.3,1086.286,107.8571
"14590","42113","2021",7,7,0,205702.9,2070,97.42857
"14591","42115","2021",14,10,4,157196.4,1681.643,92.35714
"14592","42116","2021",2,2,0,82000,925.5,86.5
"14593","42117","2021",1,1,0,230000,2447,94
"14594","42118","2021",7,7,0,108607.1,1072.571,99.57143
"14595","42119","2021",4,4,0,95000,1289.25,78.5
"14596","42120","2021",27,27,0,186108.9,1794.37,103.5556
"14597","42121","2021",3,3,0,130866.7,1551.333,91
"14598","42122","2021",23,23,0,262112.4,2135.826,120.5217
"14599","42123","2021",63,33,30,206958,2298.667,89.73016
"14600","42124","2021",6,6,0,319360.2,2040.167,169.3333
"14601","42125","2021",1,1,0,164800,1011,163
"14602","42126","2021",31,30,1,157112.4,1771.839,89.54839
"14603","42127","2021",82,75,7,170377.5,1753.268,96.31707
"14604","42128","2021",5,5,0,251820,1919.8,144.8
"14605","42129","2021",17,17,0,208279.4,2201.412,101.2353
"14606","42130","2021",7,7,0,192321.4,1792.714,108.1429
"14607","42131","2021",4,4,0,179200,1830.25,97
"14608","42132","2021",9,9,0,221222.2,2097.667,105.1111
"14609","42133","2021",8,8,0,217331.2,1995.75,108.375
"14610","42134","2021",11,11,0,171510.9,1689.182,103.8182
"14611","42135","2021",2,2,0,210500,988,207
"14612","42136","2021",16,16,0,198320.6,1683.25,111.625
"14613","42137","2021",16,15,1,208325,2032.125,106.8125
"14614","42138","2021",4,4,0,159725.5,1463,109.25
"14615","42139","2021",12,12,0,180709.2,2018.083,93.83333
"14616","42140","2021",6,6,0,169533.2,1436.333,103.3333
"14617","42141","2021",6,6,0,132506.7,1111,101.6667
"14618","42142","2021",6,6,0,164346.7,1177,149.6667
"14619","42143","2021",8,8,0,172475,2055,92.5
"14620","42145","2021",10,10,0,137880,1303.6,107.6
"14621","42146","2021",2,2,0,145050,1829.5,77
"14622","42147","2021",231,120,111,166636.4,1949.104,85.85714
"14623","42148","2021",7,7,0,111285.7,1287.571,86.28571
"14624","42149","2021",105,65,40,198824.3,2230.21,90.67619
"14625","42150","2021",11,11,0,189095.5,1838.818,103.8182
"14626","42151","2021",8,8,0,259025,1796.625,139.625
"14627","42152","2021",2,2,0,248500,1895.5,131.5
"14628","42153","2021",12,11,1,162545.8,1188.083,134.5
"14629","42154","2021",10,10,0,101090,1116.4,97.6
"14630","42155","2021",13,13,0,180515.1,1667,108.7692
"14631","42156","2021",16,16,0,145968.8,1444.875,101
"14632","42157","2021",8,8,0,103225,1219.625,87.375
"14633","42158","2021",6,6,0,156218.3,1196.167,122.8333
"14634","42159","2021",18,17,1,95625,975.6667,96.11111
"14635","42160","2021",3,3,0,92000,1111,84
"14636","42161","2021",2,2,0,394000,2214.5,162
"14637","42162","2021",16,16,0,202174.1,1581.062,132.9375
"14638","42163","2021",19,19,0,116774.7,1077.053,106.2632
"14639","42164","2021",1,1,0,129000,1032,125
"14640","42165","2021",67,58,9,149516.6,1593.672,99.9403
"14641","42166","2021",5,5,0,223780,2089.4,106.4
"14642","42167","2021",5,5,0,169286,2225.6,88.4
"14643","42168","2021",64,54,10,198686.7,1943.438,104.0781
"14644","42169","2021",27,27,0,182003.7,2007.63,87.7037
"14645","42170","2021",16,16,0,154766.6,1361.625,108.75
"14646","42171","2021",1,1,0,80000,1333,60
"14647","42172","2021",15,14,1,243273.3,2108.333,123.7333
"14648","42173","2021",9,9,0,160280.6,1757.444,95.44444
"14649","42174","2021",23,23,0,204602.2,2064.478,98.21739
"14650","42175","2021",19,19,0,153492.1,1485.105,99.57895
"14651","42176","2021",25,25,0,192822.4,1864.84,102.2
"14652","42177","2021",42,39,3,155564.9,1592.762,101.6905
"14653","42178","2021",11,11,0,161172.7,1531.818,103.3636
"14654","42179","2021",5,5,0,227480,2018,107.6
"14655","42180","2021",6,6,0,213156.7,1991.667,109
"14656","42181","2021",24,19,5,108148.3,1206.667,93.83333
"14657","42182","2021",49,45,4,200171.8,1917.98,105.4898
"14658","42183","2021",65,35,30,134736.7,1345.815,94.04615
"14659","42184","2021",232,137,95,150528.4,1682.582,86.76724
"14660","42185","2021",9,8,1,262072.2,2184.889,118
"14661","42186","2021",172,97,75,173199.1,1918.727,88.15116
"14662","42187","2021",806,184,622,99600.87,1344.705,74.71588
"14663","42188","2021",2,2,0,107500,865,120
"14664","42189","2021",104,55,49,161220.7,1885.125,84.77885
"14665","42191","2021",17,15,2,187500,2186.412,87
"14666","42192","2021",15,15,0,102558.9,1115,91
"14667","42193","2021",19,18,1,156269.5,1482.421,109.1053
"14668","42194","2021",4,4,0,116312.5,1330.5,94.25
"14669","42195","2021",21,19,2,98528.57,969.4762,103.381
"14670","42196","2021",5,5,0,89453.2,1078.2,84.2
"14671","42197","2021",20,18,2,181890,1548.9,118.4
"14672","42198","2021",16,16,0,186899.4,1679.812,114.625
"14673","42199","2021",22,20,2,194189.1,1897.773,110
"14674","42200","2021",22,22,0,191724,2149.818,89.59091
"14675","42201","2021",5,5,0,156908,1858.8,89.4
"14676","42202","2021",8,7,1,204150,2094.625,100.5
"14677","42203","2021",4,4,0,86412.5,799.25,106
"14678","42204","2021",26,12,14,96524.38,1209.231,80.57692
"14679","42205","2021",8,8,0,76037.5,980.5,81.375
"14680","42206","2021",24,23,1,322753.9,2637.792,123.5833
"14681","42207","2021",465,186,279,144107.6,1683.254,85.45376
"14682","42208","2021",18,15,3,195855.6,2118.5,94.11111
"14683","42209","2021",5,5,0,141000,1604.2,87.6
"14684","42210","2021",4,4,0,222600,2058.25,107.75
"14685","42211","2021",31,21,10,235362.7,2300,99.3871
"14686","42212","2021",17,15,2,179661.8,1633.647,108.9412
"14687","42213","2021",1,1,0,145400,1711,85
"14688","42214","2021",17,16,1,303449.8,2162.059,153.7059
"14689","42215","2021",16,14,2,122253.1,1008.062,128.1875
"14690","42216","2021",4,4,0,369255,2216.75,166.25
"14691","42217","2021",8,8,0,134862.5,1200.875,127.25
"14692","42218","2021",3457,325,3132,98029.29,1345.32,72.82644
"14693","42219","2021",21,21,0,184490.5,1901.238,102.8095
"14694","42220","2021",5,5,0,188321,1979.8,95
"14695","42221","2021",5,5,0,192137.4,1687.6,117.4
"14696","42222","2021",81,66,15,248655.5,2151.444,115.9877
"14697","42223","2021",93,49,44,205428.7,2132.806,95.26882
"14698","42224","2021",24,16,8,215247.5,2234.625,101.0417
"14699","42225","2021",60,51,9,223513.6,2257.367,101
"14700","42226","2021",8,8,0,179781.2,1528.625,117.75
"14701","42227","2021",6,6,0,60416.67,847.6667,69
"14702","42228","2021",7,7,0,205428.6,2106.571,107.7143
"14703","42229","2021",3,3,0,262850,1439.333,187
"14704","42230","2021",25,24,1,94737.6,992.8,88.08
"14705","42231","2021",7,7,0,172107.1,1425.571,122.1429
"14706","42232","2021",7,7,0,169464.3,1252.714,133.4286
"14707","42233","2021",10,10,0,231140,1994,118.7
"14708","42234","2021",46,38,8,211634.1,2168.326,95.65217
"14709","42235","2021",8,8,0,126187.5,1607,83.25
"14710","42236","2021",2,2,0,150725,1323,107.5
"14711","42237","2021",84,42,42,196287.3,2059.714,94.47619
"14712","42238","2021",8,8,0,68775,765.125,85.625
"14713","42239","2021",15,15,0,144566,1594.467,90.53333
"14714","42240","2021",13,13,0,156939.2,1569.615,100.8462
"14715","42241","2021",4,4,0,125750,1285.75,103.5
"14716","42242","2021",22,19,3,276403.2,2686.545,104.2273
"14717","42245","2021",6,6,0,108893.3,1256.5,91.66667
"14718","42246","2021",20,19,1,139165.6,1484.4,86.4
"14719","42247","2021",4,4,0,89275,794.25,103.75
"14720","42248","2021",21,18,3,108290.1,1007.857,109.9048
"14721","42249","2021",22,22,0,128390.5,1365.727,92.59091
"14722","42251","2021",4,4,0,272000,3897.5,91.5
"14723","42252","2021",5,5,0,100280,1153.6,98.2
"14724","42253","2021",17,17,0,225444.1,2052.529,113.2353
"14725","42254","2021",10,10,0,151010,1469.7,98.1
"14726","42255","2021",3,3,0,34833.33,982.6667,42.66667
"14727","42256","2021",70,62,8,200971.3,2078.886,94.98571
"14728","42257","2021",22,21,1,97986.36,1032.318,94.81818
"14729","42259","2021",39,37,2,274625.8,3081.667,96.92308
"14730","42260","2021",5,5,0,85744,851.6,109.8
"14731","42261","2021",6,6,0,193835.5,1546.667,127.3333
"14732","42262","2021",25,25,0,137436.9,1519,89.92
"14733","42264","2021",8,8,0,250606.2,2365,107.25
"14734","42265","2021",7,7,0,261342.9,2691.429,99.42857
"14735","42266","2021",7,7,0,123564.3,1261.429,95.85714
"14736","42267","2021",15,15,0,147473.3,1291,127.9333
"14737","42268","2021",7,7,0,96577.14,912.4286,107
"14738","42270","2021",23,18,5,206249.3,1948.261,100.6087
"14739","42271","2021",46,36,10,226130.9,2347.848,101.4565
"14740","42272","2021",31,25,6,186765.5,2027.516,97.87097
"14741","42273","2021",9,9,0,153455.6,1540.889,100.4444
"14742","42274","2021",3,3,0,138899.3,1327,107.3333
"14743","42275","2021",105,30,75,179591.9,2347.019,76.8381
"14744","42276","2021",8,8,0,69500,878.375,90.625
"14745","42277","2021",8,8,0,111056.2,1214,92.25
"14746","42278","2021",3,3,0,59900,668.3333,89
"14747","42279","2021",237,162,75,228256.1,2425.354,93.59916
"14748","42280","2021",4,4,0,243133,2040,121
"14749","42281","2021",7,7,0,94428.57,1050,93.71429
"14750","42282","2021",2,2,0,134970,1249.5,127.5
"14751","42283","2021",12,12,0,174251.2,1867.75,91.5
"14752","42284","2021",19,19,0,201951.6,1776.684,109.5789
"14753","42285","2021",59,52,7,190011.3,2036.085,93.44068
"14754","42286","2021",10,10,0,240481,2146.5,115.4
"14755","42287","2021",10,10,0,83760,1070.8,84.6
"14756","42288","2021",6,6,0,108633.3,1047.833,104
"14757","42289","2021",24,22,2,143637.5,1449.667,104.375
"14758","42290","2021",9,8,1,142694.4,1869.444,80.88889
"14759","42293","2021",15,14,1,169234,1628.6,105.4667
"14760","42294","2021",10,9,1,210582,1699.8,120.3
"14761","42295","2021",9,9,0,78277.78,814.2222,94.44444
"14762","42296","2021",9,9,0,236777.8,2236.111,113.8889
"14763","42297","2021",5,5,0,206360,1891.6,111.4
"14764","42298","2021",7,7,0,111364.3,1162.286,100
"14765","42299","2021",40,29,11,189548.2,2188.35,86.6
"14766","42300","2021",13,13,0,156450,1550.692,100.3077
"14767","42301","2021",10,10,0,158100,1734.4,96.9
"14768","42302","2021",86,57,29,232208,2531.116,91.40698
"14769","42303","2021",2,2,0,122250,1073.5,116.5
"14770","42304","2021",104,93,11,170578.4,1779.99,95.75962
"14771","42305","2021",81,40,41,193450.2,2272.296,84.25926
"14772","42306","2021",8,5,3,170500,1758,91.375
"14773","42307","2021",14,14,0,271300,2736.714,94.5
"14774","42308","2021",11,6,5,151529.7,1823.545,81.81818
"14775","42310","2021",2,2,0,252625,2232.5,115
"14776","42311","2021",17,15,2,304735.3,2519.941,132.5294
"14777","42312","2021",8,8,0,213193.8,2181.375,99.5
"14778","42313","2021",7,7,0,145714.3,1584,96.57143
"14779","42314","2021",6,6,0,76112.5,748.1667,104
"14780","42315","2021",2,2,0,253775,2681.5,94.5
"14781","42316","2021",97,61,36,167662.1,1860.691,89.74227
"14782","42317","2021",1,1,0,162000,1350,120
"14783","42318","2021",28,27,1,138038.5,1417.357,97.39286
"14784","42319","2021",5,5,0,248590,1717,143.4
"14785","42320","2021",9,9,0,231294.4,2273,101.5556
"14786","42321","2021",3,3,0,46833.33,503.3333,93.33333
"14787","42322","2021",16,13,3,191167.1,1960.5,102.1875
"14788","42323","2021",117,91,26,233383.9,2449.513,98.18803
"14789","42324","2021",15,15,0,265596.7,2512.6,108.8667
"14790","42325","2021",4,4,0,148937.5,1298.5,103.25
"14791","42326","2021",7,7,0,211014.3,2504.143,94.28571
"14792","42327","2021",9,7,2,236679.2,2487.333,94.22222
"14793","42328","2021",9,9,0,119227.8,1292.667,91.44444
"14794","42329","2021",6,6,0,197985,1834,107.1667
"14795","42330","2021",137,36,101,142631.8,1566.423,90.16058
"14796","42331","2021",15,15,0,176521,1719.8,104.2
"14797","42332","2021",75,68,7,209122.3,1912.52,108.1733
"14798","42333","2021",5,5,0,110220,1082.2,105.8
"14799","42334","2021",13,11,2,169126.9,1588.692,97.84615
"14800","42335","2021",9,9,0,175751.2,1727.111,99.11111
"14801","42336","2021",11,11,0,216981.8,2172.545,98.90909
"14802","42337","2021",4,4,0,141487.5,1252.75,113.25
"14803","42338","2021",15,13,2,202219.7,1821.467,110.4667
"14804","42339","2021",2,2,0,158800,1503,97.5
"14805","43001","2021",6,6,0,115753.3,854.5,136.6667
"14806","43002","2021",17,15,2,165795.3,1877.941,91.58824
"14807","43003","2021",12,11,1,108038.9,936.5,107.6667
"14808","43004","2021",1,1,0,110000,2619,42
"14809","43005","2021",6,6,0,73783.33,1107,67.83333
"14810","43006","2021",4,4,0,59703.75,462.75,142.5
"14811","43007","2021",5,5,0,202404,1615.8,136.2
"14812","43008","2021",3,3,0,98153.33,1317.333,73.66667
"14813","43009","2021",2,2,0,61250,867,70.5
"14814","43010","2021",1,1,0,207300,1835,113
"14815","43011","2021",4,4,0,131700,1167.5,108.75
"14816","43012","2021",62,50,12,173410.5,1983.581,88.24194
"14817","43013","2021",6,6,0,48333.33,606.8333,79.83333
"14818","43014","2021",1,1,0,65500,575,114
"14819","43016","2021",13,13,0,95483.77,971.0769,93.92308
"14820","43017","2021",6,6,0,109768.3,993.5,114.3333
"14821","43018","2021",14,13,1,139749.6,1440.071,97
"14822","43019","2021",3,3,0,73000,787,94.33333
"14823","43020","2021",62,54,8,175397.6,1913.161,91.24194
"14824","43021","2021",9,9,0,166038.9,1524.111,108.8889
"14825","43022","2021",5,5,0,124880,1006.4,123
"14826","43023","2021",4,4,0,103250,1002,104.75
"14827","43024","2021",9,9,0,105222.2,1511.222,71.33333
"14828","43025","2021",46,43,3,134809.1,1518.957,84.80435
"14829","43026","2021",14,14,0,143635,1363.071,97.92857
"14830","43027","2021",3,2,1,87666.67,1020.333,85.66667
"14831","43028","2021",4,4,0,100612.8,1307.25,90.75
"14832","43029","2021",2,2,0,72000,772,93
"14833","43030","2021",5,5,0,138320,1182.4,116
"14834","43032","2021",10,9,1,161240,1776.8,91.6
"14835","43033","2021",9,9,0,89905.56,1056.111,76.11111
"14836","43034","2021",5,5,0,92570,1265,67.2
"14837","43035","2021",2,2,0,215010,898.5,239
"14838","43036","2021",3,3,0,146000,1464.333,97.66667
"14839","43038","2021",10,10,0,129035,1391.7,99.3
"14840","43039","2021",10,9,1,120540,1145.4,105.2
"14841","43040","2021",74,55,19,113071.6,1312,91.13514
"14842","43041","2021",30,16,14,154563.1,1707.033,91.36667
"14843","43042","2021",9,9,0,93172.22,1140.778,79.11111
"14844","43043","2021",9,9,0,124344.4,1224.222,100
"14845","43044","2021",2,2,0,101500,1357,73.5
"14846","43045","2021",4,4,0,211850,1788.25,120.75
"14847","43046","2021",26,20,6,157338.5,1735.923,90.73077
"14848","43047","2021",3,3,0,99300,1416.667,88.33333
"14849","43048","2021",13,12,1,78911.54,900.6154,90.38462
"14850","43049","2021",12,11,1,64175,975.1667,70.91667
"14851","43051","2021",74,49,25,145015.3,1558.122,97.62162
"14852","43052","2021",6,6,0,78066.67,981,83.16667
"14853","43053","2021",3,3,0,175966.7,1474,114.3333
"14854","43054","2021",1,1,0,30000,429,70
"14855","43055","2021",2,2,0,43950,466,95
"14856","43056","2021",5,5,0,96200,1108.8,105.6
"14857","43057","2021",1,1,0,157100,1309,120
"14858","43058","2021",7,7,0,253157.1,2253.714,111.1429
"14859","43059","2021",2,2,0,84500,686,134.5
"14860","43061","2021",13,13,0,210197.8,1739.692,116.1538
"14861","43062","2021",4,4,0,147912.5,1311.25,110
"14862","43063","2021",4,4,0,91425,795.5,105.5
"14863","43066","2021",2,2,0,124000,2955,43.5
"14864","43067","2021",3,3,0,156966.7,1255.667,119.6667
"14865","43069","2021",3,3,0,123889,965.6667,126
"14866","43070","2021",3,3,0,116183.3,1326.333,87.33333
"14867","43071","2021",7,7,0,81642.86,929,87.71429
"14868","43073","2021",3,3,0,157200,1482,107
"14869","43074","2021",4,4,0,198242.5,1693,119.5
"14870","43075","2021",1,1,0,73000,730,100
"14871","43076","2021",3,3,0,77333.33,724.6667,116
"14872","43077","2021",4,4,0,99700,1116,97.25
"14873","43078","2021",27,24,3,170244.4,1552.926,106.2593
"14874","43079","2021",1,1,0,35000,343,102
"14875","43080","2021",34,28,6,111004.3,1098.029,99.26471
"14876","43082","2021",2,2,0,67000,881,74
"14877","43084","2021",7,7,0,185649.3,1592.429,116.5714
"14878","43086","2021",3,3,0,74766.67,903.6667,112.3333
"14879","43087","2021",26,21,5,152790.4,1330.231,117.8846
"14880","43088","2021",5,5,0,112154.2,1144.4,93
"14881","43089","2021",57,32,25,142186.9,1594.719,93.73684
"14882","43090","2021",1,1,0,28680,478,60
"14883","43091","2021",5,4,1,136210,1700.6,80.8
"14884","43092","2021",6,6,0,86166.67,1361.833,95.83333
"14885","43093","2021",10,10,0,67500.5,887.8,81.6
"14886","43094","2021",1,1,0,144600,1418,102
"14887","43095","2021",2,2,0,61250,935,65
"14888","43096","2021",8,8,0,103036.2,876.875,119.75
"14889","43097","2021",3,3,0,37300,466,78.33333
"14890","43098","2021",3,3,0,96910,1500,65.33333
"14891","43099","2021",6,6,0,116415,1270.833,91
"14892","43100","2021",4,4,0,60538,1799.25,68.75
"14893","43101","2021",2,2,0,77750,1026.5,66.5
"14894","43102","2021",9,9,0,182266.7,1853.222,103
"14895","43103","2021",1,1,0,38000,567,67
"14896","43104","2021",2,2,0,55000,548,91.5
"14897","43105","2021",1,1,0,46000,2706,17
"14898","43106","2021",4,4,0,105750,1015.5,100
"14899","43108","2021",4,4,0,90732.5,1028.75,88.5
"14900","43109","2021",2,2,0,198500,1896,110
"14901","43110","2021",5,5,0,135800,1024.2,131.6
"14902","43111","2021",11,11,0,104306.4,1248.455,81.90909
"14903","43112","2021",56,49,7,93876.34,1067.339,84.75
"14904","43113","2021",21,20,1,155754.1,1434.238,103.1429
"14905","43114","2021",17,17,0,157834.1,1361.588,113.2353
"14906","43115","2021",11,11,0,136009.1,1414.727,101.3636
"14907","43116","2021",2,2,0,105000,1210.5,71.5
"14908","43117","2021",3,3,0,96466.67,873.6667,95
"14909","43118","2021",5,5,0,70100,763.8,96.6
"14910","43119","2021",8,8,0,114275,1201.125,94.25
"14911","43120","2021",17,17,0,92637.35,917.1176,97.35294
"14912","43121","2021",2,2,0,79250,886.5,83.5
"14913","43122","2021",5,5,0,110640,1377.2,95
"14914","43123","2021",4,4,0,125875,1362,85.75
"14915","43124","2021",8,8,0,129943.8,1480.25,92.875
"14916","43125","2021",2,2,0,125000,1302,101.5
"14917","43126","2021",5,5,0,138160,1406.4,98.8
"14918","43127","2021",8,8,0,195031.2,1591.5,122.125
"14919","43128","2021",1,1,0,63700,425,150
"14920","43129","2021",1,1,0,153280,2395,64
"14921","43130","2021",13,10,3,108419.2,1171.692,88.46154
"14922","43131","2021",3,3,0,87000,1281.667,71
"14923","43132","2021",11,11,0,106881.8,1196.909,85.63636
"14924","43133","2021",2,2,0,84400,703.5,116
"14925","43134","2021",2,2,0,75000,754.5,97
"14926","43135","2021",17,15,2,95058.82,962.8824,100.0588
"14927","43136","2021",3,3,0,87225,849,120
"14928","43137","2021",85,67,18,193580.3,1924.553,99.8
"14929","43138","2021",8,8,0,205325,1301,174.125
"14930","43140","2021",5,5,0,178600,1581,112.8
"14931","43141","2021",12,11,1,113258.3,1370.667,79.83333
"14932","43142","2021",7,7,0,109390.6,1566.857,75.85714
"14933","43143","2021",2,2,0,165000,1718.5,96
"14934","43144","2021",1,1,0,50000,417,120
"14935","43145","2021",3,3,0,89030,1276.667,88
"14936","43147","2021",7,6,1,201514.4,1840.714,111.5714
"14937","43148","2021",10,9,1,88155,1017.9,86.5
"14938","43149","2021",4,4,0,34805,624.25,57.75
"14939","43150","2021",11,11,0,141954.5,1360.273,110.0909
"14940","43151","2021",4,4,0,51250,500.25,103.5
"14941","43152","2021",18,17,1,213891.4,1722.611,112.2222
"14942","43153","2021",25,18,7,160270,1514.56,103.92
"14943","43154","2021",9,8,1,96555.56,1077.667,84.22222
"14944","43155","2021",1,1,0,70000,700,100
"14945","43156","2021",4,4,0,56500,1005.75,57.25
"14946","43157","2021",343,54,289,115393,1485.997,78.35277
"14947","43158","2021",6,6,0,131400,1296,94.33333
"14948","43159","2021",9,9,0,181388,1614.111,108.8889
"14949","43160","2021",4,4,0,71120,851,87.5
"14950","43162","2021",41,39,2,110741.7,1352.561,79.87805
"14951","43163","2021",17,17,0,152923.5,1607.765,96.88235
"14952","43164","2021",5,4,1,102436,756.2,131.2
"14953","43165","2021",13,13,0,100311.5,1266.462,80.38462
"14954","43166","2021",4,4,0,132669.5,1129.25,104
"14955","43168","2021",4,4,0,224175,3395.25,82.25
"14956","43169","2021",3,3,0,75100,1123.667,76.33333
"14957","43170","2021",3,3,0,157333.3,1141.333,159.6667
"14958","43171","2021",1,1,0,48000,533,90
"14959","43172","2021",4,2,2,98250,1351.25,73.25
"14960","43173","2021",3,3,0,124076.7,1138.333,116.6667
"14961","43174","2021",13,13,0,115453.3,1078.923,116.8462
"14962","43175","2021",5,5,0,65920,801.2,84.2
"14963","43177","2021",44,30,14,143263.6,1495.227,97.29545
"14964","43178","2021",9,9,0,88536.44,907.8889,96.66667
"14965","43180","2021",1,1,0,82650,1181,70
"14966","43181","2021",8,8,0,130055.6,1283,98.625
"14967","43182","2021",2,2,0,90000,1035.5,94.5
"14968","43184","2021",23,13,10,161443.5,1926.739,82.82609
"14969","43185","2021",40,39,1,115158.2,1286.95,92.6
"14970","43186","2021",18,17,1,119178.3,1214.333,98.11111
"14971","43187","2021",3,3,0,107123.3,1050,110
"14972","43188","2021",4,4,0,67500,1003.75,61.5
"14973","43189","2021",5,5,0,82600,983.6,90.4
"14974","43190","2021",19,18,1,177210.5,1583.895,113.2632
"14975","43191","2021",1,1,0,45000,500,90
"14976","43192","2021",6,5,1,130333.3,1295.5,95.16667
"14977","43193","2021",3,3,0,84250,1289.333,60.33333
"14978","43194","2021",5,5,0,132880,1394.4,95
"14979","43195","2021",2,2,0,105000,881,118
"14980","43196","2021",1,1,0,30000,500,60
"14981","43197","2021",4,4,0,53127.5,905,61.5
"14982","43198","2021",6,6,0,153346.7,1312.333,116.5
"14983","43199","2021",17,16,1,136639.4,1468.824,94.11765
"14984","43200","2021",19,17,2,133541.5,1524.947,89.36842
"14985","43201","2021",1,1,0,300900,2229,135
"14986","43203","2021",5,5,0,141273.4,1154.6,135.6
"14987","43204","2021",3,3,0,171166.7,1486.333,113.6667
"14988","43205","2021",34,24,10,157234.9,1648.618,94.29412
"14989","43206","2021",3,3,0,103400,1518.333,64.33333
"14990","43207","2021",1,1,0,15000,500,30
"14991","43208","2021",1,1,0,50000,625,80
"14992","43210","2021",4,4,0,49712.5,902.25,65.25
"14993","43211","2021",24,20,4,134317.9,1735.375,81.5
"14994","43212","2021",12,10,2,92652.92,1112.417,80.41667
"14995","43213","2021",21,20,1,171051.8,1664.667,103.3333
"14996","43214","2021",3,3,0,179033.3,1557.333,117.6667
"14997","43215","2021",5,5,0,113360,1244.4,95.2
"14998","43216","2021",25,22,3,173930,1480.32,119.4
"14999","43217","2021",8,7,1,99234.38,990.75,93.875
"15000","43218","2021",14,14,0,154096.9,1467.571,107.7857
"15001","43219","2021",3,3,0,146500,1547.333,85
"15002","43220","2021",4,4,0,99877.5,843.5,118.5
"15003","43221","2021",5,4,1,98590,1166.6,76.4
"15004","43222","2021",2,2,0,66500,855,93
"15005","43223","2021",5,5,0,156200,1720,91.4
"15006","43224","2021",61,54,7,143612.3,1507.787,93.11475
"15007","43225","2021",2,2,0,135450,1605.5,88.5
"15008","43226","2021",2,2,0,66000,775.5,85
"15009","43227","2021",8,4,4,122653.8,1471.875,87
"15010","43228","2021",1,1,0,62000,899,69
"15011","43229","2021",3,3,0,206150,1623.333,125
"15012","43230","2021",13,13,0,149880.8,1323.308,118
"15013","43231","2021",6,6,0,78516.67,1250.333,66.16667
"15014","43233","2021",14,14,0,179238.1,1534.143,124
"15015","43234","2021",21,20,1,81166.67,1078.19,75.95238
"15016","43236","2021",16,6,10,101168.8,1127.375,82.8125
"15017","43237","2021",4,4,0,66300,664.75,100
"15018","43238","2021",4,4,0,75212.5,653.25,115.5
"15019","43239","2021",14,14,0,95233.36,837.1429,112.8571
"15020","43240","2021",3,3,0,85666.67,994.6667,83.33333
"15021","43241","2021",7,7,0,166921.4,1471.571,102.7143
"15022","43244","2021",38,37,1,128560.8,1342.105,102.8158
"15023","43245","2021",4,4,0,57875,548.5,105
"15024","43246","2021",11,11,0,93186.36,1852.273,75.45455
"15025","43249","2021",5,5,0,160380,1961.6,81.8
"15026","43250","2021",2,2,0,44250,634,69.5
"15027","43251","2021",66,29,37,137532.2,1572.561,82.16667
"15028","43253","2021",5,4,1,48700,1149.6,42.8
"15029","43254","2021",1,1,0,24000,400,60
"15030","43256","2021",6,6,0,87350,832.6667,104.6667
"15031","43257","2021",5,5,0,132350,1062.6,132.4
"15032","43258","2021",27,27,0,118879.7,1290.519,91.92593
"15033","43259","2021",4,4,0,76250,748,83.5
"15034","43260","2021",1,1,0,23000,479,48
"15035","43261","2021",7,7,0,101157.1,1191.571,84.57143
"15036","43262","2021",13,9,4,87338.46,1098.615,74.61538
"15037","43263","2021",3,3,0,79000,821.6667,90.33333
"15038","43264","2021",10,10,0,95895,914.8,95.1
"15039","43265","2021",12,12,0,185958.3,1917.75,94.91667
"15040","43267","2021",25,23,2,124991.4,1321.8,102.6
"15041","43268","2021",74,56,18,158941.6,1756.811,98.05405
"15042","44001","2021",28,28,0,153616.1,1690.714,98.89286
"15043","44002","2021",40,35,5,259295,2664.9,97.875
"15044","44003","2021",81,61,20,207786.7,2468.84,89.14815
"15045","44005","2021",116,111,5,226662.7,2374.81,98.87069
"15046","44006","2021",42,42,0,228055.2,2602.5,91.21429
"15047","44007","2021",35,35,0,148061.4,1551,93.91429
"15048","44009","2021",106,86,20,404469.5,3569.538,112.0849
"15049","44010","2021",97,77,20,315205.3,4354.093,74.46392
"15050","44012","2021",107,88,19,310146.6,4149.85,78.03738
"15051","44013","2021",39,37,2,223164.2,2110.513,108.3333
"15052","44014","2021",47,46,1,278783.2,2786.511,105.9149
"15053","44015","2021",165,149,16,196392.6,2131.879,93.72121
"15054","44016","2021",19,19,0,188359.2,1947.789,100.9474
"15055","44018","2021",133,108,25,288323.5,3136.286,94.98496
"15056","44019","2021",20,20,0,240250,2314.3,109
"15057","44020","2021",324,245,79,262433,3215.988,85.33025
"15058","44021","2021",78,77,1,195247.7,2197.295,90.9359
"15059","44022","2021",50,47,3,159363.4,1847.06,90.32
"15060","44023","2021",38,37,1,183230,1931.763,98.71053
"15061","44024","2021",41,40,1,274530.2,2844.537,99.56098
"15062","44025","2021",48,47,1,201562.1,2180.208,97.70833
"15063","44026","2021",289,198,91,329461.8,3441.488,97.14879
"15064","44027","2021",33,33,0,263423,2579.697,105.303
"15065","44028","2021",51,47,4,288895.5,2527.98,116.0588
"15066","44029","2021",71,69,2,217908.8,2364.07,97.1831
"15067","44030","2021",59,56,3,196945,2155.051,94.98305
"15068","44031","2021",23,23,0,136048.5,1326.87,112.087
"15069","44032","2021",37,37,0,256533.9,2742.27,94.43243
"15070","44033","2021",30,30,0,214780,2266.467,96.03333
"15071","44035","2021",248,187,61,346703.8,3550.044,98.72177
"15072","44036","2021",236,195,41,145828.4,1730.297,87.30932
"15073","44037","2021",26,24,2,251453.8,2810.731,89.57692
"15074","44038","2021",57,56,1,220071.1,2466.86,93.61404
"15075","44039","2021",15,15,0,311690,2691.267,117.3333
"15076","44041","2021",72,69,3,240438.5,2751.347,91.05556
"15077","44043","2021",115,104,11,287248.5,3079.209,96.26957
"15078","44044","2021",22,22,0,108010.3,1178.909,98.18182
"15079","44045","2021",43,43,0,265009.6,2568.628,107.5349
"15080","44046","2021",33,33,0,267333.3,2642.212,101.4545
"15081","44047","2021",379,285,94,265811,3159.354,86.59103
"15082","44048","2021",32,32,0,195530.1,2148.594,91.34375
"15083","44049","2021",184,78,106,255598.5,4013.245,66.66304
"15084","44050","2021",36,36,0,199876,2017,100.1944
"15085","44051","2021",61,61,0,148538.9,1583.902,96
"15086","44052","2021",125,123,2,171921.2,1938.432,93.136
"15087","44053","2021",29,29,0,201860.1,1898.793,103.5517
"15088","44054","2021",38,38,0,148768.4,1484.947,100.5263
"15089","44055","2021",907,303,604,442729.4,5978.95,75.54796
"15090","44056","2021",61,60,1,214713.6,2251.393,99.09836
"15091","44057","2021",58,58,0,133521.6,1435.534,92.03448
"15092","44058","2021",10,10,0,146023,1496.8,96.1
"15093","44061","2021",64,57,7,206035.7,2253.125,95.46875
"15094","44062","2021",33,33,0,154148.5,1770.848,91.66667
"15095","44063","2021",53,50,3,220392.5,2357.075,100.5283
"15096","44064","2021",53,50,3,255151.5,2555.415,101
"15097","44065","2021",10,10,0,145950,1464.6,97.1
"15098","44066","2021",70,67,3,319037.5,2980.986,108.8857
"15099","44067","2021",114,111,3,139522.3,1543.061,99.2193
"15100","44068","2021",76,76,0,154295.4,1637.868,94.68421
"15101","44069","2021",332,264,68,346609.6,3522.389,103.0241
"15102","44070","2021",56,56,0,283776.1,2794.964,103.5714
"15103","44071","2021",50,48,2,333151.9,3074.76,110.36
"15104","44072","2021",125,123,2,244858.6,2495.096,102.384
"15105","44073","2021",69,66,3,264712,2627.594,104.029
"15106","44074","2021",73,54,19,240718.2,3441.219,70.05479
"15107","44075","2021",35,35,0,119024,1215.657,99.2
"15108","44076","2021",28,28,0,184564.3,1396.5,127
"15109","44077","2021",50,47,3,161057,1867.22,91.02
"15110","44078","2021",5,5,0,126600,1053.6,123.6
"15111","44079","2021",35,34,1,225255.6,2576.6,90.94286
"15112","44080","2021",8,8,0,216310.1,2115.625,101.75
"15113","44081","2021",80,80,0,175745.8,1732,103.2
"15114","44082","2021",54,52,2,246687,2626.278,98.14815
"15115","44083","2021",49,49,0,200202.2,2101.224,95.69388
"15116","44084","2021",102,88,14,261997.1,2789.392,99.17647
"15117","44085","2021",14,14,0,120907.2,1189.286,99.64286
"15118","44086","2021",30,30,0,129473.3,1468.1,91.33333
"15119","44087","2021",111,97,14,198511.8,2317.937,87.99099
"15120","44088","2021",37,33,4,248195.5,2709.649,96.16216
"15121","44089","2021",57,56,1,236199,2498.737,98
"15122","44090","2021",27,27,0,207650,2152.111,101.1481
"15123","44091","2021",23,23,0,155784.6,1591.043,95.3913
"15124","44092","2021",17,17,0,130911.8,1425.412,90.52941
"15125","44094","2021",47,47,0,268502.3,2752.234,104.6383
"15126","44095","2021",33,33,0,118609.1,1302.364,92.09091
"15127","44096","2021",54,54,0,205195.7,2139.389,98.14815
"15128","44097","2021",73,70,3,370713.3,3985.082,95.24658
"15129","44098","2021",99,99,0,187892.4,2101.303,94.34343
"15130","44099","2021",29,29,0,138007.8,1432.621,94.7931
"15131","44100","2021",23,23,0,228184.7,2348,96.69565
"15132","44101","2021",112,103,9,250328.7,3163.848,82.74107
"15133","44102","2021",35,35,0,249702.9,2399,105.8857
"15134","44103","2021",97,80,17,194285.6,2325.907,84.78351
"15135","44104","2021",19,19,0,137884.2,1486.053,91.52632
"15136","44105","2021",5,5,0,199316.8,2133.2,93.6
"15137","44106","2021",60,53,7,280406,3706.75,80.81667
"15138","44107","2021",27,27,0,171645.7,1852.333,94.85185
"15139","44108","2021",31,31,0,256313.7,2430.968,104.4194
"15140","44109","2021",6464,1402,5062,275694.1,4066.78,67.6496
"15141","44110","2021",106,99,7,277285.3,2814.33,102.0566
"15142","44111","2021",29,29,0,238095.6,2252.345,106.6552
"15143","44112","2021",9,9,0,120833.3,1049.667,115
"15144","44113","2021",64,58,6,177370.8,1830.906,98.4375
"15145","44114","2021",458,268,190,316661.5,3449.943,91.18341
"15146","44115","2021",51,51,0,272896.5,2499.804,108.6471
"15147","44116","2021",24,16,8,164641.7,1974.625,87.125
"15148","44117","2021",57,51,6,239327.2,2551.368,95.59649
"15149","44118","2021",19,19,0,159294.7,1422.105,115.2105
"15150","44119","2021",26,26,0,193435.7,1904.423,106.6538
"15151","44120","2021",78,73,5,258204.2,2729.667,99.80769
"15152","44121","2021",9,9,0,107444.4,1077.889,95.66667
"15153","44122","2021",40,40,0,228112,2370.625,98.8
"15154","44123","2021",18,18,0,125061.9,1188.722,103.7222
"15155","44124","2021",18,18,0,134005.6,1364.722,103.6667
"15156","44125","2021",101,88,13,345384.8,3995.723,89.9802
"15157","44126","2021",133,130,3,273174.2,3710.835,79.40602
"15158","44127","2021",30,29,1,195500,1901.333,103.4
"15159","44128","2021",110,109,1,182082.1,1767.509,104.9727
"15160","44129","2021",160,135,25,195430.1,2206.338,94.11875
"15161","44130","2021",79,77,2,313209.9,3142.405,101.8481
"15162","44131","2021",385,314,71,369825.7,4428.94,87.17662
"15163","44132","2021",423,174,249,388588.3,5434.064,74.83688
"15164","44133","2021",50,45,5,260054.5,2564.22,100.5
"15165","44134","2021",13,13,0,159453.8,1578,98.69231
"15166","44135","2021",175,76,99,342322.8,5088.263,66.29714
"15167","44136","2021",41,33,8,327301.1,4271.683,79.46341
"15168","44137","2021",46,46,0,228632,2329.065,100.3913
"15169","44138","2021",9,9,0,163500,1971.222,83.55556
"15170","44139","2021",26,26,0,169417.1,1830,100.0385
"15171","44140","2021",22,21,1,193485.4,2246.318,88.22727
"15172","44141","2021",14,14,0,220801.2,1905.714,123.2143
"15173","44142","2021",27,25,2,197655.6,2187.074,90.14815
"15174","44143","2021",769,370,399,242673.9,3257.706,74.90247
"15175","44144","2021",30,30,0,142280.7,1575.067,92.9
"15176","44145","2021",45,45,0,202157.2,2366.6,89.04444
"15177","44146","2021",39,39,0,139416.8,1297.769,110.9744
"15178","44148","2021",19,19,0,108842.1,1106.263,106.4737
"15179","44149","2021",60,60,0,196144.7,1935.567,102.5833
"15180","44150","2021",54,54,0,300955,2778.315,113.5926
"15181","44151","2021",134,119,15,346477.6,3195.09,109.694
"15182","44152","2021",30,30,0,197376.2,2085.867,100.7
"15183","44153","2021",32,31,1,133196.9,1303.531,106.0938
"15184","44154","2021",425,280,145,278573.1,3864.668,75.4
"15185","44155","2021",61,61,0,229883.1,2220.82,104.3934
"15186","44156","2021",44,43,1,185420.1,2032.455,96.04545
"15187","44157","2021",27,27,0,165232.7,1761.037,93.2963
"15188","44158","2021",94,90,4,336582.4,2929.957,115.0851
"15189","44159","2021",17,16,1,274267.6,2852.118,101.2353
"15190","44161","2021",73,72,1,170239.9,1709.603,101.8219
"15191","44162","2021",895,345,550,240338.1,3024.064,79.8324
"15192","44163","2021",51,51,0,202489.1,2101.529,100.3725
"15193","44164","2021",37,35,2,236872.9,2228.946,107.1351
"15194","44165","2021",28,28,0,240754,2266.179,105.3214
"15195","44166","2021",78,78,0,270695.5,2941.115,96.48718
"15196","44168","2021",74,73,1,151975.1,1872.892,84.58108
"15197","44169","2021",104,94,10,259981.1,2858.683,92.88462
"15198","44170","2021",14,14,0,99678.57,918.5,107.6429
"15199","44171","2021",25,25,0,298684,2551.28,123.52
"15200","44172","2021",224,149,75,305380.4,3434.638,90.77232
"15201","44173","2021",28,26,2,239884.4,2325.214,104.3214
"15202","44174","2021",41,41,0,223143.9,2388.951,95.12195
"15203","44175","2021",71,71,0,311460.3,2678.394,120
"15204","44176","2021",49,49,0,201339.1,2025.265,99.4898
"15205","44178","2021",44,44,0,223672.2,2358.068,96.70455
"15206","44179","2021",72,72,0,258852.2,2606.931,101.8611
"15207","44180","2021",35,34,1,120620.8,1326.629,90.11429
"15208","44182","2021",166,132,34,260707.5,3842.59,73.93373
"15209","44183","2021",43,43,0,279662.9,2613.163,111.0698
"15210","44184","2021",1420,645,775,214788.5,2915.975,74.94577
"15211","44185","2021",69,56,13,140199,1673,87.57971
"15212","44186","2021",112,109,3,258804.4,2741.562,98.35714
"15213","44187","2021",68,66,2,224345.1,2565.735,90.61765
"15214","44188","2021",118,116,2,262134.9,2605.542,102.2712
"15215","44189","2021",37,36,1,190698.4,2003.054,95.67568
"15216","44190","2021",495,296,199,294278.4,3625.127,81.89293
"15217","44192","2021",37,36,1,211071.2,2323.946,94.24324
"15218","44193","2021",19,19,0,122500,1227.737,101.2632
"15219","44194","2021",126,98,28,474013.1,3761.548,128.3095
"15220","44195","2021",103,90,13,240557.5,2520.699,98.09709
"15221","44196","2021",41,41,0,158022.5,1835.854,85.31707
"15222","44197","2021",37,37,0,133419.4,1355.297,99.24324
"15223","44198","2021",122,94,28,298142.9,3226.68,92.71311
"15224","44199","2021",25,25,0,132777.7,1450.32,90.68
"15225","44200","2021",13,13,0,80384.62,919.7692,95.61538
"15226","44201","2021",95,89,6,403747.7,3665.326,112.6842
"15227","44202","2021",18,18,0,181849.6,1757.556,106.0556
"15228","44203","2021",17,16,1,269595.4,2681.235,111.0588
"15229","44204","2021",155,112,43,296519.8,3238.297,95.63871
"15230","44205","2021",17,17,0,202400,2119.176,90.88235
"15231","44206","2021",40,40,0,160945.6,1855.925,90.075
"15232","44207","2021",15,15,0,206020,1978.867,112.6667
"15233","44208","2021",18,18,0,132611.1,1235.444,106.6111
"15234","44209","2021",124,109,15,328481.6,3135.839,107.3306
"15235","44210","2021",144,110,34,172672.2,2306.681,77.3125
"15236","44211","2021",194,136,58,285787.3,3836.253,82.40722
"15237","44212","2021",124,115,9,240944.3,2556.5,97.24194
"15238","44213","2021",119,119,0,156534.3,1642.067,98.88235
"15239","44214","2021",36,36,0,189736.6,1776.611,109.25
"15240","44215","2021",394,326,68,363781,3717.226,100.2716
"15241","44216","2021",70,70,0,193734.3,2047.171,96.6
"15242","44217","2021",92,90,2,324687.1,3090.457,112.5217
"15243","44218","2021",8,8,0,119232.8,1112.75,113.875
"15244","44220","2021",20,20,0,192350,2030.1,95.6
"15245","44221","2021",17,17,0,242452.9,2236.059,111.2353
"15246","44222","2021",16,16,0,196031.2,1782.75,111.25
"15247","44223","2021",54,49,5,246563.9,2480.519,100.8889
"15248","44224","2021",13,13,0,195898.2,2024.923,97.84615
"15249","45001","2021",7,7,0,86042.86,1058.714,83.42857
"15250","45002","2021",8,8,0,94324.88,928,103.5
"15251","45004","2021",199,186,13,147485.8,1748.935,86
"15252","45005","2021",4,4,0,191110,2088.5,92
"15253","45006","2021",14,10,4,348946.1,2600,134.1429
"15254","45008","2021",23,20,3,157277.8,1866.739,86.95652
"15255","45009","2021",17,17,0,170432.4,1802.353,103.1176
"15256","45010","2021",17,17,0,183530,1787.647,115.9412
"15257","45011","2021",3,3,0,155000,1989.667,78.66667
"15258","45012","2021",2,2,0,235000,898,234
"15259","45013","2021",4,4,0,174500,2649.75,78.75
"15260","45014","2021",11,11,0,188759.1,1851.545,104.7273
"15261","45015","2021",17,17,0,176411.8,2272.588,84.17647
"15262","45016","2021",13,13,0,117061.5,1173.538,113.3846
"15263","45017","2021",5,5,0,142600,1325.6,106.4
"15264","45018","2021",19,19,0,131836.8,1431.263,98.52632
"15265","45019","2021",12,12,0,193331.2,1809.75,111
"15266","45020","2021",11,11,0,187241.4,1743.545,109.8182
"15267","45021","2021",10,10,0,134000,1415.7,106.5
"15268","45022","2021",10,9,1,117732,1238.2,106.1
"15269","45023","2021",2,2,0,155000,1424.5,94.5
"15270","45024","2021",30,30,0,209759.3,2078.067,103.2
"15271","45025","2021",16,16,0,156781.2,1685.812,97.25
"15272","45026","2021",19,19,0,126782.6,1570.316,84.10526
"15273","45027","2021",11,11,0,181267.3,1539.636,119.0909
"15274","45028","2021",170,109,61,141691,1665.206,84.61176
"15275","45029","2021",46,46,0,108682.6,1209.13,91.76087
"15276","45030","2021",36,35,1,135443.1,1488.056,95.38889
"15277","45031","2021",17,16,1,116294.1,1216.294,89.47059
"15278","45032","2021",7,7,0,145030,1578.143,95.85714
"15279","45033","2021",9,9,0,141266.7,1159.444,119.3333
"15280","45034","2021",29,26,3,217989.7,2342.655,95.2069
"15281","45035","2021",23,23,0,120793.5,1219.609,98.65217
"15282","45036","2021",19,19,0,154011.6,1400.053,111.6316
"15283","45037","2021",9,9,0,143035.7,1438.889,100
"15284","45038","2021",8,8,0,215625,1840.625,125.5
"15285","45039","2021",14,14,0,140985.7,1597.5,88.21429
"15286","45040","2021",36,34,2,104820.8,1131.028,94.83333
"15287","45041","2021",2,2,0,145000,1395,98.5
"15288","45042","2021",34,33,1,141188,1455.529,97.26471
"15289","45043","2021",7,7,0,176357.1,1869.143,94
"15290","45044","2021",4,4,0,168430.5,1839.25,101.5
"15291","45045","2021",3,3,0,165666.7,1840.667,90
"15292","45046","2021",8,7,1,179183.4,1377.375,133.25
"15293","45047","2021",4,4,0,182275,1683.75,116.75
"15294","45049","2021",19,19,0,169606.5,1495.526,114.5263
"15295","45050","2021",22,22,0,128805,1328,102.3182
"15296","45051","2021",32,31,1,184641.2,1971.562,98.46875
"15297","45052","2021",3,3,0,86000,795,110.3333
"15298","45053","2021",89,87,2,120652.7,1420.034,87.93258
"15299","45054","2021",12,12,0,168588.1,1690.417,102.1667
"15300","45055","2021",5,5,0,148800,1860.6,82
"15301","45056","2021",9,9,0,153248.3,1318.667,118.7778
"15302","45058","2021",2,2,0,262500,1495.5,175.5
"15303","45059","2021",1,1,0,175000,1316,133
"15304","45060","2021",16,16,0,137287.5,1247.812,109.1875
"15305","45061","2021",41,41,0,151418.9,1742.463,87.58537
"15306","45062","2021",14,12,2,216242.9,1945.071,112.5714
"15307","45063","2021",22,22,0,111850,1159.636,93.90909
"15308","45064","2021",14,14,0,153885.7,1438.929,103.5714
"15309","45065","2021",2,2,0,149100,1485,101
"15310","45066","2021",22,22,0,151246.4,1503.045,106.5
"15311","45067","2021",29,28,1,207644.1,2217.793,96.72414
"15312","45068","2021",152,138,14,116419.4,1529.289,77.93421
"15313","45069","2021",12,12,0,148466.7,1708.417,88.41667
"15314","45070","2021",2,2,0,44000,511.5,87
"15315","45072","2021",19,18,1,288372.8,2343.421,126.6316
"15316","45073","2021",8,8,0,118250,1628.75,84.625
"15317","45074","2021",3,3,0,162500,1344.667,122
"15318","45075","2021",172,115,57,180322.5,2098.355,86.61628
"15319","45076","2021",3,3,0,106666.7,1009.667,107.3333
"15320","45077","2021",14,14,0,122714.3,1361.5,94.35714
"15321","45078","2021",6,6,0,98166.67,983.5,99.5
"15322","45079","2021",9,9,0,108700,1283.889,85.66667
"15323","45080","2021",3,3,0,133166.7,2041.333,63.66667
"15324","45081","2021",10,10,0,132325,1379.4,104.4
"15325","45082","2021",150,113,37,167879.3,1968.567,88.42667
"15326","45083","2021",41,40,1,120285,1295.756,91.53659
"15327","45084","2021",7,7,0,141992.9,1462.429,90.85714
"15328","45085","2021",48,43,5,99593.75,1114.583,95.04167
"15329","45086","2021",2,2,0,118500,1252.5,102.5
"15330","45087","2021",53,51,2,105250,1226.868,85.54717
"15331","45088","2021",7,7,0,193571.4,1510.857,129.8571
"15332","45089","2021",140,122,18,215704.5,2265.307,96.31429
"15333","45091","2021",7,7,0,195400,1744.286,115.7143
"15334","45092","2021",19,19,0,195373.7,1989.211,108.4737
"15335","45093","2021",35,34,1,173878.9,1759.743,101.2857
"15336","45094","2021",3,3,0,264333.3,2030.667,148.6667
"15337","45095","2021",53,52,1,141858.2,1807.434,86.28302
"15338","45096","2021",13,13,0,242401.6,2654.462,122.6923
"15339","45097","2021",38,38,0,127711.8,1397.132,93.60526
"15340","45098","2021",46,46,0,222490.2,2019.5,116.8478
"15341","45099","2021",12,12,0,171443.3,1257.5,137.9167
"15342","45100","2021",8,8,0,290287.5,1824.25,166
"15343","45101","2021",1,1,0,60000,1304,46
"15344","45102","2021",5,5,0,212000,1491.6,137
"15345","45103","2021",26,26,0,133506.9,1577.423,85.23077
"15346","45104","2021",45,45,0,175229.9,1650.356,105.3778
"15347","45107","2021",7,7,0,138721.4,1435.286,104
"15348","45108","2021",33,32,1,156795.6,1612.152,96.84848
"15349","45109","2021",4,4,0,193428.5,1742.25,119.25
"15350","45110","2021",6,6,0,97718.83,1163.5,86.33333
"15351","45111","2021",9,9,0,136666.7,1577.889,90.33333
"15352","45112","2021",6,6,0,155291.7,1410.667,102
"15353","45113","2021",6,6,0,163466.7,970.8333,171
"15354","45114","2021",5,5,0,165650.6,1558,110
"15355","45115","2021",82,80,2,135303.9,1534.329,93.62195
"15356","45116","2021",22,22,0,127583.3,1379.136,96.04545
"15357","45118","2021",6,6,0,182956.7,1524.667,120.1667
"15358","45119","2021",34,34,0,160986,1591.412,109.0588
"15359","45121","2021",10,10,0,91699,1171.7,78.6
"15360","45122","2021",27,27,0,136386.7,1489.333,96
"15361","45123","2021",25,24,1,208652.6,2059.44,104.24
"15362","45124","2021",3,3,0,183000,1922.667,108
"15363","45126","2021",40,38,2,261302.6,2160.85,125.975
"15364","45127","2021",79,79,0,174159.6,1868.418,98.51899
"15365","45129","2021",33,32,1,104588.8,1309.515,79.45455
"15366","45130","2021",11,11,0,182550,1837.909,106.4545
"15367","45131","2021",14,14,0,125407.1,1565.286,86.71429
"15368","45132","2021",9,9,0,103823.3,1597.556,74.66667
"15369","45133","2021",8,8,0,156930.6,1413.75,111
"15370","45134","2021",27,27,0,171679.7,1463.444,123.2222
"15371","45135","2021",5,5,0,250600,1769.2,164
"15372","45136","2021",14,14,0,144777.1,1664.786,91.57143
"15373","45137","2021",16,16,0,156298.1,1562.5,97.6875
"15374","45138","2021",1,1,0,281000,3345,84
"15375","45139","2021",8,8,0,243343.8,1853.125,149
"15376","45141","2021",2,2,0,227500,1240.5,182
"15377","45142","2021",53,40,13,185560.2,1946.321,98.0566
"15378","45143","2021",1,1,0,147705,1231,120
"15379","45144","2021",18,18,0,186719.2,1882.278,107.1667
"15380","45145","2021",61,61,0,170527.9,1736.344,98.62295
"15381","45146","2021",101,93,8,195297.1,2145.04,89.52475
"15382","45147","2021",307,182,125,173699.9,2182.508,81.76873
"15383","45148","2021",31,31,0,146107.7,1616,91.35484
"15384","45149","2021",7,7,0,158084.3,2013.571,92.42857
"15385","45150","2021",2,2,0,184000,1356,136.5
"15386","45151","2021",4,4,0,129562.5,1272.75,101.25
"15387","45152","2021",3,3,0,157666.7,1810,99.66667
"15388","45153","2021",15,15,0,205749.5,1934.6,108
"15389","45154","2021",33,33,0,199054,2028.606,102.9697
"15390","45155","2021",191,154,37,113168.7,1328.702,86.30366
"15391","45156","2021",9,9,0,143722.2,1326.111,108.7778
"15392","45157","2021",4,4,0,167000,1526.25,119
"15393","45158","2021",4,4,0,142900,1192,121
"15394","45159","2021",4,4,0,226475,1731,136.5
"15395","45160","2021",12,12,0,147300,1518.917,100.3333
"15396","45161","2021",21,21,0,136060.8,1520.333,98.33333
"15397","45162","2021",5,5,0,119900,1533.4,79
"15398","45164","2021",12,12,0,177059.2,1669.333,107.1667
"15399","45165","2021",18,18,0,142466.7,1218.111,115.5556
"15400","45166","2021",5,5,0,228100,1523.2,150.8
"15401","45167","2021",19,19,0,220544.7,2021.368,117.7368
"15402","45168","2021",6,6,0,201280.7,1291,156.3333
"15403","45169","2021",90,81,9,215943.4,2328.244,97.93333
"15404","45170","2021",8,8,0,142896.2,1892.5,74.625
"15405","45171","2021",17,17,0,112112.4,1190.471,98.70588
"15406","45173","2021",59,51,8,193964.2,1906.458,106.9153
"15407","45174","2021",6,6,0,162656.8,1518.167,107.3333
"15408","45175","2021",20,20,0,261608.3,2038.8,132
"15409","45176","2021",11,11,0,166247.3,1448.273,123.4545
"15410","45177","2021",3,3,0,161125,1142.333,141
"15411","45178","2021",34,34,0,140916.5,1389.324,102.7941
"15412","45179","2021",46,45,1,185422.8,1884.37,102.4783
"15413","45182","2021",22,22,0,170580.9,1830,91.77273
"15414","45183","2021",2,2,0,136150,971.5,125
"15415","45184","2021",10,10,0,159810,1665.2,99.3
"15416","45185","2021",4,4,0,203500,1866,101.75
"15417","45186","2021",7,7,0,118714.3,1437,87.57143
"15418","45187","2021",55,54,1,124083.5,1373.236,93.2
"15419","45188","2021",24,24,0,212951.3,2068.833,106.5833
"15420","45189","2021",4,4,0,269875,1773,148.5
"15421","45191","2021",139,108,31,166382.8,1842.345,94.08633
"15422","45193","2021",29,29,0,197556.6,2073.379,97.41379
"15423","45194","2021",35,34,1,228683.6,2354.143,102.0571
"15424","45195","2021",10,10,0,169969,1528.2,104.5
"15425","45196","2021",16,16,0,234073.8,2492.5,94.0625
"15426","45197","2021",21,21,0,236601.4,2191.619,112
"15427","45198","2021",6,6,0,165083.3,1830,98.5
"15428","45199","2021",16,16,0,105581.2,1389.25,86.75
"15429","45200","2021",25,25,0,214419.9,2014.56,115.56
"15430","45201","2021",7,7,0,175179.1,1581.429,111.7143
"15431","45202","2021",10,10,0,205122.2,1796,122.3
"15432","45203","2021",93,77,16,171349.1,1955.409,88.8172
"15433","45204","2021",11,11,0,251318.2,2305.909,120.6364
"15434","45205","2021",6,6,0,110866.7,1316.667,84
"15435","45206","2021",8,8,0,188162.5,1657.25,113.75
"15436","45207","2021",7,7,0,150414.3,1327.429,114
"15437","45208","2021",296,115,181,110437.6,1465.318,77.11824
"15438","45209","2021",1,1,0,94000,1843,51
"15439","45210","2021",11,11,0,90063.64,1103.364,84.72727
"15440","45212","2021",23,23,0,148868.3,1539.087,101.6957
"15441","45213","2021",21,20,1,137701.8,1671.714,86.90476
"15442","45214","2021",3,3,0,146666.7,1500.667,101
"15443","45215","2021",5,5,0,101800,1334,76
"15444","45216","2021",3,3,0,179353.3,1448.667,128.3333
"15445","45217","2021",5,5,0,175560,1612,109.4
"15446","45218","2021",3,3,0,93166.67,1029.333,88.33333
"15447","45219","2021",4,4,0,133225,1455,92.75
"15448","45220","2021",18,18,0,148772.2,1462.167,107.6111
"15449","45222","2021",32,32,0,168525.9,1622.469,108.375
"15450","45223","2021",6,6,0,162166.7,1554.167,98
"15451","45224","2021",74,66,8,166295.7,1801.473,94.71622
"15452","45225","2021",9,9,0,173572.2,1474.444,117.2222
"15453","45226","2021",23,23,0,161653,1574.261,102.8696
"15454","45227","2021",19,19,0,164142.9,1325.316,125.8947
"15455","45228","2021",22,22,0,148482.4,1592.682,101.9091
"15456","45229","2021",62,62,0,125241.9,1415.855,92.06452
"15457","45230","2021",13,13,0,130723.1,1405.308,99.46154
"15458","45231","2021",3,3,0,139000,1257,124
"15459","45232","2021",439,207,232,211303.8,2508.278,85.29157
"15460","45233","2021",4,4,0,147125,1625.25,94
"15461","45234","2021",2210,570,1640,178264.4,2544.467,71.90633
"15462","45235","2021",43,37,6,227564.4,2250.116,103.5349
"15463","45237","2021",5,5,0,267660,2482.4,109.8
"15464","45238","2021",16,16,0,96925,1008.125,95.25
"15465","45239","2021",10,10,0,136077.1,1234.4,106
"15466","45240","2021",30,29,1,153881,1613.267,106.0333
"15467","45241","2021",3,3,0,199766.7,1775,112.6667
"15468","45242","2021",7,7,0,118300,1229.571,97.57143
"15469","45243","2021",8,8,0,127037.5,1467.25,88.375
"15470","45244","2021",55,54,1,142846.1,1410.564,104.5273
"15471","45245","2021",24,24,0,90720.88,1030.167,83.45833
"15472","45246","2021",5,5,0,161000,1577.4,102.8
"15473","45247","2021",60,60,0,167933,1795.25,95.78333
"15474","45248","2021",32,30,2,143084.9,1441.062,107.6562
"15475","45249","2021",18,18,0,162830.6,1490.667,114.1667
"15476","45250","2021",5,5,0,110100,1185.4,102.4
"15477","45251","2021",3,3,0,73185.33,1991,45.33333
"15478","45252","2021",100,61,39,135529.1,1678.98,80.78
"15479","45253","2021",19,19,0,152476.8,1487.053,102.2632
"15480","45254","2021",33,33,0,148328.7,1538.182,104.6667
"15481","45255","2021",8,8,0,182000,1671.5,115.375
"15482","45256","2021",1,1,0,105000,1544,68
"15483","45257","2021",5,5,0,103100,811.2,165.2
"15484","45258","2021",53,49,4,143776.9,1543.981,93.0566
"15485","45259","2021",13,13,0,114901.2,1376.846,87.92308
"15486","45260","2021",2,2,0,213750,1335.5,175
"15487","45261","2021",17,17,0,216745,1995.118,115.7059
"15488","45263","2021",4,4,0,133875,1389.5,113
"15489","45264","2021",6,6,0,211675,1905.167,116.6667
"15490","45265","2021",8,8,0,120250,1326.625,90.75
"15491","45266","2021",1,1,0,67000,1861,36
"15492","45268","2021",16,16,0,154057.5,1388.438,117.0625
"15493","45269","2021",64,62,2,208719.1,1967.672,108.5
"15494","45270","2021",27,27,0,181359.3,1783.259,106.4074
"15495","45271","2021",16,16,0,126765.6,1571.562,80
"15496","45272","2021",44,43,1,245408.6,2355.955,109.3182
"15497","45273","2021",60,55,5,191569.2,2097.183,93.86667
"15498","45274","2021",108,100,8,296817.1,2620.157,116.9537
"15499","45275","2021",14,14,0,111719.7,1140.286,99.92857
"15500","45276","2021",5,5,0,102728,1221.8,87.8
"15501","45277","2021",11,11,0,131761.8,1348.273,100.3636
"15502","45278","2021",28,28,0,120626.8,1314.286,95.32143
"15503","45279","2021",39,38,1,129962.4,1483.795,91.69231
"15504","45280","2021",18,18,0,136641.1,1464.167,95.5
"15505","45281","2021",20,20,0,128334.7,1389.6,94.65
"15506","45282","2021",45,41,4,280804.8,2556.333,110.5111
"15507","45284","2021",396,177,219,172576,2113.722,81.46465
"15508","45285","2021",261,139,122,148525.4,1949.697,77.27969
"15509","45286","2021",164,79,85,191771.3,2270.835,87.05488
"15510","45288","2021",9,9,0,118213.3,1344.444,83.11111
"15511","45289","2021",16,16,0,209773.8,1938.438,112.25
"15512","45290","2021",29,29,0,229579.3,1882.241,126.2759
"15513","45291","2021",15,15,0,153162.7,1594.067,100.3333
"15514","45292","2021",30,30,0,99702,1110.2,97.4
"15515","45293","2021",15,15,0,149972.1,1675.267,96.06667
"15516","45294","2021",1,1,0,158000,1612,98
"15517","45296","2021",11,11,0,193072.7,1684.364,115.5455
"15518","45297","2021",19,19,0,148395.8,1627.579,95.05263
"15519","45298","2021",70,63,7,252945.1,2378.914,110.5714
"15520","45299","2021",6,6,0,152833.3,1639.333,94.33333
"15521","45300","2021",41,40,1,246624.8,2479.024,108.6829
"15522","45301","2021",4,4,0,244000,1954.75,117.5
"15523","45302","2021",200,162,38,198908.3,2271.305,87.47
"15524","45303","2021",15,15,0,159716.7,1401.4,112.5333
"15525","45305","2021",1,1,0,95000,1508,63
"15526","45306","2021",15,15,0,123236.7,1552.533,81.4
"15527","45307","2021",25,25,0,155360.4,1405.32,113.28
"15528","45308","2021",25,22,3,261889.6,2421.4,109.56
"15529","45309","2021",17,17,0,168251.8,1696.235,99.64706
"15530","45310","2021",27,26,1,192030.1,2052.333,97.92593
"15531","45311","2021",19,19,0,174297,1640.158,107.8947
"15532","45312","2021",4,4,0,130775,1621,79.5
"15533","45313","2021",11,11,0,168530,1479.818,119.0909
"15534","45314","2021",10,10,0,165668,1632.6,106.2
"15535","45315","2021",85,73,12,140931.2,1541.271,93.91765
"15536","45316","2021",20,20,0,154454.8,1468.75,105.6
"15537","45317","2021",22,22,0,236380.8,2006.545,125.0455
"15538","45320","2021",14,14,0,211786.8,1964.714,112.2857
"15539","45321","2021",10,10,0,130567,1271.3,104.4
"15540","45322","2021",2,2,0,152500,1089,122
"15541","45323","2021",4,4,0,89475,1210.25,68.75
"15542","45324","2021",39,39,0,178658.8,1798.513,101.1282
"15543","45325","2021",6,6,0,143835,1644.167,96
"15544","45326","2021",8,8,0,138162.5,1612.75,90.875
"15545","45327","2021",55,55,0,208396,1981.273,108.2909
"15546","45328","2021",6,6,0,98983.33,1606.5,62.33333
"15547","45329","2021",28,28,0,109670.8,1241.464,96.03571
"15548","45330","2021",2,2,0,329005,2464,121.5
"15549","45331","2021",7,7,0,226785.7,1916.429,114.2857
"15550","45332","2021",34,34,0,126205.3,1515.853,87.97059
"15551","45333","2021",27,25,2,213361.8,2203.778,98.37037
"15552","45334","2021",13,13,0,207822.3,1908.692,108.8462
"15553","45335","2021",16,16,0,216448.1,2104.5,107.9375
"15554","45336","2021",14,14,0,170791.4,1665.286,96.35714
"15555","45337","2021",6,5,1,110850,1912.5,73.83333
"15556","45338","2021",51,46,5,156363.9,1704.569,99.62745
"15557","45339","2021",8,8,0,132987.5,1386.75,98.75
"15558","45340","2021",5,5,0,81900,992.6,82.8
"15559","45341","2021",3,3,0,137333.3,1472.333,96
"15560","45342","2021",5,5,0,198190,1992.8,101.4
"15561","45343","2021",5,5,0,134200,1435.2,94.8
"15562","45344","2021",20,20,0,174785,1457.75,119.5
"15563","45345","2021",19,19,0,154025.4,1716.842,88.15789
"15564","45346","2021",44,43,1,175158.4,1933.432,95.88636
"15565","45347","2021",16,16,0,162109.4,1554.125,109.9375
"15566","45348","2021",13,13,0,174278.2,1251.154,142.9231
"15567","46001","2021",9,9,0,161118.9,1285.889,96.88889
"15568","46002","2021",2,2,0,68500,847,71.5
"15569","46003","2021",11,10,1,148709.1,1883,89.90909
"15570","46004","2021",3,3,0,132433.3,1154,113.6667
"15571","46005","2021",9,9,0,188100.6,1553.444,115.6667
"15572","46006","2021",6,6,0,158925,1768.333,103.8333
"15573","46007","2021",8,8,0,203047.6,1709.875,118.875
"15574","46008","2021",3,3,0,262473.3,1612.333,164.3333
"15575","46009","2021",18,18,0,154644.4,1601.278,93.66667
"15576","46010","2021",5,5,0,478459,3642.4,130.4
"15577","46011","2021",8,8,0,88716.25,1273.875,80.5
"15578","46012","2021",9,9,0,129733.3,1344.667,110.7778
"15579","46013","2021",6,6,0,136348.3,1610.833,86.66667
"15580","46015","2021",24,24,0,97510.83,1078.833,91.625
"15581","46016","2021",1,1,0,127700,1403,91
"15582","46017","2021",2,2,0,189325,2230,85
"15583","46018","2021",2,2,0,128000,1201.5,104.5
"15584","46020","2021",3,3,0,219166.7,1601.667,134.6667
"15585","46021","2021",12,12,0,169033.3,1537.833,113.25
"15586","46022","2021",6,6,0,175151.7,2013.833,96.66667
"15587","46023","2021",2,2,0,61500,937.5,70
"15588","46024","2021",2,2,0,101428.5,1659.5,56.5
"15589","46026","2021",1,1,0,276000,1758,157
"15590","46027","2021",4,4,0,175500,1687.25,109.25
"15591","46028","2021",21,21,0,161703.7,1432.762,107.8095
"15592","46029","2021",27,26,1,128763,1391.185,92.85185
"15593","46030","2021",2,2,0,88985,1085,65.5
"15594","46031","2021",4,4,0,101062.5,1393.75,91
"15595","46032","2021",8,8,0,223243.8,1775.375,120.125
"15596","46033","2021",13,13,0,147407.1,1595.846,107.1538
"15597","46034","2021",7,7,0,155525.4,1537.286,94.57143
"15598","46035","2021",2,2,0,170000,1693,100.5
"15599","46036","2021",4,4,0,132500,1164.25,107.5
"15600","46037","2021",6,6,0,167000,1502.833,98.83333
"15601","46038","2021",17,17,0,141092.4,1572.118,90.17647
"15602","46039","2021",2,2,0,147000,1688,94.5
"15603","46040","2021",2,2,0,146150,1296,104.5
"15604","46041","2021",2,2,0,51500,1367.5,43.5
"15605","46042","2021",411,205,206,131587.6,1573.757,82.52798
"15606","46044","2021",10,9,1,176410,1799.8,107.3
"15607","46045","2021",22,21,1,162745.4,1628.636,100.7727
"15608","46046","2021",5,5,0,216920,1840.8,107.2
"15609","46047","2021",6,6,0,146333.3,1236.667,123.1667
"15610","46049","2021",7,7,0,205335.7,1758.571,117.8571
"15611","46050","2021",2,2,0,148500,2070.5,72.5
"15612","46051","2021",2,2,0,153847.5,1427,106
"15613","46052","2021",3,3,0,173233.3,1635,109.6667
"15614","46053","2021",8,8,0,107250,1202.875,84.875
"15615","46054","2021",3,3,0,194333.3,1760,110.3333
"15616","46055","2021",19,18,1,159357.8,1518.263,102.4737
"15617","46057","2021",17,17,0,168500,1687.294,104.2353
"15618","46058","2021",11,11,0,208877.3,1708,124.7273
"15619","46059","2021",5,4,1,220670,2338.8,118.8
"15620","46060","2021",4,4,0,225687.5,2193,104.75
"15621","46061","2021",3,3,0,275383.3,1636.667,144
"15622","46062","2021",12,12,0,181262.5,1430.667,124.3333
"15623","46063","2021",27,26,1,206186.3,1863.926,116.9259
"15624","46064","2021",20,20,0,158704,1512.9,105.05
"15625","46065","2021",8,8,0,157460.9,1508,98.875
"15626","46066","2021",17,17,0,189282.6,1589.647,125.4118
"15627","46068","2021",2,2,0,150200,792.5,207.5
"15628","46069","2021",4,4,0,288339.2,1975,142.5
"15629","46070","2021",10,10,0,189148,1893.5,108.4
"15630","46072","2021",7,7,0,138635.7,1472.286,99.42857
"15631","46073","2021",5,5,0,110400,1358,78.6
"15632","46074","2021",5,5,0,95720,1124.8,80.4
"15633","46075","2021",5,5,0,180420,1864.8,87.2
"15634","46076","2021",7,7,0,158971.4,1549.571,98.42857
"15635","46078","2021",2,2,0,171000,2214.5,75.5
"15636","46079","2021",5,5,0,177928,1691.4,105.6
"15637","46080","2021",9,9,0,276228.4,2280.333,129.1111
"15638","46081","2021",4,4,0,205900.8,2205.25,89.25
"15639","46082","2021",2,2,0,102675,1095.5,97
"15640","46083","2021",18,18,0,193846.1,1959.667,106.2778
"15641","46084","2021",11,11,0,237413.6,1678.636,133
"15642","46085","2021",6,6,0,92833.33,1197.333,78
"15643","46086","2021",3,3,0,181000,2093.667,101.3333
"15644","46087","2021",19,19,0,129397.6,1282,100.1579
"15645","46088","2021",10,10,0,156847,1286.1,124.2
"15646","46089","2021",27,27,0,142598.8,1494,94.85185
"15647","46090","2021",4,4,0,117348.8,1722.5,65.25
"15648","46091","2021",3,3,0,141166.7,1649,82.66667
"15649","46092","2021",2,2,0,155660,1184.5,130.5
"15650","46093","2021",2,2,0,84000,1178,67.5
"15651","46094","2021",6,6,0,110316.7,1291.5,86.16667
"15652","46095","2021",11,11,0,191063.5,1658.545,117.1818
"15653","46098","2021",7,7,0,239085.7,1933.714,124.2857
"15654","46100","2021",9,9,0,176966.7,1968.778,104.1111
"15655","46101","2021",2,2,0,112315,1265,92
"15656","46102","2021",145,98,47,136166.3,1664.214,84.84138
"15657","46103","2021",8,8,0,155812.5,1662.75,96.75
"15658","46104","2021",4,4,0,130755,1344.25,88.75
"15659","46105","2021",10,10,0,235651.7,1749.8,137.7
"15660","46106","2021",7,7,0,129756.3,1584.714,86
"15661","46107","2021",3,3,0,221666.7,2270.333,116.6667
"15662","46108","2021",8,8,0,150562.5,1738.5,88.375
"15663","46109","2021",9,9,0,219472.2,1957.778,115.3333
"15664","46111","2021",4,4,0,179787.5,1891.75,95.25
"15665","46112","2021",4,4,0,204323.8,1969.5,95.75
"15666","46113","2021",10,10,0,210589.5,1813.6,110.1
"15667","46114","2021",6,6,0,148881.3,1873.667,85.33333
"15668","46115","2021",3,3,0,53333.33,718.3333,74.33333
"15669","46116","2021",1,1,0,98000,1089,90
"15670","46117","2021",10,10,0,115150,1154.4,96.4
"15671","46118","2021",7,7,0,151428.6,1422.714,110.1429
"15672","46120","2021",4,4,0,255025,1720.5,136.5
"15673","46121","2021",1,1,0,67000,893,75
"15674","46122","2021",1,1,0,75000,938,80
"15675","46123","2021",4,4,0,159652.5,1424.5,108
"15676","46124","2021",1,1,0,247130,2149,115
"15677","46125","2021",14,14,0,145704.3,1428.714,98.78571
"15678","46126","2021",5,5,0,129516.2,1543.4,77.4
"15679","46127","2021",97,82,15,124815.8,1414.155,88.83505
"15680","46128","2021",53,43,10,131548.5,1532.358,89.73585
"15681","46129","2021",5,5,0,144300,1451.2,100.8
"15682","46130","2021",3,3,0,200037,1373.333,126.6667
"15683","46131","2021",7,7,0,190075.7,1659.143,122
"15684","46132","2021",5,5,0,122661.6,1533.8,91.6
"15685","46133","2021",6,6,0,187581,1820.5,103.3333
"15686","46134","2021",7,7,0,214645.7,1567,122.1429
"15687","46136","2021",3,3,0,135700,1414.667,118.3333
"15688","46137","2021",9,9,0,261825.8,2043.333,122.5556
"15689","46138","2021",21,21,0,156631.9,1683.476,114.7143
"15690","46139","2021",3,3,0,112333.3,1482.667,74
"15691","46140","2021",6,6,0,264408.3,1987.167,134.5
"15692","46142","2021",4,4,0,148125,1412,107.75
"15693","46143","2021",23,23,0,128851.9,1261.174,115.8261
"15694","46144","2021",4,4,0,127270,1481,102.75
"15695","46145","2021",17,17,0,127770.9,1273.765,99.94118
"15696","46146","2021",1,1,0,187000,2429,77
"15697","46147","2021",2,2,0,242475,1699.5,151
"15698","46148","2021",29,29,0,190278.3,1861.862,107.8276
"15699","46149","2021",8,8,0,191690,1856.75,104.625
"15700","46151","2021",2,2,0,228750,1530.5,152
"15701","46152","2021",5,5,0,218390,2349,96.4
"15702","46153","2021",11,11,0,157727.3,1768.727,89.54545
"15703","46154","2021",6,6,0,115975,1313.667,89.83333
"15704","46155","2021",1,1,0,114000,2280,50
"15705","46156","2021",19,18,1,119947.5,1243.737,100.2105
"15706","46157","2021",1,1,0,105000,621,169
"15707","46159","2021",2,2,0,152500,1346,110
"15708","46160","2021",3,3,0,78500,965,82
"15709","46161","2021",6,6,0,171983.3,1176.833,146
"15710","46162","2021",3,3,0,128333.3,2250.333,53.33333
"15711","46163","2021",7,7,0,78857.14,996.8571,83.71429
"15712","46164","2021",4,4,0,145675,1400.75,109.5
"15713","46165","2021",4,4,0,177683.2,1595.25,115.75
"15714","46167","2021",1,1,0,107500,717,150
"15715","46168","2021",3,3,0,96000,1362,73
"15716","46169","2021",6,6,0,148083.3,1587.667,87.5
"15717","46170","2021",14,14,0,133906.3,1238.857,109.3571
"15718","46171","2021",4,4,0,221392.5,2147.75,104
"15719","46172","2021",4,4,0,157879.2,1796,91
"15720","46173","2021",18,16,2,138613.6,1441.833,99.88889
"15721","46174","2021",7,7,0,136367.4,1249,109
"15722","46175","2021",14,13,1,171107.1,1903.214,97.78571
"15723","46176","2021",7,7,0,124658.6,1402.429,88.14286
"15724","46177","2021",13,12,1,178103.8,1604.692,112.4615
"15725","46178","2021",3,3,0,204666.7,1537,128.6667
"15726","46179","2021",1,1,0,153950,1100,140
"15727","46180","2021",4,4,0,205750,1406.5,123.25
"15728","46181","2021",1,1,0,289000,2369,122
"15729","46182","2021",26,24,2,145272.2,1494.846,99.84615
"15730","46183","2021",6,6,0,142500,1516.167,104
"15731","46184","2021",10,10,0,236603.4,1640.4,144.6
"15732","46185","2021",21,19,2,206728.6,2036.476,105.2381
"15733","46186","2021",5,5,0,145280,1623.2,89.2
"15734","46187","2021",12,12,0,172235,1691.167,110
"15735","46188","2021",2,2,0,148000,1400,106.5
"15736","46189","2021",10,10,0,164795,1648.5,101.1
"15737","46190","2021",2,2,0,250878,3621.5,72.5
"15738","46191","2021",16,16,0,173652.5,1588.438,104.4375
"15739","46192","2021",5,5,0,137620,1554.6,89.4
"15740","46193","2021",6,6,0,140283.3,1361.167,111.6667
"15741","46194","2021",6,6,0,221350,1791,117.8333
"15742","46195","2021",7,7,0,96568.57,1115,89.85714
"15743","46196","2021",1,1,0,112000,2489,45
"15744","46197","2021",14,14,0,250214.3,1881.929,135
"15745","46198","2021",7,7,0,174700,1545.429,110.2857
"15746","46199","2021",7,7,0,196200,1756.143,114.5714
"15747","46200","2021",5,5,0,221685.6,1977.2,111.2
"15748","46201","2021",46,45,1,192047.2,1626.804,126.1957
"15749","46202","2021",4,4,0,184575,1626.5,112.25
"15750","46204","2021",6,6,0,157694.7,1177.333,139.8333
"15751","46205","2021",5,5,0,286199.6,1750,153.8
"15752","46206","2021",2,2,0,215000,1611,120
"15753","46207","2021",2,2,0,170782.5,936.5,160
"15754","46208","2021",15,15,0,145768,1403.867,100.6
"15755","46209","2021",3,3,0,154530,1216.333,124
"15756","46210","2021",1,1,0,168000,1680,100
"15757","46211","2021",5,5,0,157220,1707.8,96
"15758","46212","2021",2,2,0,77500,1127,67
"15759","46213","2021",6,6,0,275101.7,1469.333,169.3333
"15760","46214","2021",4,4,0,165850,1417,128.75
"15761","46215","2021",14,14,0,167529.4,1384,125.2143
"15762","46216","2021",18,18,0,182522.2,1549.278,117.8889
"15763","46217","2021",3,3,0,108000,1306.667,83
"15764","46218","2021",4,4,0,125375,1730.25,76
"15765","46219","2021",6,6,0,194941.2,1412.833,131
"15766","46220","2021",13,13,0,138074.3,1554.615,94.38462
"15767","46221","2021",9,9,0,180366.7,1763.444,107.8889
"15768","46222","2021",4,4,0,296528.8,2466.75,124.25
"15769","46223","2021",4,4,0,165280.8,1588.5,104.25
"15770","46224","2021",46,35,11,178469.7,1747.109,99.78261
"15771","46225","2021",62,61,1,203161.4,2061.177,105.3226
"15772","46226","2021",6,6,0,154916.7,1242.167,117.5
"15773","46227","2021",1,1,0,129500,1439,90
"15774","46228","2021",9,9,0,154055.6,1989.667,90.55556
"15775","46229","2021",16,16,0,112373.1,1181.812,92.875
"15776","46230","2021",2,2,0,141000,1369.5,100.5
"15777","46231","2021",46,45,1,133874.5,1447.891,94.54348
"15778","46232","2021",21,21,0,163507,1622.476,102.3333
"15779","46233","2021",3,3,0,280000,1682,134.6667
"15780","46234","2021",2,2,0,195500,2656.5,68
"15781","46235","2021",1,1,0,77000,1283,60
"15782","46236","2021",9,9,0,199053,1619,127.7778
"15783","46237","2021",1,1,0,380000,1979,192
"15784","46238","2021",5,5,0,133500,1210.8,120.4
"15785","46239","2021",7,7,0,116500,1352.429,92.28571
"15786","46240","2021",8,7,1,203900,2896.875,94.75
"15787","46241","2021",5,5,0,137260,1535.6,89.6
"15788","46242","2021",1,1,0,140200,1375,102
"15789","46243","2021",5,5,0,114330,1031,103.4
"15790","46244","2021",1,1,0,165000,1650,100
"15791","46245","2021",2,2,0,96250,1194,80.5
"15792","46247","2021",3,3,0,249000,1828,168
"15793","46249","2021",3,3,0,91700,1057.667,94.33333
"15794","46250","2021",1,1,0,91000,2275,40
"15795","46251","2021",54,43,11,140250.9,1564.778,89.74074
"15796","46252","2021",6,6,0,206515,1968,115.3333
"15797","46253","2021",4,4,0,153240,1498,104.5
"15798","46254","2021",1,1,0,78000,557,140
"15799","46255","2021",4,4,0,121625,1240.75,94
"15800","46256","2021",5,5,0,237600,3221.4,103.6
"15801","46257","2021",4,4,0,175361.2,1812.5,96.75
"15802","46258","2021",1,1,0,130000,1287,101
"15803","46259","2021",2,2,0,232475,2149,130
"15804","46260","2021",2,2,0,127500,1641.5,86.5
"15805","46262","2021",10,10,0,213260,1596.2,118.6
"15806","46263","2021",15,15,0,169060.3,1387.8,112.6667
"15807","46265","2021",5,5,0,107900,2029.4,68.4
"15808","46266","2021",1,1,0,215000,1792,120
"15809","46267","2021",13,13,0,166195.4,1655.692,96
"15810","46268","2021",19,19,0,139961.6,1371.526,103.6842
"15811","46269","2021",1,1,0,42000,1200,35
"15812","46270","2021",9,9,0,107888.9,1176.889,92.22222
"15813","46271","2021",1,1,0,133000,1529,87
"15814","46272","2021",2,2,0,162930,2885.5,91.5
"15815","46273","2021",15,15,0,155441.9,1616.267,100.9333
"15816","46276","2021",3,3,0,114643.3,1108.333,104.6667
"15817","46277","2021",5,5,0,300350,1900.2,145
"15818","46279","2021",1,1,0,75000,1442,52
"15819","46280","2021",6,6,0,345574.7,2230.167,159
"15820","46281","2021",3,3,0,141333.3,1187.333,125.6667
"15821","46283","2021",3,3,0,202333.3,1648.333,116.6667
"15822","46284","2021",3,3,0,132000,1996,75
"15823","46286","2021",1,1,0,356400,1980,180
"15824","46288","2021",1,1,0,168800,1876,90
"15825","46289","2021",6,6,0,115628.3,1288,91.16667
"15826","46290","2021",7,7,0,135174.1,1421.286,107.2857
"15827","46292","2021",1,1,0,150000,1000,150
"15828","46293","2021",12,12,0,142247.5,1396,106
"15829","46294","2021",5,5,0,227000,2170.4,109.2
"15830","46295","2021",5,5,0,129678,1180.6,110.8
"15831","46296","2021",4,4,0,101250,1416.5,73
"15832","46297","2021",29,28,1,139805.1,1482.793,92.68966
"15833","46299","2021",4,4,0,180693.8,1906.75,97.5
"15834","46301","2021",10,10,0,122101.5,1293.9,99.2
"15835","46302","2021",2,2,0,88750,860,102.5
"15836","46303","2021",3,3,0,354473.3,3951.333,81.66667
"15837","46304","2021",4,4,0,153327.5,1991.5,87
"15838","46305","2021",5,5,0,227337.6,2271.4,109.8
"15839","46306","2021",4,4,0,151657.5,1686,98.25
"15840","46307","2021",12,12,0,179742.5,1536.167,130.25
"15841","46308","2021",2,2,0,242500,1798,121
"15842","46309","2021",48,38,10,115304.4,1282.062,97.8125
"15843","46310","2021",1,1,0,280000,2772,101
"15844","46311","2021",27,27,0,113777.6,1153.407,108.4074
"15845","46312","2021",8,7,1,213100.4,1455,150
"15846","46313","2021",7,7,0,121857.1,1614,81.28571
"15847","46315","2021",4,4,0,79750,873.5,89.5
"15848","46316","2021",13,13,0,148918.9,1579.308,95.84615
"15849","46317","2021",5,5,0,172600,1707.2,101.2
"15850","46318","2021",8,8,0,102769,1154.875,106.25
"15851","46320","2021",9,8,1,180094.4,1493,132.7778
"15852","46321","2021",3,3,0,160000,1583.333,97.66667
"15853","46322","2021",7,7,0,201328.6,1871.286,118
"15854","46323","2021",1,1,0,2e+05,2381,84
"15855","46324","2021",9,9,0,157183.9,1518.111,97.77778
"15856","46328","2021",4,4,0,229000,1975,125.5
"15857","46329","2021",8,8,0,151725.8,1394.375,113.875
"15858","46330","2021",22,22,0,153977.8,1407.545,107.4091
"15859","46332","2021",5,5,0,162740,1442.2,111.4
"15860","46333","2021",2,2,0,133000,1366,100
"15861","46334","2021",25,25,0,174401.2,1682.16,102.4
"15862","46335","2021",4,4,0,179200.5,1556.25,114.75
"15863","46336","2021",6,6,0,179670,1545,115.8333
"15864","46337","2021",3,3,0,153633.3,2193,73.33333
"15865","46338","2021",1,1,0,229100,8485,27
"15866","46339","2021",2,2,0,129500,1225,95
"15867","46340","2021",10,10,0,199631,1934.1,111.7
"15868","47001","2021",772,268,504,121200.3,1687.412,72.75
"15869","47002","2021",3,3,0,109600,1619.667,92.66667
"15870","47003","2021",13,13,0,227206.5,1754.308,128.6154
"15871","47004","2021",59,55,4,111481.2,1123.814,101.0339
"15872","47005","2021",15,14,1,119083,1146.8,112
"15873","47006","2021",10,10,0,279835,2339.9,133.1
"15874","47007","2021",2,2,0,210720,1904.5,120.5
"15875","47008","2021",3,3,0,195000,1777.667,108
"15876","47009","2021",4,4,0,215000,1379.25,165.75
"15877","47010","2021",3,3,0,131984,1100,120
"15878","47011","2021",5,5,0,194184,1734.2,114.8
"15879","47012","2021",6,6,0,204966.7,1730.833,122
"15880","47013","2021",8,8,0,229362.5,1721.25,136.875
"15881","47014","2021",3,3,0,189648,1768.333,109.3333
"15882","47015","2021",31,30,1,154549.3,1560.065,103.6129
"15883","47016","2021",17,17,0,211417.7,1905.235,116.5294
"15884","47017","2021",4,4,0,209750,1718,120.75
"15885","47018","2021",3,3,0,208829.3,1864.667,120.6667
"15886","47019","2021",15,14,1,205219.3,1871.667,110.5333
"15887","47020","2021",5,5,0,232900,1790.6,127.4
"15888","47021","2021",25,23,2,129589.1,1330.36,97.56
"15889","47022","2021",7,7,0,126857.1,1109,112.7143
"15890","47023","2021",2,2,0,315734,3276.5,96.5
"15891","47024","2021",22,22,0,203033.7,1896.682,106.0909
"15892","47025","2021",13,13,0,245799.4,1780.154,140.7692
"15893","47026","2021",4,4,0,190750,2064.5,106
"15894","47027","2021",48,48,0,148214.1,1576.812,94.16667
"15895","47028","2021",9,9,0,188577.8,1411.222,135.8889
"15896","47029","2021",9,9,0,149028.3,1628.556,92.55556
"15897","47031","2021",57,46,11,183797.5,1876.86,100.1404
"15898","47032","2021",83,77,6,190208.6,1892.663,100.2048
"15899","47033","2021",6,6,0,161385.8,1415.167,114.5
"15900","47034","2021",10,10,0,161127.5,1525.5,107.5
"15901","47035","2021",5,5,0,177300,1185.4,140.4
"15902","47036","2021",4,4,0,177000,1423,113.5
"15903","47037","2021",8,8,0,224590.4,1876.375,117.125
"15904","47038","2021",8,8,0,147600,1224.625,138.375
"15905","47039","2021",2,2,0,151854,1049,160
"15906","47040","2021",30,30,0,220189.7,2007.033,106.8
"15907","47041","2021",5,5,0,150000,1282.6,129.6
"15908","47042","2021",3,3,0,201433.3,1701.667,126.6667
"15909","47043","2021",18,16,2,115050,1189.333,101.3889
"15910","47044","2021",7,7,0,206360,1361.286,154.4286
"15911","47045","2021",10,10,0,168400,1502.9,120.4
"15912","47046","2021",8,8,0,102740.8,1016.25,99.25
"15913","47048","2021",24,24,0,147161.4,1322.833,105.25
"15914","47049","2021",24,23,1,145704.2,1168.542,125.5833
"15915","47050","2021",1,1,0,465000,1954,238
"15916","47051","2021",33,26,7,166242.4,1843.212,91.42424
"15917","47052","2021",74,56,18,154029.6,1602.23,95.36486
"15918","47053","2021",7,7,0,291835,2234.429,130.7143
"15919","47054","2021",24,23,1,149458.4,1379.708,111.5833
"15920","47055","2021",12,8,4,142527.5,1553.167,105.5
"15921","47056","2021",10,10,0,205729.8,1772.3,119.4
"15922","47057","2021",30,29,1,136494.8,1235.267,118.9
"15923","47058","2021",3,3,0,196250,1600,123.3333
"15924","47059","2021",4,4,0,158850,1699.75,95
"15925","47060","2021",9,9,0,177294.9,1627.222,114.6667
"15926","47061","2021",9,9,0,197605.6,1775.778,118.4444
"15927","47062","2021",8,8,0,208392.5,2059.5,103.25
"15928","47063","2021",1,1,0,205000,1640,125
"15929","47064","2021",2,2,0,116175,933,124.5
"15930","47065","2021",43,42,1,124217.8,1244.07,101.6977
"15931","47066","2021",8,8,0,182075,1643.125,120.375
"15932","47067","2021",5,5,0,153600,1464.8,110.2
"15933","47068","2021",26,25,1,131853.2,1182.269,112.3462
"15934","47069","2021",47,44,3,157757.4,1631.957,99.48936
"15935","47070","2021",13,13,0,119928.6,1276.538,96.23077
"15936","47071","2021",2,2,0,277399,1351,207
"15937","47072","2021",2,2,0,137550,1560.5,89
"15938","47073","2021",2,2,0,441000,2352,163
"15939","47074","2021",2,2,0,105294,1018.5,103.5
"15940","47075","2021",11,11,0,184888.2,1641.273,110.9091
"15941","47076","2021",1,1,0,218390,1527,143
"15942","47077","2021",9,9,0,222803.3,1907.111,120.1111
"15943","47078","2021",22,20,2,123479.1,1120.409,108
"15944","47079","2021",9,9,0,148355.6,1481.222,114.8889
"15945","47080","2021",2,2,0,220250,1360,157
"15946","47081","2021",12,12,0,155833.3,1310.917,111.4167
"15947","47082","2021",8,8,0,218756,2034.125,112.25
"15948","47083","2021",1,1,0,245000,1713,143
"15949","47084","2021",8,8,0,171181.2,1603.25,104.625
"15950","47085","2021",7,7,0,135928.6,1347.857,105
"15951","47086","2021",27,17,10,116693.1,2420.926,77.22222
"15952","47087","2021",2,2,0,166000,2080,115.5
"15953","47088","2021",7,5,2,86512.57,1115.857,73.28571
"15954","47090","2021",5,5,0,226100,1565.2,150.8
"15955","47091","2021",40,29,11,166450.9,1867.25,90.35
"15956","47092","2021",1,1,0,40000,519,77
"15957","47093","2021",5,5,0,165780,1473.6,119.8
"15958","47094","2021",5,5,0,142104.2,1609.4,90.4
"15959","47095","2021",8,8,0,150858.8,1113.375,141.5
"15960","47096","2021",4,4,0,134750,1461,89.25
"15961","47097","2021",15,15,0,150368.7,1120.267,130.6667
"15962","47098","2021",2,2,0,289705,1632,177.5
"15963","47099","2021",9,8,1,163923.3,1177.667,132.7778
"15964","47100","2021",82,78,4,224331.9,1977.476,118.9756
"15965","47101","2021",11,11,0,188481.8,1791.455,113.1818
"15966","47102","2021",12,12,0,145870.5,1406.75,132.8333
"15967","47103","2021",4,4,0,195000,1631.5,115
"15968","47104","2021",1,1,0,86000,956,90
"15969","47105","2021",5,5,0,114676,1245.8,95.8
"15970","47106","2021",78,73,5,132430.6,1221.744,102.1282
"15971","47107","2021",7,7,0,213428.6,1462.571,139.7143
"15972","47109","2021",7,7,0,265491.4,1929.857,144.8571
"15973","47110","2021",18,18,0,152621,1327.889,117.1111
"15974","47111","2021",7,7,0,115771.4,1137.429,102.7143
"15975","47112","2021",5,5,0,123520,1130.4,104.4
"15976","47114","2021",4,4,0,193750,2011.25,97.25
"15977","47115","2021",4,4,0,130112.5,1229,110.25
"15978","47117","2021",20,20,0,200987.5,1647.15,122.15
"15979","47118","2021",1,1,0,50000,833,60
"15980","47119","2021",21,20,1,100964.8,983.8095,103.4762
"15981","47120","2021",1,1,0,111111,1029,108
"15982","47121","2021",4,4,0,177945,1433.75,130.75
"15983","47122","2021",2,2,0,209000,1591.5,108.5
"15984","47123","2021",8,8,0,121999.9,1087.375,116.875
"15985","47124","2021",3,3,0,149666.7,1931.333,82.66667
"15986","47125","2021",7,7,0,186142.9,1309.857,153.7143
"15987","47127","2021",11,11,0,182910.9,1836.364,105.5455
"15988","47128","2021",16,10,6,117578.1,1476.812,80.1875
"15989","47129","2021",2,2,0,147500,1541.5,95
"15990","47130","2021",9,9,0,162000,1236.444,129.2222
"15991","47131","2021",4,4,0,167950,1306.75,157.25
"15992","47132","2021",5,5,0,120751.4,1164.2,115
"15993","47133","2021",2,2,0,143575,1319,108.5
"15994","47134","2021",6,6,0,117233.3,1222.833,105.5
"15995","47135","2021",9,9,0,160788.9,1394.778,125.1111
"15996","47136","2021",2,2,0,273925,1635.5,175
"15997","47137","2021",14,13,1,168470.7,1881.5,92.71429
"15998","47138","2021",23,22,1,192985.7,1730.217,115.087
"15999","47140","2021",11,11,0,197251.8,1702.364,114.0909
"16000","47141","2021",5,5,0,194803.2,1739.8,123
"16001","47142","2021",18,18,0,169173.3,1275.167,139.0556
"16002","47143","2021",51,47,4,121610.7,1329.039,97.21569
"16003","47144","2021",13,13,0,170500,1463.923,120.3846
"16004","47145","2021",75,58,17,172487.6,1817.573,91.30667
"16005","47146","2021",23,22,1,218294.5,1775.348,125.0435
"16006","47147","2021",11,11,0,218672.9,1318.364,158.3636
"16007","47148","2021",2,2,0,135000,1237,103.5
"16008","47150","2021",6,6,0,229366.7,1457.667,166.5
"16009","47151","2021",7,7,0,256246.4,1532.429,158.4286
"16010","47152","2021",5,5,0,255600,1827.8,134.2
"16011","47154","2021",2,2,0,224650,1890,120.5
"16012","47155","2021",6,6,0,230833.3,1959.5,147.1667
"16013","47156","2021",10,10,0,162165,1410.1,115
"16014","47157","2021",380,274,106,130015.8,1514.676,84.60526
"16015","47158","2021",1,1,0,132100,1573,84
"16016","47159","2021",22,21,1,111728.8,1071.955,103.1364
"16017","47160","2021",3,3,0,166283.3,2023.333,80.66667
"16018","47161","2021",3,3,0,163800,1548.333,102
"16019","47162","2021",2,2,0,189837.5,1537,123.5
"16020","47163","2021",2,2,0,114905,1069.5,96
"16021","47164","2021",2,2,0,162500,1685.5,117
"16022","47165","2021",15,15,0,140978.7,1345.667,107.4667
"16023","47167","2021",30,30,0,120343.3,1170.5,108.6
"16024","47168","2021",72,67,5,95803.44,1126.75,86.40278
"16025","47169","2021",15,15,0,241056.7,1721.733,140.2
"16026","47170","2021",13,13,0,116783.8,1180.538,107.8462
"16027","47171","2021",4,4,0,103250,1344.5,77
"16028","47172","2021",6,6,0,188915,1527.667,129.6667
"16029","47173","2021",15,15,0,171480,1501.133,124.6
"16030","47174","2021",13,13,0,195892.2,1716.077,134.6154
"16031","47175","2021",62,60,2,142878.5,1356.355,97.25806
"16032","47176","2021",2,2,0,166500,1343.5,125
"16033","47177","2021",3,3,0,71450,866.3333,94.33333
"16034","47178","2021",6,6,0,192415,1772.5,107.6667
"16035","47179","2021",39,36,3,111459,1132.821,100.3333
"16036","47180","2021",4,4,0,243375,1974.25,125
"16037","47181","2021",9,9,0,244625.9,2457.444,103.2222
"16038","47182","2021",1,1,0,568500,1895,300
"16039","47183","2021",6,6,0,209476,1619.667,141.6667
"16040","47184","2021",8,8,0,263699.8,1964.375,132.625
"16041","47185","2021",42,42,0,131710.1,1365.571,100.0238
"16042","47186","2021",13,13,0,240879.6,1619.615,143.0769
"16043","47187","2021",5,5,0,232743.8,1600.8,139.2
"16044","47188","2021",1,1,0,182000,1468,124
"16045","47190","2021",13,13,0,124984.6,1356.538,94.15385
"16046","47191","2021",11,11,0,217222.3,1885.909,115
"16047","47193","2021",3,3,0,255666.7,1552,162
"16048","47194","2021",10,10,0,199671.3,1689.3,117.4
"16049","47195","2021",115,93,22,127944.5,1485.748,93.05217
"16050","47196","2021",4,4,0,123638.8,1079.5,115.75
"16051","47197","2021",5,5,0,298471.8,1874.8,142
"16052","47198","2021",7,7,0,174208.3,1603.429,102.7143
"16053","47199","2021",15,15,0,219191.8,1419.8,145.2
"16054","47200","2021",1,1,0,275000,2115,130
"16055","47201","2021",194,171,23,147084.6,1743.088,87.13402
"16056","47202","2021",2,2,0,160717.5,1262.5,131.5
"16057","47203","2021",40,38,2,210776.5,1728.175,121.1
"16058","47204","2021",3,3,0,122316.7,1205.667,97.66667
"16059","47205","2021",4,4,0,134556,1340.75,93.25
"16060","47206","2021",8,8,0,161250,1372.25,122.125
"16061","47207","2021",2,2,0,146750,1069,117.5
"16062","47208","2021",5,5,0,114376,1579.6,74.8
"16063","47209","2021",58,53,5,152853.7,1697.672,89.25862
"16064","47210","2021",26,25,1,98032.73,1000.115,95.42308
"16065","47211","2021",2,2,0,202000,1338.5,155.5
"16066","47212","2021",5,5,0,162170.6,1471.6,108.6
"16067","47213","2021",15,15,0,209484.5,1705,126.4
"16068","47214","2021",6,6,0,62666.67,790.8333,82.33333
"16069","47215","2021",71,69,2,170548.7,1558.873,111.2676
"16070","47216","2021",7,7,0,163692.9,1488.429,109.2857
"16071","47217","2021",9,9,0,168293.9,1232.444,135.2222
"16072","47218","2021",2,2,0,109000,992.5,116.5
"16073","47219","2021",4,4,0,482962.5,3332,117.75
"16074","47221","2021",8,8,0,162600,1129.375,145
"16075","47222","2021",5,5,0,230360,2000.2,119.8
"16076","47223","2021",5,5,0,188200,1814.2,105.2
"16077","47224","2021",3,3,0,123200,1335,95
"16078","47225","2021",23,22,1,239483.9,2362.217,103.4348
"16079","47226","2021",10,10,0,152778.3,1278.4,114.6
"16080","47227","2021",3,3,0,188276.7,1143.333,164.6667
"16081","47228","2021",8,8,0,146575,1575.5,101.625
"16082","47229","2021",3,3,0,288740.3,2166,126.3333
"16083","47230","2021",8,8,0,184039.1,1328.25,137.375
"16084","47231","2021",2,2,0,199000,2076.5,95
"16085","47232","2021",10,10,0,125929,1255.2,105.6
"16086","47233","2021",42,37,5,156081,1477.357,103.9286
"16087","47234","2021",10,9,1,174617.9,1635.5,109.5
"16088","47235","2021",5,5,0,207210,1837.2,113.2
"16089","47236","2021",3,3,0,279000.3,1411,159
"16090","47237","2021",5,5,0,306358,2141.8,129.6
"16091","47238","2021",25,25,0,245776.4,1992.68,118.96
"16092","47239","2021",12,12,0,165945.8,1748.5,98.75
"16093","47240","2021",7,7,0,176886.9,1128.429,163.1429
"16094","47241","2021",11,11,0,212922.7,1308.182,154.1818
"16095","47242","2021",4,4,0,212680,1954.75,92.5
"16096","47244","2021",5,5,0,213390,1487.2,144.8
"16097","47245","2021",1,1,0,179020,1627,110
"16098","47246","2021",19,19,0,179770.1,1645.526,112.4211
"16099","47247","2021",4,4,0,109248.8,995,113.25
"16100","47248","2021",5,5,0,267900,1960,138
"16101","47249","2021",2,2,0,189080,1144,162.5
"16102","47251","2021",4,4,0,118500,1346.5,94
"16103","47252","2021",92,88,4,134439.8,1315.054,100.2174
"16104","47253","2021",7,7,0,226833.6,1653.429,139.2857
"16105","47254","2021",1,1,0,317000,1585,200
"16106","47255","2021",6,6,0,217947.5,1734.5,131.3333
"16107","47256","2021",1,1,0,182530,1372,133
"16108","47257","2021",4,4,0,211050,1742,121
"16109","47258","2021",5,5,0,230903.4,1658.2,158.6
"16110","47259","2021",1,1,0,57000,633,90
"16111","47260","2021",11,11,0,293462.3,2121.182,130.0909
"16112","47262","2021",7,7,0,171428.6,1261.857,161.2857
"16113","47263","2021",4,4,0,133525,1160,115.5
"16114","47264","2021",35,35,0,135207.3,1408.857,97.02857
"16115","47265","2021",5,5,0,115117.6,969.4,122.8
"16116","47266","2021",2,2,0,292699.5,2151,130
"16117","47267","2021",1,1,0,95000,559,170
"16118","47269","2021",10,10,0,195471,1894.1,107.1
"16119","47271","2021",3,3,0,213473.3,1506.333,123.3333
"16120","47272","2021",5,5,0,187393,1467.2,127.4
"16121","47273","2021",1,1,0,247000,1871,132
"16122","47274","2021",7,7,0,166828.6,1421.571,114.2857
"16123","47275","2021",3,3,0,146500,1145,126
"16124","47276","2021",4,4,0,233625,1642,130.5
"16125","47277","2021",7,7,0,233942.9,1809.286,134
"16126","47278","2021",8,8,0,192705.9,1178.75,137
"16127","47279","2021",6,6,0,142691.7,1708,88.16667
"16128","47280","2021",31,31,0,151209.7,1601.935,96.29032
"16129","47281","2021",1,1,0,139000,1544,90
"16130","47282","2021",1,1,0,426600,1641,260
"16131","47283","2021",14,14,0,151574.3,1370,106.6429
"16132","47284","2021",4,4,0,185887.5,1582.5,119.5
"16133","47285","2021",7,7,0,149250,1640.571,93.28571
"16134","47286","2021",2,2,0,224830,1665.5,136
"16135","47287","2021",6,6,0,178283.3,1646.333,115.8333
"16136","47288","2021",5,5,0,213330,1455.8,149.8
"16137","47289","2021",6,5,1,170166.7,1557.667,116.3333
"16138","47290","2021",6,6,0,150250,1246.5,116.6667
"16139","47291","2021",7,7,0,187333.6,1174,171.5714
"16140","47292","2021",12,12,0,100504.2,1078.083,96.75
"16141","47293","2021",5,5,0,123440,1030.6,120.6
"16142","47294","2021",7,7,0,171495.7,1397.143,132.2857
"16143","47295","2021",8,8,0,236943.8,1520.375,158.75
"16144","47296","2021",6,6,0,230650.8,1400.333,164.3333
"16145","47298","2021",2,2,0,97500,1333.5,75
"16146","47299","2021",3,3,0,165333.3,1352.333,129.6667
"16147","47300","2021",18,18,0,178230.9,1631.778,109.7778
"16148","47301","2021",18,18,0,126994.1,1370.889,102
"16149","47302","2021",20,20,0,131553,1243.3,96.85
"16150","47303","2021",6,6,0,194633.3,1687,101
"16151","47304","2021",1,1,0,60000,923,65
"16152","47305","2021",7,7,0,144785.7,1556.571,110
"16153","47306","2021",8,8,0,175571.2,1628.5,111.375
"16154","47307","2021",6,6,0,208791.7,1448.5,138.1667
"16155","47308","2021",3,3,0,107283.3,1509.333,74.33333
"16156","47309","2021",14,14,0,166609.9,1523.429,131
"16157","47310","2021",174,143,31,103476.4,1109.023,94.78736
"16158","47311","2021",1,1,0,160850,1608,100
"16159","47312","2021",14,14,0,163177.4,1402.643,112.1429
"16160","47313","2021",5,5,0,164694,1404.2,128.4
"16161","47314","2021",6,6,0,145108.3,1451.833,109.6667
"16162","47315","2021",8,8,0,329340.6,2419,138.25
"16163","47316","2021",3,3,0,218666.7,1431.667,152.6667
"16164","47317","2021",7,7,0,92928.57,1326.857,77.71429
"16165","47318","2021",15,14,1,110280,1240.133,90.93333
"16166","47320","2021",9,9,0,187077.8,1359.111,146.2222
"16167","47321","2021",5,5,0,242920,1334.4,158.8
"16168","47323","2021",502,390,112,118268.1,1288.871,91.54382
"16169","47324","2021",36,36,0,144636.1,1466.611,106.25
"16170","47325","2021",9,9,0,134055.6,1376,101.5556
"16171","47326","2021",13,13,0,185882.2,1469.077,137.0769
"16172","47327","2021",5,5,0,122110,1151,107
"16173","47328","2021",4,4,0,89725,1118.75,81.75
"16174","48001","2021",2,2,0,117700,1277.5,81
"16175","48002","2021",3,3,0,139640.7,1165,110.3333
"16176","48003","2021",4,4,0,108000,1560.25,78
"16177","48004","2021",7,6,1,47357.14,740.2857,64.42857
"16178","48005","2021",6,6,0,103700,1258.667,84.66667
"16179","48007","2021",1,1,0,90000,1023,88
"16180","48008","2021",1,1,0,80000,1000,80
"16181","48009","2021",26,25,1,107905.2,1093.769,99.23077
"16182","48010","2021",5,5,0,53816,669,89.8
"16183","48012","2021",5,5,0,103680,1184,87.2
"16184","48013","2021",5,5,0,183723.6,1707.4,118
"16185","48015","2021",8,8,0,152716.2,2170.625,76.5
"16186","48016","2021",5,5,0,137200,2202.8,73.8
"16187","48017","2021",9,7,2,135743.3,1674.222,81.33333
"16188","48018","2021",9,9,0,188854.4,2032.778,98
"16189","48019","2021",6,5,1,105166.7,1392.833,73.16667
"16190","48020","2021",1,1,0,163000,1716,95
"16191","48021","2021",4,4,0,121337.5,1195.75,102
"16192","48025","2021",2,2,0,192000,1511.5,125
"16193","48026","2021",4,4,0,156875,1678,88.25
"16194","48027","2021",18,16,2,117197.7,1970.167,72.88889
"16195","48028","2021",1,0,1,30000,857,35
"16196","48029","2021",1,1,0,158000,2225,71
"16197","48030","2021",2,2,0,129000,1203.5,110
"16198","48031","2021",3,3,0,52000,730,57.66667
"16199","48032","2021",1,1,0,67000,447,150
"16200","48034","2021",23,22,1,130800,1386.478,91.65217
"16201","48036","2021",7,7,0,127516.4,2132.714,65.42857
"16202","48038","2021",9,8,1,88311.11,847.8889,109.4444
"16203","48039","2021",19,16,3,144193.3,1556.895,89.84211
"16204","48041","2021",3,3,0,161666.7,1684,89
"16205","48042","2021",3,3,0,197420,1530.667,125.3333
"16206","48043","2021",1,1,0,166000,1509,110
"16207","48045","2021",2,2,0,94277,1053,112.5
"16208","48050","2021",5,5,0,186910,2306.6,84.8
"16209","48051","2021",12,9,3,116341.2,1589.667,77.91667
"16210","48053","2021",9,9,0,105766.7,1343.889,84.11111
"16211","48055","2021",1,1,0,258000,1720,150
"16212","48056","2021",1,1,0,150000,1282,117
"16213","48058","2021",3,3,0,53333.33,1544.333,45
"16214","48061","2021",29,23,6,179795.9,1740.483,103.3103
"16215","48064","2021",4,4,0,142667.5,1651.25,81
"16216","48065","2021",1,1,0,79000,840,94
"16217","48067","2021",1,0,1,146500,2442,60
"16218","48068","2021",2,2,0,187000,1695,115
"16219","48069","2021",1,1,0,50000,595,84
"16220","48070","2021",9,9,0,92150,1156.333,83.44444
"16221","48071","2021",3,3,0,204506.7,1584.667,135.3333
"16222","48072","2021",3,3,0,77603.33,953.6667,81.66667
"16223","48074","2021",6,6,0,216842.3,2732,109.1667
"16224","48075","2021",15,13,2,95031.67,1619.067,66.6
"16225","48077","2021",1,1,0,62000,827,75
"16226","48079","2021",1,1,0,132850,1898,70
"16227","48080","2021",47,31,16,97997.43,1187.915,87.25532
"16228","48081","2021",2,2,0,133000,1401.5,93
"16229","48082","2021",2,2,0,1e+05,1415,72
"16230","48083","2021",4,4,0,98250,1253.75,80.75
"16231","48085","2021",1,1,0,162990,1582,103
"16232","48086","2021",8,7,1,106337.5,1518.125,80.375
"16233","48087","2021",1,1,0,181975,1273,143
"16234","48088","2021",4,4,0,162875,1736.5,106.5
"16235","48089","2021",6,5,1,129556.7,1416,82.66667
"16236","48090","2021",11,9,2,135686.4,1476.909,95.09091
"16237","48091","2021",2,2,0,304684,1859,236.5
"16238","48092","2021",63,38,25,122443.7,1365.302,90.30159
"16239","48094","2021",13,12,1,130651.5,1607.154,80.76923
"16240","48095","2021",98,48,50,154267.7,1833.173,87.26531
"16241","48096","2021",10,9,1,124724,1483.1,89.2
"16242","48097","2021",4,4,0,276661.2,2659,107.25
"16243","48098","2021",1,1,0,120000,1600,75
"16244","48099","2021",26,26,0,136424.5,1318.885,102.4231
"16245","48100","2021",5,5,0,70400,886.4,82.2
"16246","48103","2021",6,6,0,220258.3,1674,132.1667
"16247","48104","2021",4,4,0,76278.75,742,107.5
"16248","48105","2021",2,2,0,106500,1266,78.5
"16249","48108","2021",4,4,0,112750,1343.5,87.5
"16250","48111","2021",6,5,1,123703.3,1326.5,88.16667
"16251","48112","2021",3,3,0,66500,1327,77.33333
"16252","48115","2021",6,6,0,169500,2505.5,76
"16253","48116","2021",14,14,0,92608.29,1240.857,76.42857
"16254","48117","2021",3,3,0,111666.7,2319.667,49
"16255","48119","2021",2,2,0,67500,1194.5,60
"16256","48121","2021",1,1,0,215370,1485,145
"16257","48123","2021",4,4,0,227926.2,1267,174.5
"16258","48124","2021",2,2,0,87500,1233.5,65
"16259","48126","2021",2,2,0,80750,882.5,85
"16260","48127","2021",11,10,1,119959.1,1378.727,88.63636
"16261","48128","2021",3,3,0,75000,1053.667,81.33333
"16262","48129","2021",4,4,0,95425,1172,89.5
"16263","48130","2021",1,1,0,23977,510,47
"16264","48131","2021",3,3,0,171816,2119,77.66667
"16265","48132","2021",25,23,2,78703.4,897.2,91.76
"16266","48135","2021",4,4,0,72625,1297.25,59
"16267","48136","2021",4,4,0,135010.5,1297,112
"16268","48137","2021",2,2,0,172500,1687,103.5
"16269","48139","2021",1,1,0,80000,430,186
"16270","48140","2021",33,25,8,121024.7,1496.909,82.69697
"16271","48141","2021",4,4,0,229580,2741.25,81
"16272","48144","2021",5,4,1,241934.4,2175.8,113.4
"16273","48145","2021",2,2,0,41000,586.5,62
"16274","48146","2021",26,23,3,146770.3,2509.577,77.5
"16275","48147","2021",4,4,0,78326.5,1246.25,70.25
"16276","48148","2021",20,18,2,171781.5,2255,80.2
"16277","48149","2021",5,5,0,66340,873,74
"16278","48150","2021",1,1,0,213000,1578,135
"16279","48152","2021",5,5,0,152677,2287,67.6
"16280","48153","2021",2,2,0,182500,1880.5,98
"16281","48155","2021",7,5,2,218457.1,2776.714,72.28571
"16282","48156","2021",10,10,0,75920,1074.7,82.5
"16283","48157","2021",1,1,0,138000,7667,18
"16284","48158","2021",3,3,0,218363.3,2660,76
"16285","48160","2021",3,3,0,61333.33,735,83.66667
"16286","48161","2021",2,2,0,64000,1375,46.5
"16287","48163","2021",4,4,0,171675,2871.5,59
"16288","48165","2021",2,2,0,65000,1055.5,61.5
"16289","48166","2021",5,4,1,62500,796,77.6
"16290","48167","2021",2,2,0,75500,1666.5,43
"16291","48169","2021",3,3,0,62166.67,1015,61.66667
"16292","48170","2021",1,1,0,170000,4595,37
"16293","48173","2021",3,3,0,256666.7,3826.667,70.33333
"16294","48174","2021",3,3,0,102000,1287,74.66667
"16295","48176","2021",2,2,0,108640,1822,58.5
"16296","48177","2021",4,4,0,1e+05,1499.5,63.25
"16297","48178","2021",12,11,1,113858,1801.75,79.83333
"16298","48179","2021",2,2,0,124500,1327,122
"16299","48181","2021",1,1,0,183650,1530,120
"16300","48182","2021",3,3,0,158666.7,2137.333,66.66667
"16301","48185","2021",3,3,0,154666.7,1607.667,112
"16302","48187","2021",3,3,0,142333.3,1747.667,85.33333
"16303","48188","2021",8,7,1,88662.5,939.375,100.5
"16304","48190","2021",3,3,0,108856.7,1670.667,67.66667
"16305","48191","2021",1,1,0,70000,1667,42
"16306","48192","2021",4,4,0,87577.5,1150,82.25
"16307","48193","2021",2,2,0,160235,1786,86
"16308","48194","2021",15,14,1,111470.7,1151,97.2
"16309","48198","2021",19,11,8,78692.63,1770.211,46.42105
"16310","49002","2021",52,52,0,190686.8,1613.827,117.0962
"16311","49003","2021",31,31,0,174450,1628.839,107.5484
"16312","49007","2021",2957,739,2218,214573.2,3168.05,69.57897
"16313","49008","2021",14,14,0,155000,1545.286,101.0714
"16314","49009","2021",9,9,0,137555.6,1141.667,122.4444
"16315","49010","2021",7,7,0,141214.3,1207,141
"16316","49011","2021",3,3,0,143333.3,1494.667,101.3333
"16317","49012","2021",6,6,0,145333.3,1547.5,99.5
"16318","49015","2021",258,140,118,249509.8,2816.07,90.6938
"16319","49017","2021",13,13,0,122773.1,1428.923,90.30769
"16320","49018","2021",208,206,2,144610.2,1402.683,101.726
"16321","49020","2021",35,32,3,306007.2,2714.657,115.7429
"16322","49021","2021",102,102,0,193895.2,1796.961,111.0686
"16323","49022","2021",18,16,2,237000,2198.778,108.7222
"16324","49023","2021",284,263,21,153205.9,1629.271,96.2007
"16325","49026","2021",36,36,0,211326,1938.222,111.6389
"16326","49027","2021",20,18,2,134250,1496.9,89.4
"16327","49028","2021",4,4,0,303725,3287.75,101.75
"16328","49029","2021",22,22,0,303780.5,2064,150
"16329","49030","2021",18,18,0,172535.4,1420.111,122.2222
"16330","49035","2021",91,89,2,360437.9,3163.967,113.978
"16331","49036","2021",16,16,0,106985.2,929.3125,131.375
"16332","49038","2021",2,2,0,69500,636.5,99
"16333","49041","2021",26,26,0,157196.8,1427.5,110.4231
"16334","49045","2021",12,12,0,159620.8,1570.917,99.58333
"16335","49048","2021",54,53,1,250937.2,2558.13,100.037
"16336","49050","2021",134,128,6,224873.5,2041.53,114.0522
"16337","49053","2021",7,7,0,126928.6,1342.714,91.42857
"16338","49054","2021",42,40,2,143911.4,1420.81,106.4524
"16339","49055","2021",20,17,3,297779.5,2502.65,117.15
"16340","49056","2021",4,4,0,94750,840.25,105.25
"16341","49057","2021",3,3,0,187133.3,1352.667,142
"16342","49058","2021",9,9,0,110250,1250.222,88.88889
"16343","49060","2021",60,57,3,170492.4,1674.333,101.6333
"16344","49061","2021",14,14,0,134739.3,1107.071,122.1429
"16345","49063","2021",89,75,14,204749.3,2164.348,96.06742
"16346","49064","2021",9,9,0,246266.7,1955,95
"16347","49067","2021",5,5,0,164400,1636,96.2
"16348","49068","2021",26,26,0,170311.5,1795.769,98.34615
"16349","49069","2021",251,248,3,184627.4,1963.725,94.42629
"16350","49070","2021",8,8,0,151126.2,1433.875,106.75
"16351","49076","2021",12,12,0,197872.9,1925.5,101.3333
"16352","49080","2021",124,120,4,167967.8,1601.411,107.0726
"16353","49082","2021",17,17,0,227783.5,2087.941,116.8824
"16354","49086","2021",50,48,2,171997.2,1680.96,106.94
"16355","49089","2021",15,15,0,196335.9,1650.667,116.4667
"16356","49090","2021",22,21,1,176272.7,2077.273,94.09091
"16357","49092","2021",287,284,3,157824.7,1562.948,104.2056
"16358","49099","2021",1042,656,386,171463.9,2062.724,84.41459
"16359","49100","2021",6,6,0,192933.3,1207,162.5
"16360","49102","2021",8,8,0,119368.8,1075,119.25
"16361","49107","2021",5,5,0,256458,1814.2,142.6
"16362","49109","2021",19,18,1,132064.9,1260.895,106.5789
"16363","49110","2021",19,19,0,216572.4,1940.211,115.6842
"16364","49112","2021",15,15,0,164017.3,1575.533,103.5333
"16365","49113","2021",6,6,0,130166.7,1295.333,103.6667
"16366","49114","2021",3,3,0,140666.7,1064.333,126.6667
"16367","49120","2021",14,14,0,205850,2027.786,102.9286
"16368","49121","2021",6,6,0,188083.3,1797.5,103.5
"16369","49123","2021",32,32,0,208327.3,2027.219,107.6562
"16370","49125","2021",123,123,0,150164.9,1537.585,99.3252
"16371","49127","2021",51,51,0,122162.6,1320.824,92.70588
"16372","49129","2021",71,67,4,279231.6,2593.521,109.2254
"16373","49130","2021",6,6,0,247345.8,1950,126.6667
"16374","49131","2021",8,8,0,108825,1059.625,98.5
"16375","49132","2021",22,22,0,180759.1,1636.091,110.5
"16376","49135","2021",22,22,0,227852.3,2531.227,98.63636
"16377","49138","2021",30,30,0,169863.3,1548.467,122.5333
"16378","49140","2021",17,17,0,101751.8,1209.059,91
"16379","49155","2021",20,20,0,279712.5,2443.6,105.35
"16380","49160","2021",22,21,1,149554.5,1495.682,111
"16381","49161","2021",3,3,0,126000,1570,80.66667
"16382","49163","2021",51,50,1,165501.8,1614.882,104.1569
"16383","49167","2021",49,49,0,287567.5,2459.041,120.551
"16384","49170","2021",16,16,0,182271.9,1686.5,115.9375
"16385","49174","2021",24,24,0,165833.3,1645.25,101.2083
"16386","49176","2021",63,56,7,202028.3,2133.079,94.79365
"16387","49178","2021",21,21,0,155446.3,1178.905,122.9048
"16388","49180","2021",89,89,0,142052.5,1378.539,102.2584
"16389","49182","2021",7,7,0,190428.6,2058.429,94
"16390","49183","2021",54,54,0,163616.9,1599.667,103.3519
"16391","49188","2021",15,15,0,246333.3,2247.933,116.4667
"16392","49192","2021",34,34,0,159661.4,1554.676,102.4412
"16393","49193","2021",65,64,1,169348.8,1652.754,104.9846
"16394","49194","2021",97,91,6,211184,2023.454,112.9278
"16395","49195","2021",9,9,0,169463,1863.556,91.44444
"16396","49200","2021",84,80,4,265983.2,2403.31,112.6786
"16397","49201","2021",27,25,2,177654.8,1925.481,100.8889
"16398","49205","2021",19,18,1,147286.8,1388.316,104.2105
"16399","49209","2021",6,6,0,151425,1533,97
"16400","49211","2021",9,9,0,168611.1,1549.222,107.3333
"16401","49214","2021",95,79,16,267355.6,2672.463,99.82105
"16402","49215","2021",58,58,0,137998.5,1459.862,96.44828
"16403","49216","2021",11,11,0,266909.1,2363.636,113.2727
"16404","49217","2021",6,6,0,269200,1862.5,146.5
"16405","49218","2021",220,219,1,128374.4,1359.632,95.87273
"16406","49219","2021",11,10,1,158300,1935.636,80.36364
"16407","49220","2021",54,54,0,134978.5,1395.37,96.94444
"16408","49221","2021",26,26,0,142387.6,1361.731,109.2308
"16409","49222","2021",17,17,0,248352.9,2388.059,103.2941
"16410","49223","2021",81,69,12,270604.1,2502.062,111.1975
"16411","49224","2021",10,10,0,139050,1401,100.9
"16412","49228","2021",110,110,0,97510.69,1017.273,98.65455
"16413","49231","2021",17,16,1,195834.7,1898.882,106.5294
"16414","49235","2021",13,13,0,179500,1685.308,107.6154
"16415","49236","2021",6,6,0,136233.3,1092.333,120.6667
"16416","49237","2021",2,2,0,171000,1443,114.5
"16417","49240","2021",16,16,0,135554.4,1257.25,106.5625
"16418","49241","2021",26,26,0,298354,2478.615,121.2308
"16419","49244","2021",236,227,9,156419.8,1667.233,95.39831
"16420","49246","2021",159,126,33,254808.7,2679.862,97.37736
"16421","49247","2021",29,29,0,309923.3,2540.276,124.8276
"16422","49248","2021",161,153,8,120949.1,1142.727,105.9441
"16423","49253","2021",21,21,0,130251.4,1071.857,114
"16424","49257","2021",25,25,0,173248.8,1458.44,118.84
"16425","49259","2021",29,29,0,212431,2352.724,93.13793
"16426","49260","2021",29,29,0,168930.2,1655.897,106.8621
"16427","49261","2021",131,130,1,191181.1,1779.924,109.145
"16428","49262","2021",8,8,0,183931.2,1937.75,94.75
"16429","49266","2021",15,14,1,196203.9,1928.8,102.2
"16430","49267","2021",113,79,34,254279.1,2746.062,94.95575
"16431","49269","2021",34,34,0,237370.9,2070.265,114.9412
"16432","49271","2021",27,27,0,232761.7,2277.037,103.3704
"16433","49272","2021",20,20,0,182187.5,1973.05,98.35
"16434","49278","2021",42,29,13,265340.3,2666.333,98.11905
"16435","49283","2021",47,44,3,217686.4,2106.511,109.2553
"16436","49284","2021",14,14,0,222892.9,2319.214,104.8571
"16437","49288","2021",3,3,0,101666.7,1145,96
"16438","49291","2021",6,6,0,107250,863.1667,116.1667
"16439","49292","2021",58,57,1,185414.5,1895.017,102.2931
"16440","49294","2021",25,25,0,317178.9,2683.8,118.4
"16441","49298","2021",47,47,0,288776.4,2683.532,108.8723
"16442","49299","2021",32,32,0,215232.8,2149.438,103.0625
"16443","49301","2021",336,335,1,174136,1801.902,99.10417
"16444","49302","2021",5,5,0,105840,1012.2,109.8
"16445","49306","2021",11,11,0,256718.9,2554.364,98.72727
"16446","49307","2021",196,196,0,247387.8,2244,113.8929
"16447","49308","2021",22,20,2,356157.3,2741.5,132.5455
"16448","49310","2021",8,8,0,140175,1418.375,104.375
"16449","49311","2021",15,15,0,142750,1254.6,112.0667
"16450","49321","2021",9,9,0,121388.9,1343.222,95.11111
"16451","49323","2021",83,78,5,286044.2,2555.783,115.8795
"16452","49326","2021",7,7,0,208742.9,1936.571,119
"16453","49328","2021",558,313,245,142398.9,1649.559,86.25269
"16454","49329","2021",17,17,0,252099.4,2593.647,94.64706
"16455","49330","2021",19,19,0,184259.5,2113.947,88.78947
"16456","49331","2021",294,270,24,130186.1,1392.762,94.07823
"16457","49332","2021",29,29,0,192861.4,1947.552,100.4483
"16458","49333","2021",61,58,3,202078.5,2081.18,103.9672
"16459","49334","2021",5,5,0,134120,1591.6,85.4
"16460","49336","2021",15,15,0,123903.8,1089.133,107.1333
"16461","49338","2021",10,10,0,227600,1998.7,117.8
"16462","49339","2021",24,24,0,233563.8,2161.333,111.0833
"16463","49341","2021",10,10,0,151637,1560.7,95.9
"16464","49343","2021",28,27,1,187550,1949.214,99.10714
"16465","49344","2021",12,12,0,237881.2,1896.333,127.5
"16466","49345","2021",65,65,0,177266.2,1649.262,110.2462
"16467","49347","2021",38,34,4,245608.7,2177.842,115.1316
"16468","49352","2021",11,11,0,207132.7,1787.182,118.5455
"16469","49353","2021",243,198,45,202759.4,2400.539,86.07407
"16470","49355","2021",42,42,0,186773.7,1776.905,107.0476
"16471","49358","2021",9,9,0,119833.3,1412.333,90.33333
"16472","49359","2021",4,4,0,172500,1516.5,114.5
"16473","49361","2021",32,31,1,160960.2,1521.062,106.0625
"16474","49362","2021",16,16,0,179185.3,1834.938,97.1875
"16475","49364","2021",11,11,0,126981.8,1347.818,91.54545
"16476","49367","2021",80,79,1,183624.7,1722.9,108.8
"16477","49368","2021",35,35,0,114006.4,1207.086,95.71429
"16478","49369","2021",24,24,0,130645.8,1342.875,94
"16479","49370","2021",10,10,0,248310,1509.6,163
"16480","49371","2021",21,21,0,166693.1,1717.095,98.04762
"16481","49373","2021",116,115,1,136939.9,1279.888,108.181
"16482","49374","2021",23,23,0,171609.3,1526.696,113.3913
"16483","49377","2021",69,69,0,251288.7,2268.478,117.1014
"16484","49378","2021",49,47,2,163799.2,1689.245,99.12245
"16485","49381","2021",20,18,2,137775,1530.45,88.45
"16486","50002","2021",75,60,15,145251.6,1580.267,93.84
"16487","50003","2021",76,71,5,358329.3,3685.421,102.5921
"16488","50004","2021",7,7,0,133671.4,1184.286,119.2857
"16489","50006","2021",1,1,0,232000,1669,139
"16490","50008","2021",4,3,1,288375,2334.25,132
"16491","50013","2021",6,6,0,200500,1504.5,128
"16492","50015","2021",13,12,1,173492.3,2216.769,82.69231
"16493","50016","2021",4,4,0,119750,1091.75,102.5
"16494","50019","2021",2,2,0,53000,871,62
"16495","50022","2021",4,3,1,156250,1018,147.25
"16496","50023","2021",7,7,0,150641.4,1542.143,99.71429
"16497","50024","2021",1,1,0,92500,728,127
"16498","50025","2021",110,80,30,175424.5,1957.627,95.01818
"16499","50027","2021",13,13,0,181076.9,2030.538,92.46154
"16500","50029","2021",6,6,0,61050,824.3333,84.83333
"16501","50030","2021",11,8,3,188753.2,2600.818,74.45455
"16502","50031","2021",74,55,19,212549.8,2765.23,81.06757
"16503","50032","2021",9,9,0,173622.2,1529.667,109.8889
"16504","50033","2021",2,2,0,106250,2037.5,55
"16505","50034","2021",5,5,0,179700,1256.6,145.2
"16506","50036","2021",6,6,0,112833.3,1198.333,93
"16507","50038","2021",9,9,0,96055.56,1063.667,88.55556
"16508","50039","2021",1,1,0,165000,1719,96
"16509","50041","2021",92,88,4,204432.2,2104.641,102.25
"16510","50042","2021",3,3,0,162833.3,2059,86.33333
"16511","50044","2021",3,3,0,183000,1808,99.33333
"16512","50045","2021",8,8,0,198250,1810.875,118.5
"16513","50046","2021",4,4,0,148125,1369.25,104.25
"16514","50048","2021",11,11,0,119625.2,1363.818,89.18182
"16515","50049","2021",6,6,0,181333.3,1626.5,118
"16516","50050","2021",1,1,0,70129,1895,37
"16517","50052","2021",4,4,0,164500,1849.25,114
"16518","50054","2021",2,2,0,65125,791,83
"16519","50058","2021",23,22,1,225640.4,2401.435,103.4783
"16520","50059","2021",3,3,0,138333.3,1476.667,93.66667
"16521","50060","2021",6,6,0,180000,1348.5,128.6667
"16522","50062","2021",2,2,0,99787.5,1066,94.5
"16523","50064","2021",1,1,0,78000,1529,51
"16524","50066","2021",64,57,7,343020.2,3235.453,104.3594
"16525","50069","2021",6,6,0,109883.3,1313.667,82.66667
"16526","50074","2021",20,18,2,94320,1131.35,82.2
"16527","50076","2021",65,60,5,242476.2,2552.062,99.66154
"16528","50077","2021",15,15,0,285457.3,2400.733,120.4
"16529","50078","2021",7,7,0,193130.7,1624.857,112.4286
"16530","50079","2021",4,4,0,246125,2046,119.5
"16531","50081","2021",15,15,0,452981.3,2994.2,144.8667
"16532","50082","2021",55,55,0,183872,1763.055,111.0545
"16533","50083","2021",6,6,0,180583.3,1900.667,92
"16534","50084","2021",6,6,0,172916.7,1715.5,102.8333
"16535","50085","2021",11,11,0,254482.1,2096.182,117.8182
"16536","50086","2021",1,1,0,169000,1817,93
"16537","50087","2021",18,18,0,210694.4,1769.556,124.6111
"16538","50088","2021",4,4,0,111068.2,748.5,161.75
"16539","50090","2021",14,14,0,76375,960.3571,79.78571
"16540","50092","2021",8,8,0,191812.5,1372.5,141.25
"16541","50093","2021",7,7,0,116000,889.7143,125.1429
"16542","50094","2021",4,4,0,89375,929.25,90
"16543","50095","2021",25,25,0,160681.4,1432.4,114.6
"16544","50098","2021",7,7,0,87204.43,849,101.8571
"16545","50099","2021",111,95,16,144196.9,1494.261,98.63964
"16546","50101","2021",1,1,0,286530,4477,64
"16547","50102","2021",10,10,0,207950,2225,96
"16548","50106","2021",5,5,0,152247,1322.4,115.4
"16549","50108","2021",2,2,0,106000,1085,88
"16550","50109","2021",30,30,0,142890,1610.667,102.8333
"16551","50110","2021",22,22,0,140644.8,1335.273,109.0909
"16552","50111","2021",15,15,0,106486.7,1025.867,108.8
"16553","50112","2021",3,3,0,161100,1922.333,83.66667
"16554","50115","2021",3,3,0,335666.7,3605.667,91
"16555","50117","2021",7,6,1,188700.7,2600.143,73.28571
"16556","50118","2021",5,5,0,149770,1082.6,138
"16557","50120","2021",6,6,0,222583.3,2330.167,99.33333
"16558","50121","2021",1,1,0,55000,1019,54
"16559","50124","2021",6,6,0,102450,996.3333,104.8333
"16560","50126","2021",2,2,0,250000,1801.5,139
"16561","50129","2021",858,567,291,165402.8,2064.675,82.10839
"16562","50130","2021",3,3,0,120933.3,1779.667,71.66667
"16563","50135","2021",1,1,0,190000,2184,87
"16564","50137","2021",6,6,0,144500,1126.333,121
"16565","50138","2021",7,7,0,189785.7,1565.143,124.2857
"16566","50139","2021",40,40,0,139619.7,1370.7,107.5
"16567","50142","2021",14,14,0,152514.3,1742.571,87
"16568","50143","2021",9,9,0,177091.7,1612.667,103.8889
"16569","50144","2021",6,6,0,79145,1254.167,85.66667
"16570","50145","2021",11,11,0,154136.5,1553.455,122.4545
"16571","50146","2021",1,1,0,109000,1453,75
"16572","50147","2021",97,65,32,138899.5,1637.546,87.62887
"16573","50148","2021",6,6,0,183866.7,1273.833,152.6667
"16574","50149","2021",11,11,0,186540.9,2233,91.72727
"16575","50150","2021",2,2,0,205000,1793,110.5
"16576","50151","2021",26,24,2,160388.4,1793.692,94.73077
"16577","50152","2021",4,4,0,82875,1123.5,78
"16578","50155","2021",4,4,0,126425,1445.75,85.5
"16579","50156","2021",1,1,0,65000,929,70
"16580","50158","2021",1,1,0,135000,1570,86
"16581","50159","2021",6,6,0,123891.7,1119.167,118.6667
"16582","50161","2021",7,7,0,109000,1004,98.57143
"16583","50162","2021",22,22,0,227988.6,2018.136,114.6818
"16584","50164","2021",11,11,0,184509.1,1279.455,140.9091
"16585","50165","2021",59,38,21,263410.7,3200.051,82.77966
"16586","50166","2021",2,2,0,150000,1616,97.5
"16587","50167","2021",15,15,0,187103.3,1885.8,96.6
"16588","50168","2021",23,23,0,163195.7,1761.652,93.30435
"16589","50172","2021",6,6,0,142916.7,1507.667,90.33333
"16590","50174","2021",5,5,0,203200,1762.2,111
"16591","50175","2021",2,2,0,160000,1395,114
"16592","50176","2021",1,1,0,161229,1919,84
"16593","50177","2021",1,1,0,158000,1859,85
"16594","50178","2021",14,14,0,210807.1,2748.071,87.64286
"16595","50181","2021",4,4,0,254490,1477.5,147.75
"16596","50182","2021",3,3,0,115833.3,1278.667,90.66667
"16597","50183","2021",4,4,0,129500,1597,86
"16598","50184","2021",20,20,0,190708,1936.4,100.95
"16599","50185","2021",13,13,0,195464.6,1718.077,116.3846
"16600","50186","2021",3,3,0,186333.3,1444.667,139.3333
"16601","50188","2021",22,22,0,160488.6,1429.182,118.2727
"16602","50190","2021",3,3,0,141000,1348,101.3333
"16603","50192","2021",3,3,0,120833.3,1283,90.33333
"16604","50193","2021",4,4,0,72375,1216,60.25
"16605","50194","2021",8,8,0,153937.5,1338.125,113.75
"16606","50195","2021",7,7,0,87048.57,1095.429,79.28571
"16607","50196","2021",6,6,0,218500,2131.167,126
"16608","50197","2021",22,22,0,107304.5,1245.045,94.13636
"16609","50198","2021",4,4,0,179375,1957,131.75
"16610","50199","2021",11,11,0,122336.4,1707.727,79.72727
"16611","50200","2021",14,14,0,96089.29,933.3571,96.42857
"16612","50205","2021",1,1,0,95000,805,118
"16613","50207","2021",1,1,0,135000,1436,94
"16614","50208","2021",5,5,0,122400,1278.4,103.4
"16615","50209","2021",14,14,0,190321.4,1921.286,102.5
"16616","50210","2021",9,9,0,89777.78,974,92.11111
"16617","50214","2021",7,7,0,110128.6,1054,95.57143
"16618","50215","2021",43,43,0,187973.8,2189.977,88.5814
"16619","50216","2021",8,8,0,147734.4,1264.25,121
"16620","50217","2021",7,7,0,110714.3,1221.714,92.14286
"16621","50218","2021",254,97,157,236573.3,3277.598,74.23622
"16622","50219","2021",10,10,0,217810,1846.2,123.3
"16623","50221","2021",2,2,0,126555,1357,88
"16624","50222","2021",6,6,0,191833.3,2185.833,88.66667
"16625","50225","2021",2,2,0,56500,637,90
"16626","50227","2021",3,3,0,102166.7,1314.667,76.33333
"16627","50228","2021",19,19,0,96463.42,886.8947,105.2105
"16628","50229","2021",4,4,0,107500,1011,110
"16629","50230","2021",9,9,0,231641.6,2298.333,104
"16630","50231","2021",25,24,1,222862,2769.76,92.36
"16631","50232","2021",7,7,0,137514.3,1610.429,88.28571
"16632","50233","2021",1,1,0,189665,2285,83
"16633","50234","2021",1,1,0,117000,836,140
"16634","50235","2021",3,3,0,130000,1591.667,79.66667
"16635","50236","2021",64,61,3,141999.3,1434.172,101.7344
"16636","50237","2021",18,17,1,147022.2,1683.5,94.44444
"16637","50238","2021",2,2,0,133500,1719,83
"16638","50239","2021",18,18,0,161900,1431.056,112.1667
"16639","50240","2021",5,5,0,177600,1964.4,90
"16640","50243","2021",5,5,0,202982,1764.2,122.2
"16641","50246","2021",1,1,0,220000,1789,123
"16642","50247","2021",3,3,0,138333.3,1682.333,81
"16643","50251","2021",4,4,0,290920,1977.25,157
"16644","50252","2021",21,21,0,192878,1999.667,105.5238
"16645","50253","2021",2,2,0,84950,1535.5,54.5
"16646","50256","2021",42,42,0,108201,1141.857,97.16667
"16647","50259","2021",5,5,0,107800,1202.6,112.4
"16648","50260","2021",23,23,0,90036.13,1195.913,82.26087
"16649","50262","2021",7,7,0,107700,1222.571,80.42857
"16650","50263","2021",5,5,0,107600,1277,93.8
"16651","50265","2021",6,6,0,143500,1292,115.3333
"16652","50266","2021",5,5,0,106820,1140,115.4
"16653","50267","2021",26,26,0,158596.2,1754.885,102.5
"16654","50268","2021",1,1,0,205750,1744,118
"16655","50269","2021",1,1,0,235000,2350,100
"16656","50270","2021",5,5,0,116000,1333.4,81.8
"16657","50271","2021",2,2,0,137250,1765,89.5
"16658","50272","2021",11,11,0,175727.3,2076.364,97.72727
"16659","50273","2021",25,25,0,113596,1196.04,96.92
"16660","50274","2021",13,13,0,135588.5,1482,95.84615
"16661","50275","2021",1,1,0,55000,786,70
"16662","50276","2021",9,9,0,180641.1,1854.222,96.55556
"16663","50277","2021",14,14,0,312728.6,2570.357,120.3571
"16664","50278","2021",2,2,0,127500,1477.5,86.5
"16665","50279","2021",8,8,0,117018.8,1305,84.125
"16666","50281","2021",14,14,0,167987.9,1628.643,105.1429
"16667","50282","2021",5,5,0,166100,1056.8,154.8
"16668","50285","2021",1,1,0,65000,2955,22
"16669","50288","2021",13,12,1,161586.9,1947.462,84.61538
"16670","50289","2021",6,6,0,162677.5,1385.833,114.1667
"16671","50290","2021",12,12,0,103735,1252.75,86.83333
"16672","50291","2021",3,3,0,117733.3,1225.667,92.33333
"16673","50292","2021",28,28,0,141754.5,1389.75,101.1786
"16674","50294","2021",14,14,0,226217.9,1863.929,120.7143
"16675","50295","2021",3,3,0,119613.3,1083.333,110.3333
"16676","50296","2021",4,4,0,148250,1548.75,97
"16677","50297","2021",7,7,0,135528.6,1245.429,107.2857
"16678","50298","2021",3,3,0,111500,1158,107
"16679","50299","2021",4,4,0,176300,1739.5,99
"16680","50300","2021",4,4,0,87712.5,1183.75,79.25
"16681","50302","2021",1,1,0,154600,1418,109
"16682","50304","2021",4,4,0,75372.5,1043.75,82
"16683","50305","2021",2,2,0,277000,2395.5,116
"16684","50310","2021",3,3,0,70100,572.3333,121
"16685","50311","2021",2,2,0,159000,1576,102
"16686","50312","2021",4,4,0,80250,986.5,80.25
"16687","50315","2021",9,9,0,67822.22,834.1111,81.44444
"16688","50317","2021",4,4,0,212475,1648.75,130.75
"16689","50321","2021",6,6,0,258150,1472.667,164.1667
"16690","50324","2021",2,2,0,75250,524,157.5
"16691","50326","2021",5,5,0,129070,1129.6,110.6
"16692","50327","2021",2,2,0,162500,1064.5,151
"16693","50328","2021",6,6,0,118816.7,1401.167,86.33333
"16694","50332","2021",8,8,0,247625,2622.875,100.125
"16695","50335","2021",2,2,0,144000,1485.5,99
"16696","50336","2021",4,4,0,114250,1347.5,87.25
"16697","50338","2021",9,9,0,85967.78,1114.444,79.88889
"16698","50340","2021",1,1,0,136750,1554,88
"16699","50341","2021",24,19,5,117337.5,1382.417,88.33333
"16700","50342","2021",16,16,0,251140.6,2239.562,116.0625
"16701","50345","2021",6,6,0,213958.3,1652.333,132.8333
"16702","50347","2021",8,8,0,146930.6,1264.375,121.5
"16703","50349","2021",22,20,2,186226.5,2209.136,90.27273
"16704","50350","2021",4,4,0,147000,1243.75,136
"16705","50351","2021",1,1,0,125000,694,180
"16706","50352","2021",3,3,0,109000,895.6667,119
"16707","50356","2021",8,8,0,149037.5,1223.625,123.5
"16708","50357","2021",1,1,0,111570,808,138
"16709","50359","2021",42,36,6,68429.76,847.6667,81.19048
"16710","50360","2021",4,4,0,121083.2,1471,104.25
"16711","50361","2021",1,1,0,201000,1211,166
"16712","50362","2021",5,5,0,141800,1199.6,122.2
"16713","50363","2021",13,13,0,151255.8,1281.538,124.3077
"16714","50364","2021",11,11,0,139454.5,1297.636,108.1818
"16715","50365","2021",9,9,0,191437.6,1755.222,115.4444
"16716","50368","2021",3,3,0,127266.7,1163,101.6667
"16717","50369","2021",9,9,0,119888.9,1513.556,78.22222
"16718","50370","2021",5,5,0,94600,1352.2,74.8
"16719","50371","2021",5,5,0,99036,907.6,111.8
"16720","50372","2021",1,1,0,105000,1141,92
"16721","50374","2021",2,2,0,121000,1354,88.5
"16722","50376","2021",8,8,0,189825,1774.875,111.625
"16723","50378","2021",12,12,0,142508.3,1295.833,112.0833
"16724","50379","2021",2,2,0,175575,1987,91
"16725","50382","2021",7,7,0,259857.1,2198,121
"16726","50384","2021",5,5,0,144506,2033.4,75
"16727","50387","2021",5,5,0,181800,1537.8,118.6
"16728","50388","2021",16,16,0,160526.2,1440.188,108
"16729","50389","2021",9,9,0,127333.3,1334,96.55556
"16730","50390","2021",2,2,0,130000,1699,78.5
"16731","50391","2021",31,29,2,138412.4,1542.935,90.87097
"16732","50393","2021",20,20,0,121767.1,1062.9,120.4
"16733","50394","2021",30,30,0,110180,1171.133,89.36667
"16734","50395","2021",1,1,0,250000,1337,187
"16735","50397","2021",5,5,0,87600,1483.6,62.6
"16736","50399","2021",1,1,0,1e+05,1075,93
"16737","50400","2021",49,49,0,130751,1174.959,111.6735
"16738","50401","2021",8,8,0,170250,1600.5,106.75
"16739","50402","2021",25,25,0,226041,1969.56,113.72
"16740","50403","2021",33,32,1,152449.1,2293.091,71.81818
"16741","50405","2021",2,2,0,557066.5,3382,143
"16742","50407","2021",6,6,0,120933.3,1175,100.6667
"16743","50408","2021",9,9,0,136977.8,1754.556,77.44444
"16744","50409","2021",23,19,4,90854.35,1132.522,80.08696
"16745","50410","2021",66,58,8,118686.5,1529.773,86.19697
"16746","50411","2021",6,6,0,161416.7,1483.667,106
"16747","50412","2021",48,47,1,182187,2146.5,85.10417
"16748","50413","2021",6,6,0,104666.7,1269,78.83333
"16749","50417","2021",17,17,0,158288.2,1859.294,86.52941
"16750","50419","2021",38,38,0,176105.3,1623.158,113.7632
"16751","50420","2021",18,18,0,147630.6,1164.722,126.2222
"16752","50421","2021",1,1,0,127000,2309,55
"16753","50422","2021",3,3,0,112666.7,851.3333,144.6667
"16754","50423","2021",3,3,0,150333.3,1507.667,100.6667
"16755","50425","2021",21,21,0,130832.9,1387.333,96.66667
"16756","50426","2021",7,7,0,96451.43,1407.143,72.42857
"16757","50428","2021",7,7,0,109928.6,1072,102.8571
"16758","50429","2021",16,16,0,229390.6,2759,90.1875
"16759","50431","2021",17,17,0,96482.59,1014.412,98.17647
"16760","50433","2021",18,17,1,260166.7,2772,94.33333
"16761","50435","2021",8,8,0,141106.2,1691.5,82.625
"16762","50436","2021",15,15,0,93470.87,1178.933,84.8
"16763","50437","2021",11,11,0,107606.4,1052.455,101.6364
"16764","50442","2021",2,2,0,1e+05,1840,65
"16765","50443","2021",9,9,0,106272.2,1048.333,93.33333
"16766","50444","2021",22,22,0,151175.2,1334,110.3636
"16767","50445","2021",4,4,0,136087.5,1501.75,93.5
"16768","50446","2021",8,8,0,159175,1335.625,120.25
"16769","50447","2021",5,5,0,183100,1559.4,115.2
"16770","50448","2021",12,12,0,96541.67,976.9167,101.4167
"16771","50450","2021",5,5,0,129940,1227.8,107
"16772","50451","2021",2,2,0,254200,2429,105
"16773","50452","2021",7,7,0,117714.3,1408.857,78.57143
"16774","50453","2021",8,8,0,210515,1441.375,156.5
"16775","50454","2021",4,4,0,197500,1783.25,121
"16776","50455","2021",10,10,0,151800,1226.7,125.7
"16777","50456","2021",10,10,0,106272,1288.6,77.5
"16778","50461","2021",1,1,0,3e+05,2174,138
"16779","50462","2021",12,12,0,76803.75,1034.083,79.75
"16780","50463","2021",7,7,0,170188.6,1085.714,161.2857
"16781","50464","2021",5,5,0,129740,1178.4,105.8
"16782","50467","2021",5,5,0,207095,1602.8,140.4
"16783","50468","2021",10,10,0,91421.6,1038.7,90.6
"16784","50469","2021",7,7,0,158059.1,1714.857,95.42857
"16785","50471","2021",11,11,0,144075.5,2061.818,70.18182
"16786","50472","2021",3,3,0,138333.3,1400.667,107.3333
"16787","50473","2021",2,2,0,231500,1515,149
"16788","50474","2021",7,7,0,82638.43,1223.429,76.57143
"16789","50475","2021",11,11,0,197209.1,1480.909,133.0909
"16790","50476","2021",4,4,0,176015.8,1535.5,135
"16791","50478","2021",5,5,0,140000,1263.8,113.2
"16792","50479","2021",1,1,0,241250,2173,111
"16793","50480","2021",11,11,0,178504.5,1844.545,108.8182
"16794","50481","2021",30,28,2,149245.6,2136.733,73.56667
"16795","50482","2021",1,1,0,78500,714,110
"16796","50483","2021",9,9,0,159044.4,1485.667,111.7778
"16797","50484","2021",44,43,1,106896.4,1254,87.93182
"16798","50486","2021",6,6,0,141216.7,1268.833,111
"16799","50487","2021",65,64,1,120519.5,1346.215,94.06154
"16800","50488","2021",4,4,0,148500,1186.75,124.75
"16801","50489","2021",9,9,0,145555.6,1452.667,96
"16802","50490","2021",12,11,1,216679.2,3800,65
"16803","50491","2021",2,2,0,255315,1895.5,134
"16804","50492","2021",29,29,0,152380.5,1388.621,109.931
"16805","50493","2021",20,20,0,197831.6,2069.6,104.7
"16806","50496","2021",22,19,3,216793.2,2465.682,91.22727
"16807","50498","2021",6,6,0,224850.8,2114.667,140.3333
"16808","50499","2021",9,9,0,89493.33,904.2222,108
"16809","50500","2021",7,7,0,114000,1140.571,111.5714
"16810","50502","2021",259,130,129,121775.7,1561.981,78.28185
"16811","50504","2021",6,6,0,131862.5,1047,122.3333
"16812","50505","2021",3,3,0,169333.3,1682.333,97.66667
"16813","50506","2021",3,3,0,174333.3,1573,108.3333
"16814","50507","2021",9,9,0,141233.3,1669.222,88.77778
"16815","50509","2021",7,7,0,111428.6,1828.429,69.28571
"16816","50510","2021",7,7,0,122200,1348.714,89.14286
"16817","50511","2021",1,1,0,190000,1166,163
"16818","50512","2021",9,9,0,122557.9,1187,107.4444
"16819","50513","2021",5,5,0,116600,886.2,125.2
"16820","50514","2021",13,13,0,72538.46,889.1538,80.76923
"16821","50517","2021",2,2,0,121250,1522.5,88
"16822","50518","2021",3,3,0,167833.3,1061.333,174.3333
"16823","50519","2021",6,6,0,212911.7,1939,111.1667
"16824","50521","2021",1,1,0,287500,1150,250
"16825","50522","2021",2,2,0,136500,1417.5,105
"16826","50523","2021",41,38,3,192218,1811.073,115.7073
"16827","50525","2021",11,11,0,100486.4,891.5455,116.3636
"16828","50528","2021",2,2,0,92500,1014,90.5
"16829","50529","2021",1,1,0,59900,856,70
"16830","50531","2021",11,11,0,125363.6,1233.545,105
"16831","50532","2021",91,66,25,271194.3,3291.516,84.53846
"16832","50533","2021",2,2,0,82200,791,104.5
"16833","50535","2021",8,8,0,151645.9,1688.5,89.625
"16834","50537","2021",6,6,0,224000,1505.833,147.5
"16835","50538","2021",3,3,0,140666.7,1530.667,89.66667
"16836","50539","2021",16,15,1,148981.2,1733.625,90.5625
"16837","50540","2021",11,11,0,259513.7,2267.909,112
"16838","50541","2021",18,18,0,202562.6,1834.278,116.3889
"16839","50542","2021",3,3,0,130625,1023.333,188.6667
"16840","50543","2021",17,17,0,198930.6,1879.882,114.2353
"16841","50546","2021",44,44,0,161629.9,1367.068,115.4773
"16842","50548","2021",1,1,0,85000,1118,76
"16843","50549","2021",4,4,0,209250,1649,122.25
"16844","50550","2021",46,46,0,126804.1,1245.304,99.30435
"16845","50551","2021",18,18,0,122833.3,1528.944,87.22222
"16846","50552","2021",3,3,0,104500,894.3333,111.3333
"16847","50553","2021",3,3,0,85833.33,792,113.6667
"16848","50554","2021",16,16,0,217545,1985.125,110.375
"16849","50556","2021",2,2,0,178895,1372,131.5
"16850","50562","2021",34,27,7,206328.4,2280.765,98.38235
"16851","50563","2021",5,5,0,101600,1113.4,96.2
"16852","50564","2021",13,13,0,117884.6,1224,99.61538
"16853","50565","2021",27,21,6,176890.3,1823.519,101.8148
"16854","50567","2021",8,8,0,124312.5,1635.75,79.75
"16855","50568","2021",4,4,0,184250,1705,105
"16856","50569","2021",9,9,0,146600,1282.333,112.2222
"16857","50570","2021",6,6,0,77583.33,1059.667,82.66667
"16858","50571","2021",2,2,0,142500,1426,101
"16859","50572","2021",3,3,0,229333.3,1883.333,126.3333
"16860","50574","2021",3,3,0,149000,1259,117
"16861","50575","2021",9,9,0,200128.9,2228.444,97.55556
"16862","50576","2021",20,19,1,268856.9,2716.55,102.7
"16863","50577","2021",3,3,0,150666.7,2695.333,78.66667
"16864","50579","2021",9,9,0,162444.4,1479.667,108.1111
"16865","50580","2021",6,6,0,215621.7,2889.167,94.33333
"16866","50582","2021",53,52,1,107622.3,1209,96.60377
"16867","50584","2021",3,3,0,151666.7,1497.333,87.33333
"16868","50585","2021",18,18,0,145142.8,1858.778,89
"16869","50587","2021",1,1,0,116000,1365,85
"16870","50588","2021",6,6,0,186500,1346,136.3333
"16871","50589","2021",3,3,0,153866.7,1481.667,111.3333
"16872","50591","2021",28,28,0,91770.11,1063.786,88.42857
"16873","50592","2021",29,25,4,113108.6,1132.586,98.58621
"16874","50593","2021",6,5,1,117916.7,1316.5,105.8333
"16875","50594","2021",7,7,0,212381,1624.143,153.1429
"16876","50596","2021",2,2,0,207000,1744.5,134
"16877","50597","2021",9,9,0,162669.4,1625.222,96.77778
"16878","50598","2021",4,4,0,137500,1562.5,89.5
"16879","50599","2021",12,12,0,222829.2,2168.167,106
"16880","50601","2021",49,49,0,127185.6,1329.959,99.10204
"16881","50603","2021",16,16,0,166757.5,1786.875,97.25
"16882","50604","2021",4,4,0,149000,1986.75,78.75
"16883","50606","2021",11,11,0,99473.09,976,102.5455
"16884","50607","2021",3,3,0,142833.3,1615.667,87.33333
"16885","50609","2021",4,4,0,321250,2016,139.75
"16886","50610","2021",6,6,0,114333.3,1758.167,77.5
"16887","50612","2021",7,7,0,145838.1,1785.143,77.71429
"16888","50613","2021",5,5,0,154200,1817.8,85.2
"16889","50615","2021",63,56,7,190977.2,1925.603,104.0476
"16890","50616","2021",25,25,0,197781.7,1960.84,99.88
"16891","50617","2021",4,4,0,151875,1622,101.5
"16892","50618","2021",4,4,0,133250,1484.75,90.75
"16893","50619","2021",8,8,0,125750,1200.875,105.625
"16894","50624","2021",6,6,0,198333.3,1812,109.1667
"16895","50626","2021",9,9,0,93611.11,1305,76.88889
"16896","50628","2021",2,2,0,55500,863,60
"16897","50629","2021",11,11,0,148331.2,1198,120.6364
"16898","50633","2021",3,3,0,276000,1859,154.3333
"16899","50634","2021",1,1,0,410000,2470,166
"16900","50637","2021",4,4,0,101000,946,102.5
"16901","50639","2021",51,45,6,132243.9,1444.451,92.4902
"16902","50641","2021",8,8,0,169959.4,1308.375,138.125
"16903","50643","2021",7,7,0,182407.1,1769.714,100
"16904","50647","2021",20,20,0,222607.5,2403.4,97.15
"16905","50648","2021",12,12,0,181270.8,1631.667,117
"16906","51002","2021",21,20,1,192533.3,1832.952,106.0952
"16907","51003","2021",5,5,0,182180,1609,117.6
"16908","51004","2021",5,5,0,111560,1015,110.2
"16909","51005","2021",1,1,0,157300,1430,110
"16910","51006","2021",5,5,0,94400,879.6,109.4
"16911","51007","2021",9,9,0,153536.7,1377.222,110.6667
"16912","51008","2021",1,1,0,2e+05,2041,98
"16913","51009","2021",18,18,0,121361.1,1197.889,108.8333
"16914","51010","2021",1,1,0,47500,642,74
"16915","51012","2021",1,1,0,160000,2000,80
"16916","51013","2021",1,1,0,195000,1114,175
"16917","51014","2021",3,3,0,188583.3,1566.667,127
"16918","51015","2021",1,1,0,183000,1245,147
"16919","51016","2021",3,3,0,109500,972.6667,128.3333
"16920","51018","2021",6,6,0,191191.7,1590,118.5
"16921","51019","2021",2,2,0,222500,1407,197.5
"16922","51020","2021",1,1,0,433200,2083,208
"16923","51022","2021",5,5,0,153700,1230.8,120.4
"16924","51023","2021",3,3,0,315000,2311.667,136
"16925","51025","2021",10,10,0,226612.6,2065.2,110.3
"16926","51027","2021",3,3,0,186905.3,1263.667,156
"16927","51028","2021",16,15,1,182062.4,1977.312,100.375
"16928","51029","2021",12,11,1,152318.3,1824.417,85.75
"16929","51030","2021",58,53,5,189175.9,1950.31,98.2069
"16930","51032","2021",2,2,0,30500,433.5,70
"16931","51033","2021",4,4,0,129437.5,1199,112.5
"16932","51035","2021",3,3,0,173163.3,1370.667,138.6667
"16933","51036","2021",5,5,0,93696,890,105.6
"16934","51037","2021",6,6,0,218916.7,2007.333,107.8333
"16935","51038","2021",1,1,0,75000,962,78
"16936","51039","2021",2,2,0,75000,877.5,88
"16937","51040","2021",4,4,0,101000,840.25,134.75
"16938","51041","2021",1,1,0,110000,444,248
"16939","51042","2021",8,8,0,119812.5,1015.25,128.375
"16940","51043","2021",23,23,0,202720,2140.783,97.86957
"16941","51044","2021",8,8,0,264402.6,2122.625,137.625
"16942","51045","2021",1,1,0,120000,1224,98
"16943","51046","2021",8,8,0,272462.5,2362.75,115.875
"16944","51048","2021",1,1,0,290000,1737,167
"16945","51049","2021",6,6,0,152556.7,1317.5,118.5
"16946","51050","2021",2,2,0,174000,1502,123
"16947","51051","2021",4,4,0,316327,2224,150
"16948","51052","2021",10,10,0,262593.7,2465.7,108.2
"16949","51053","2021",3,3,0,120300,1242.333,111.6667
"16950","51054","2021",13,13,0,156316.2,1744.692,91.23077
"16951","51055","2021",96,74,22,229086,2463.677,92.01042
"16952","51056","2021",2,2,0,86850,1052,88
"16953","51057","2021",3,3,0,126666.7,1129,114
"16954","51058","2021",38,23,15,343359.3,3262.132,104.7895
"16955","51059","2021",7,7,0,180201.4,1462.429,124.4286
"16956","51060","2021",1,1,0,122000,1232,99
"16957","51061","2021",2,2,0,256000,1759.5,143
"16958","51062","2021",3,3,0,54516.67,976.3333,60.66667
"16959","51063","2021",2,2,0,127000,1278.5,104.5
"16960","51065","2021",4,4,0,110237.5,1056.25,106.75
"16961","51066","2021",7,7,0,127235.7,1429.714,88
"16962","51068","2021",2,2,0,137000,1160,126
"16963","51070","2021",1,1,0,153680,1746,88
"16964","51071","2021",5,5,0,127500,1566.4,86.6
"16965","51072","2021",4,4,0,302825,2342.75,127.25
"16966","51073","2021",3,3,0,326333.3,2710,119.6667
"16967","51074","2021",17,17,0,196767.9,2148.353,95.94118
"16968","51075","2021",12,12,0,267125.8,2005.417,141
"16969","51076","2021",6,6,0,192183.3,2208.833,97.5
"16970","51077","2021",1,1,0,95000,621,153
"16971","51078","2021",3,3,0,182400,1434.667,129
"16972","51079","2021",11,11,0,222026.8,2160.455,106.3636
"16973","51080","2021",4,4,0,114425,1044.25,122.25
"16974","51081","2021",5,5,0,351760,2332,150
"16975","51082","2021",1,1,0,85500,1276,67
"16976","51083","2021",4,4,0,114500,1144.25,103.75
"16977","51084","2021",2,2,0,122500,1062.5,115.5
"16978","51085","2021",5,5,0,123000,1198.2,111.2
"16979","51086","2021",5,5,0,197880,2207,89.8
"16980","51087","2021",1,1,0,201000,1272,158
"16981","51088","2021",9,9,0,303594,2228.444,144.7778
"16982","51090","2021",5,5,0,104600,869,120.4
"16983","51091","2021",2,2,0,194961,2182.5,115
"16984","51092","2021",6,6,0,114831.7,1173,102.6667
"16985","51093","2021",6,6,0,238936.7,1998.667,116.6667
"16986","51094","2021",3,3,0,70333.33,720.6667,97
"16987","51099","2021",5,5,0,173930,1667.6,111
"16988","51101","2021",6,6,0,330058.3,3134.667,106.6667
"16989","51102","2021",3,3,0,214418.3,2290.667,94.66667
"16990","51103","2021",1,1,0,110000,1100,100
"16991","51104","2021",2,2,0,93500,502.5,160
"16992","51105","2021",10,10,0,294961,2627.4,115.2
"16993","51106","2021",3,3,0,112200,1064.667,110.3333
"16994","51107","2021",5,5,0,153300,1688,92
"16995","51108","2021",531,203,328,121360.5,1557.373,78.13748
"16996","51109","2021",1,1,0,323200,3591,90
"16997","51110","2021",1,1,0,99000,1800,55
"16998","51111","2021",3,3,0,258000,2055.667,124.3333
"16999","51112","2021",3,3,0,178033.3,1776.333,90.33333
"17000","51113","2021",4,4,0,104747.5,1167.75,93.75
"17001","51115","2021",7,7,0,395800,2888.857,133.1429
"17002","51116","2021",3,3,0,169107.7,1221,138
"17003","51117","2021",1,1,0,161000,1750,92
"17004","51118","2021",20,20,0,444715.2,3561.1,127.9
"17005","51119","2021",2,2,0,242500,1948.5,124.5
"17006","51120","2021",1,1,0,22000,917,24
"17007","51121","2021",4,4,0,115250,1434.75,74
"17008","51124","2021",1,1,0,75000,560,134
"17009","51125","2021",1,1,0,140000,1474,95
"17010","51129","2021",2,2,0,126000,1679.5,74
"17011","51130","2021",4,4,0,137430,988,136.5
"17012","51132","2021",4,4,0,54000,778,83.25
"17013","51133","2021",1,1,0,80000,1455,55
"17014","51134","2021",3,3,0,108666.7,1139.333,107
"17015","51136","2021",10,10,0,109970,1236.9,95.9
"17016","51137","2021",6,6,0,125666.7,1424.833,96.33333
"17017","51139","2021",6,6,0,189116.7,1842.833,130.3333
"17018","51140","2021",5,4,1,140370,1468.4,92
"17019","51141","2021",7,7,0,160035.7,1841.571,91.57143
"17020","51142","2021",3,3,0,513950,2775.333,179
"17021","51143","2021",1,1,0,70000,583,120
"17022","51144","2021",8,8,0,98387.5,1022.125,98
"17023","51145","2021",3,3,0,717726.7,3450.333,195.6667
"17024","51147","2021",1,1,0,130000,963,135
"17025","51148","2021",2,2,0,155500,1963.5,80
"17026","51149","2021",7,7,0,141114.3,1597,83.85714
"17027","51150","2021",2,2,0,233000,1965,118.5
"17028","51151","2021",2,2,0,76250,718,105
"17029","51152","2021",4,4,0,340700,2283.5,144
"17030","51153","2021",7,7,0,247385.7,2030.571,126.4286
"17031","51154","2021",1,1,0,151000,1127,134
"17032","51155","2021",4,4,0,146250,1118.75,134.75
"17033","51157","2021",1,1,0,28000,1167,24
"17034","51158","2021",6,6,0,132233.3,1199.167,113.6667
"17035","51160","2021",18,18,0,177945.3,1835.833,97.72222
"17036","51161","2021",10,10,0,153726.6,1499.4,106.6
"17037","51162","2021",11,11,0,99981.82,1301.636,74
"17038","51163","2021",2,2,0,110000,707,131.5
"17039","51164","2021",1,1,0,118000,1283,92
"17040","51165","2021",12,12,0,158536.2,1516.917,99.5
"17041","51166","2021",1,1,0,162650,1549,105
"17042","51167","2021",5,5,0,103600,1070.8,99
"17043","51169","2021",1,1,0,115000,535,215
"17044","51171","2021",22,22,0,263907.5,2172.818,124.1818
"17045","51172","2021",85,57,28,251641.5,2773.8,89.34118
"17046","51173","2021",5,5,0,126100,1520.8,83.6
"17047","51174","2021",1,1,0,260900,1631,160
"17048","51175","2021",2,2,0,192500,1512.5,142.5
"17049","51176","2021",2,2,0,46250,512.5,88.5
"17050","51177","2021",1,1,0,320350,3172,101
"17051","51178","2021",2,2,0,154550,1472,105
"17052","51179","2021",1,1,0,233000,2219,105
"17053","51181","2021",4,4,0,335177.5,2665,124
"17054","51182","2021",5,5,0,54000,886.6,60.2
"17055","51183","2021",9,8,1,256746.2,2411.556,111.2222
"17056","51184","2021",4,4,0,138500,1199.5,117.75
"17057","51185","2021",10,9,1,136829,1619.6,103.4
"17058","51186","2021",2,2,0,139500,1254.5,112.5
"17059","51187","2021",2,2,0,180195,1715,106
"17060","51188","2021",2,2,0,250000,2085,117
"17061","51190","2021",2,2,0,262500,1592,168
"17062","51191","2021",1,1,0,92000,868,106
"17063","51192","2021",6,6,0,183083.3,1678.333,127.8333
"17064","51193","2021",22,20,2,165767.5,1596.955,108.8182
"17065","51194","2021",10,10,0,179720,1584.1,121.5
"17066","51195","2021",7,7,0,102564.3,1105.857,93.71429
"17067","51196","2021",11,10,1,172836.4,1706.182,107
"17068","51197","2021",1,1,0,61000,693,88
"17069","51198","2021",18,18,0,183438.9,1996.944,96.94444
"17070","51199","2021",6,6,0,160425,1981.667,80.83333
"17071","51200","2021",7,7,0,159510.4,1678,98.14286
"17072","51201","2021",1,1,0,75000,625,120
"17073","51202","2021",5,5,0,89373.2,1240.8,76.6
"17074","51204","2021",19,19,0,160380.3,1808.895,97.26316
"17075","51205","2021",1,1,0,215000,1514,142
"17076","51208","2021",2,2,0,211770,1396,152
"17077","51210","2021",18,15,3,191538.9,2123.611,91.55556
"17078","51211","2021",2,2,0,158750,1130,140.5
"17079","51212","2021",1,1,0,98900,749,132
"17080","51213","2021",1,1,0,129000,717,180
"17081","51215","2021",1,1,0,86000,935,92
"17082","51216","2021",2,2,0,142500,1490,97
"17083","51217","2021",36,31,5,156100.6,1836.5,91.13889
"17084","51218","2021",2,2,0,70000,697,107
"17085","51220","2021",1,1,0,70000,1167,60
"17086","51222","2021",1,1,0,72000,727,99
"17087","51224","2021",3,3,0,189716.7,1323.333,146
"17088","51225","2021",6,6,0,262488.3,2206.167,121.3333
"17089","51227","2021",7,6,1,183200,1364.429,135.7143
"17090","51228","2021",1,1,0,50000,625,80
"17091","51230","2021",334,147,187,144703,1874.219,77.07784
"17092","51231","2021",7,7,0,161835.7,1687.429,101
"17093","51232","2021",7,7,0,234621.4,2227.429,107.1429
"17094","51233","2021",2,2,0,116500,1270.5,95.5
"17095","51234","2021",9,9,0,163880,1550.222,107
"17096","51235","2021",12,12,0,154114.2,1176.417,139.6667
"17097","51236","2021",2,2,0,177000,1288.5,137.5
"17098","51237","2021",19,19,0,130571.6,1517.842,86.21053
"17099","51238","2021",8,8,0,130350,1609.875,83.25
"17100","51240","2021",2,2,0,51000,614,101
"17101","51241","2021",2,2,0,106250,910.5,114.5
"17102","51242","2021",31,28,3,176853.5,1725.806,101.5161
"17103","51243","2021",7,7,0,95539.29,851.2857,114.1429
"17104","51245","2021",9,9,0,224405.6,1931.333,119.2222
"17105","51246","2021",1,1,0,206500,1424,145
"17106","51247","2021",1,1,0,155000,1476,105
"17107","51248","2021",15,15,0,80344,1075.667,80
"17108","51249","2021",5,5,0,144000,1448.8,96.4
"17109","51250","2021",56,44,12,146970.8,1660.054,88.375
"17110","51252","2021",1,1,0,150000,1765,85
"17111","51253","2021",1,1,0,55000,688,80
"17112","51254","2021",6,6,0,78800,947.8333,84.5
"17113","51256","2021",2,2,0,263250,1901.5,137.5
"17114","51258","2021",3,3,0,123000,1138.333,117.3333
"17115","51259","2021",4,4,0,204536.2,1346.75,148.75
"17116","51260","2021",1,1,0,175000,1067,164
"17117","51262","2021",25,22,3,134955.6,1253.04,101.84
"17118","51263","2021",5,5,0,139398,1236.2,116
"17119","51264","2021",8,8,0,111750,1045.625,105
"17120","51265","2021",8,8,0,123625,1429.5,88.625
"17121","51266","2021",4,4,0,272531.2,2328.75,114.75
"17122","51267","2021",2,2,0,412800,2306.5,185
"17123","51268","2021",2,2,0,55000,740,75.5
"17124","51269","2021",17,15,2,124074,2035.588,84.41176
"17125","51270","2021",6,6,0,102083.3,1014.667,108.8333
"17126","51272","2021",2,2,0,75500,956.5,79.5
"17127","51273","2021",2,2,0,105000,1341,88
"17128","51274","2021",3,3,0,136333.3,1221.333,115
"17129","51275","2021",2,2,0,123000,720.5,157.5
"17130","51276","2021",3,3,0,78866.67,882,87.33333
"17131","51277","2021",5,5,0,202494,2068.6,99.8
"17132","51278","2021",5,5,0,246827,1783.6,137.2
"17133","51279","2021",2,2,0,92500,884,114.5
"17134","51281","2021",7,7,0,173842.9,1752.286,102.2857
"17135","51282","2021",20,20,0,482855.1,3485.25,142.9
"17136","51283","2021",2,2,0,116500,851.5,130
"17137","51284","2021",3,3,0,122666.7,1601.333,76.66667
"17138","51285","2021",3,3,0,179999.3,888.3333,206.6667
"17139","51287","2021",11,10,1,203797.6,2042.091,102.6364
"17140","51288","2021",3,3,0,155166.7,1508,102.6667
"17141","51289","2021",3,3,0,156200,1216.667,135
"17142","51290","2021",1,1,0,98000,1065,92
"17143","51291","2021",13,13,0,266800,2412.538,107.3077
"17144","51293","2021",6,6,0,159890.3,1782,96.16667
"17145","51294","2021",2,2,0,215495,1880,115
"17146","51295","2021",4,4,0,145613.5,1251,115.25
"17147","51298","2021",3,3,0,63400,617.6667,100
"17148","51299","2021",10,10,0,278925,2260.7,124.2
"17149","51300","2021",1,1,0,163150,1665,98
"17150","51301","2021",1,1,0,250000,2101,119
"17151","51303","2021",8,8,0,165025,1624.75,105.625
"17152","51304","2021",4,4,0,131750,1098,123
"17153","51305","2021",1,1,0,395531,1814,218
"17154","51306","2021",1,1,0,48000,738,65
"17155","51307","2021",4,4,0,139650,1322.25,98.25
"17156","51308","2021",27,27,0,280718.4,2303.667,122.4444
"17157","51309","2021",2,2,0,164500,1827.5,90
"17158","51310","2021",1,1,0,370000,3058,121
"17159","51311","2021",2,2,0,68500,715.5,95
"17160","51312","2021",11,11,0,181004.5,1965.545,98.63636
"17161","51313","2021",3,3,0,129333.3,1173.333,112.3333
"17162","51314","2021",4,4,0,194737.5,1476.25,129.25
"17163","51315","2021",1,1,0,87000,916,95
"17164","51317","2021",1,1,0,15000,375,40
"17165","51318","2021",2,2,0,350000,1997.5,159
"17166","51320","2021",3,3,0,276333.3,1910,153
"17167","51323","2021",2,2,0,157500,1363.5,117.5
"17168","51324","2021",2,2,0,89000,1167.5,85
"17169","51326","2021",10,10,0,201790,1796.6,113
"17170","51327","2021",1,1,0,120000,642,187
"17171","51328","2021",10,10,0,155535,1518.3,106.5
"17172","51329","2021",15,15,0,291756.7,2708.267,110.5333
"17173","51333","2021",4,4,0,310198.8,2254,136
"17174","51336","2021",1,1,0,38500,583,66
"17175","51337","2021",2,2,0,238450,3283.5,77.5
"17176","51338","2021",15,15,0,227506.6,1846.067,124.7333
"17177","51339","2021",7,7,0,184614.3,1870,104.4286
"17178","51340","2021",8,8,0,161981.2,1503.25,110.75
"17179","51341","2021",1,1,0,87000,750,116
"17180","51342","2021",3,3,0,162150,1710.667,95.66667
"17181","51343","2021",12,12,0,151879.2,1158.333,138.1667
"17182","51344","2021",15,15,0,198162.1,2195.667,93
"17183","51345","2021",2,2,0,242500,1537,161.5
"17184","51346","2021",13,13,0,143198.9,1411.154,102.7692
"17185","51348","2021",1,1,0,167500,1419,118
"17186","51350","2021",4,4,0,169187.5,1423,118
"17187","51352","2021",5,5,0,135314,1288,116.6
"17188","51354","2021",2,2,0,174000,1439,143
"17189","51355","2021",1,1,0,80000,702,114
"17190","51356","2021",2,2,0,186000,1369,137
"17191","51357","2021",5,5,0,198450,1854.2,102
"17192","51358","2021",9,9,0,105611.1,1123.778,95.44444
"17193","51360","2021",4,4,0,120247.5,1898.5,65.75
"17194","51361","2021",2,2,0,166200,1193.5,143
"17195","51362","2021",7,7,0,311864.3,2369.286,140.2857
"17196","51363","2021",4,4,0,141850,1218.25,118.75
"17197","51365","2021",11,11,0,360981.8,2874.364,125
"17198","51367","2021",14,14,0,167526.4,1872.714,94.57143
"17199","51369","2021",4,4,0,148775,1773.5,96.5
"17200","51370","2021",3,3,0,134333.3,1012.667,128
"17201","51372","2021",5,5,0,221160,1695,133.8
"17202","51373","2021",3,3,0,187300,1620,118.6667
"17203","51374","2021",1,1,0,23000,561,41
"17204","51375","2021",5,5,0,423770,2607.8,162.8
"17205","51376","2021",1,1,0,148000,1194,124
"17206","51378","2021",3,3,0,140666.7,1571.667,91.66667
"17207","51379","2021",7,7,0,280232.9,1778.286,161
"17208","51380","2021",63,62,1,127531.7,1334.429,96.04762
"17209","51381","2021",9,6,3,170511.1,1631.667,98.22222
"17210","51382","2021",1,1,0,70000,414,169
"17211","51384","2021",3,3,0,200700,2050.667,102
"17212","51387","2021",4,4,0,152500,1905.5,87.75
"17213","51388","2021",38,35,3,166517.2,1582.579,107.0263
"17214","51389","2021",9,9,0,220175,1769.778,134.8889
"17215","51390","2021",8,8,0,195050,1865.125,106.5
"17216","51391","2021",22,20,2,287433.6,2563.273,114.1818
"17217","51392","2021",1,1,0,50000,505,99
"17218","51393","2021",2,2,0,337750,2106,172.5
"17219","51395","2021",1,1,0,115000,1150,100
"17220","51396","2021",2,2,0,155000,1669,92.5
"17221","51397","2021",1,1,0,30000,714,42
"17222","51398","2021",1,1,0,171000,1425,120
"17223","51399","2021",3,3,0,71666.67,737.6667,114
"17224","51402","2021",9,9,0,169722.2,1513.222,115.5556
"17225","51403","2021",5,5,0,208100,2300.2,93.2
"17226","51406","2021",2,2,0,127300,1382.5,90
"17227","51407","2021",10,10,0,154803,1571.7,104.6
"17228","51409","2021",3,3,0,156066.7,1257,122.6667
"17229","51410","2021",10,10,0,201735,1953.5,113
"17230","51413","2021",7,7,0,215118.9,2214,108
"17231","51415","2021",1,1,0,129000,1767,73
"17232","51416","2021",12,12,0,102208.3,995.1667,113.1667
"17233","51417","2021",5,5,0,68500,1006.2,80.6
"17234","51418","2021",5,5,0,388540,2257,181.8
"17235","51419","2021",1,1,0,87000,1145,76
"17236","51420","2021",2,2,0,121000,1111.5,107.5
"17237","51421","2021",1,1,0,155000,2313,67
"17238","51422","2021",4,4,0,445363.5,3168.25,129
"17239","51423","2021",18,18,0,93311.11,989.6667,98.66667
"17240","51424","2021",3,3,0,65833.33,651,103.3333
"17241","51425","2021",6,6,0,127166.7,1541.5,83.33333
"17242","51428","2021",4,4,0,197525,1633.75,134.75
"17243","51429","2021",5,5,0,284730,1778.4,147.2
"17244","51431","2021",10,10,0,196275,1842.8,103.7
"17245","51432","2021",6,6,0,122716.7,1118.333,108.3333
"17246","51433","2021",2,2,0,158225,1277.5,128
"17247","51434","2021",16,16,0,221243.8,1990.188,112.9375
"17248","51435","2021",1,1,0,200800,1046,192
"17249","51436","2021",9,9,0,159077.8,1504.556,107.6667
"17250","51437","2021",3,3,0,285400,1754.667,167
"17251","51439","2021",12,10,2,230434.6,2228.917,114
"17252","51440","2021",19,17,2,162644.7,1513.263,113.4211
"17253","51441","2021",1,1,0,21500,430,50
"17254","51442","2021",4,4,0,70550,619.5,107.75
"17255","51443","2021",4,4,0,121500,1104.75,111.5
"17256","51444","2021",1,1,0,334000,3408,98
"17257","51445","2021",4,4,0,269500,2404.75,122.25
"17258","51446","2021",4,4,0,146752.5,1396.25,134.5
"17259","51447","2021",5,5,0,170248,1720.8,99.4
"17260","51448","2021",12,12,0,118202.5,2468.75,54.75
"17261","51449","2021",8,8,0,271858.8,2434,115.375
"17262","51451","2021",2,2,0,169595,1093.5,157
"17263","51453","2021",11,11,0,256075.5,2094.182,121.8182
"17264","51454","2021",2674,643,2031,189532.4,2641.205,72.06507
"17265","51456","2021",2,2,0,132000,1245.5,103
"17266","51457","2021",4,4,0,154000,1408.75,114.5
"17267","51458","2021",2,2,0,135245,1113.5,120.5
"17268","51459","2021",1,1,0,190000,1508,126
"17269","51460","2021",3,3,0,111333.3,1444,90
"17270","51461","2021",6,6,0,185533.3,2080,93
"17271","51463","2021",1,1,0,85000,895,95
"17272","51464","2021",4,4,0,179332.5,1812.5,100
"17273","51465","2021",1,1,0,231220,1850,125
"17274","51466","2021",4,4,0,181722.5,1732,108
"17275","51468","2021",4,4,0,395387.5,2360.25,168
"17276","51469","2021",1,1,0,230990,1604,144
"17277","51471","2021",4,4,0,555000,2755,189.25
"17278","51472","2021",10,10,0,135515,1469,97.2
"17279","51473","2021",3,3,0,231788.3,1576,145.3333
"17280","51474","2021",46,35,11,231857.6,2447,98.67391
"17281","51476","2021",6,6,0,193900,1937.667,100.6667
"17282","51477","2021",2,2,0,162000,1562.5,102.5
"17283","51478","2021",6,6,0,206826.7,1695.667,124.1667
"17284","51479","2021",2,2,0,346700,2944.5,118.5
"17285","51480","2021",3,3,0,147666.7,1778.333,77.66667
"17286","51482","2021",5,5,0,199340,1722.2,122
"17287","51483","2021",5,5,0,210250,1925.8,109.8
"17288","51484","2021",4,4,0,138125,1215.5,134.5
"17289","51485","2021",1,1,0,123000,1108,111
"17290","51486","2021",3,3,0,140430,1475,98.33333
"17291","51487","2021",1,1,0,45000,714,63
"17292","51488","2021",1,1,0,86649,1155,75
"17293","51490","2021",3,3,0,186933.3,1707.333,110.6667
"17294","51492","2021",21,21,0,102393.6,1228.19,83.80952
"17295","51493","2021",1,1,0,605000,2420,250
"17296","51496","2021",2,2,0,152290,1515.5,100
"17297","51498","2021",2,2,0,205500,1557,132
"17298","51499","2021",2,2,0,78750,540,151.5
"17299","51501","2021",1,1,0,173000,840,206
"17300","51502","2021",1,1,0,148000,1495,99
"17301","51504","2021",11,11,0,167813.2,1726.364,99.63636
"17302","51505","2021",5,5,0,225098,1776,137.2
"17303","51506","2021",49,27,22,139534.1,1581.224,87.16327
"17304","51507","2021",48,40,8,136932.5,1383.542,108.9792
"17305","51508","2021",2,2,0,124130,1182.5,103.5
"17306","51509","2021",3,3,0,271387.3,1761.333,148.6667
"17307","51510","2021",1,1,0,247700,1769,140
"17308","51511","2021",5,5,0,83300,1010.2,83
"17309","51512","2021",3,3,0,144633.3,1306.333,117.6667
"17310","51513","2021",9,9,0,106100,1045.778,106
"17311","51514","2021",4,4,0,169343.8,1615.25,107.5
"17312","51515","2021",3,3,0,213233.3,1719.667,127
"17313","51517","2021",2,2,0,155000,1433,108
"17314","51518","2021",5,5,0,229800,2095.4,112
"17315","51519","2021",1,1,0,65000,650,100
"17316","51520","2021",1,1,0,45000,446,101
"17317","51521","2021",1,1,0,152800,1039,147
"17318","51522","2021",2,2,0,87500,941.5,101
"17319","51523","2021",2,2,0,193000,2189.5,88
"17320","51524","2021",2,2,0,106500,1321.5,80.5
"17321","51525","2021",23,23,0,212412.4,1894.87,114.6522
"17322","51526","2021",8,8,0,127686.2,1045,112.75
"17323","51527","2021",1,1,0,259400,2702,96
"17324","51528","2021",1,1,0,30000,469,64
"17325","51529","2021",6,6,0,191166.7,1651.333,125.1667
"17326","51530","2021",1,1,0,204100,1701,120
"17327","51531","2021",19,19,0,92667.47,1029.842,93.94737
"17328","51532","2021",6,6,0,258496.7,1963.333,135
"17329","51533","2021",1,1,0,148000,1663,89
"17330","51534","2021",2,2,0,285250,1774.5,169
"17331","51535","2021",58,47,11,142754.3,1496.241,97.05172
"17332","51536","2021",18,13,5,249597.2,2379.556,104.5
"17333","51537","2021",2,2,0,96450,818,112
"17334","51538","2021",1,1,0,162500,1169,139
"17335","51542","2021",3,3,0,258333.3,1859.667,136.3333
"17336","51543","2021",1,1,0,107000,1163,92
"17337","51544","2021",15,15,0,141618.1,1357.2,106.7333
"17338","51545","2021",4,4,0,149620.2,1390.25,107.25
"17339","51546","2021",2,2,0,180595,2068.5,88
"17340","51547","2021",1,1,0,60000,375,160
"17341","51548","2021",3,3,0,177000,1787,101.6667
"17342","51550","2021",1,1,0,134500,1019,132
"17343","51552","2021",8,8,0,168525,1328,126.625
"17344","51553","2021",5,5,0,152980,1359.4,123
"17345","51555","2021",1,1,0,155000,1462,106
"17346","51556","2021",3,3,0,157333.3,1101.333,139.3333
"17347","51557","2021",5,5,0,130690,1172,113.4
"17348","51558","2021",2,2,0,128840,1363.5,102.5
"17349","51559","2021",35,30,5,134514.5,1416.571,101.1714
"17350","51560","2021",1,1,0,98000,1289,76
"17351","51562","2021",27,23,4,258279.6,2602.037,97.25926
"17352","51563","2021",3,3,0,101666.7,1418.667,70.33333
"17353","51564","2021",5,5,0,168432.4,1487.8,115.4
"17354","51566","2021",1,1,0,185000,1729,107
"17355","51567","2021",2,2,0,131950,971.5,137
"17356","51568","2021",2,2,0,217500,2381.5,92
"17357","51569","2021",1,1,0,280000,2276,123
"17358","51570","2021",1,1,0,1e+05,943,106
"17359","51571","2021",9,9,0,261572.8,2450.111,104.8889
"17360","51572","2021",5,5,0,221960,1664.4,128.6
"17361","51573","2021",140,82,58,227835.5,2644.7,86.58571
"17362","51574","2021",1,1,0,120000,1277,94
"17363","51576","2021",15,14,1,164416.7,1804.933,87.73333
"17364","51577","2021",2,2,0,152500,1189.5,126
"17365","51579","2021",3,3,0,206666.7,2199,110.6667
"17366","51580","2021",2,2,0,129000,1543,80.5
"17367","51581","2021",1,1,0,269400,2749,98
"17368","51582","2021",9,9,0,268355.6,2331.778,114.6667
"17369","51583","2021",3,3,0,153000,1227,144.3333
"17370","51585","2021",7,7,0,121857.1,1251,96
"17371","51586","2021",1,1,0,273000,1820,150
"17372","51588","2021",2,2,0,106500,793.5,129.5
"17373","51589","2021",2,2,0,68500,927.5,76
"17374","51590","2021",5,4,1,117940,1404,89.8
"17375","51591","2021",4,4,0,210040,1967,111
"17376","51592","2021",2,2,0,135625,1463.5,93
"17377","51595","2021",1,1,0,167400,1419,118
"17378","51596","2021",7,7,0,180687.1,1486.429,122.8571
"17379","51597","2021",4,4,0,173125,1808,103.5
"17380","51598","2021",6,6,0,82750,1117.833,70.16667
"17381","51599","2021",3,3,0,192213.3,1972,99.66667
"17382","51600","2021",1,1,0,130000,985,132
"17383","51601","2021",1,1,0,88000,967,91
"17384","51603","2021",1,1,0,253000,1794,141
"17385","51604","2021",2,2,0,144610.5,1572.5,84.5
"17386","51605","2021",4,4,0,105250,929.25,98.75
"17387","51607","2021",4,4,0,141750,1286.5,107
"17388","51608","2021",1,1,0,125000,1033,121
"17389","51609","2021",3,2,1,163833.3,1793,87.33333
"17390","51610","2021",3,3,0,113500,920.3333,126.6667
"17391","51611","2021",5,5,0,108980,1094.8,103.8
"17392","51612","2021",33,33,0,153235,1447.758,110.1515
"17393","51613","2021",19,19,0,209226.8,2041.316,109.2105
"17394","51614","2021",13,13,0,215830.9,1867.846,117.3846
"17395","51616","2021",2,2,0,183700,1595,112
"17396","51617","2021",7,7,0,213428.6,1766.571,124.8571
"17397","51618","2021",5,5,0,160800,1803.4,107.4
"17398","51619","2021",1,1,0,117500,1306,90
"17399","51621","2021",3,3,0,102033.3,981,114.3333
"17400","51622","2021",1,1,0,180000,923,195
"17401","51623","2021",4,4,0,366000,2195.25,165.25
"17402","51624","2021",10,10,0,253760.7,1910.7,141.1
"17403","51625","2021",7,7,0,174571.4,1729.571,104.4286
"17404","51626","2021",1,1,0,190000,1667,114
"17405","51627","2021",2,2,0,83500,1096.5,72.5
"17406","51628","2021",4,4,0,65125,764.25,82.75
"17407","51629","2021",12,11,1,268066.3,2406.417,135.5
"17408","51630","2021",7,7,0,185650,1634.429,119.1429
"17409","51631","2021",1,1,0,397000,2269,175
"17410","51632","2021",3,3,0,1e+05,912,109.6667
"17411","51633","2021",6,6,0,286350,2479.5,113.5
"17412","51634","2021",2,2,0,215000,1222,179
"17413","51635","2021",1,1,0,55000,714,77
"17414","51636","2021",5,5,0,195900,1809.8,121.8
"17415","51638","2021",1,1,0,105000,1071,98
"17416","51639","2021",1,1,0,22000,629,35
"17417","51640","2021",1,1,0,86000,729,118
"17418","51641","2021",2,2,0,74750,1126,66.5
"17419","51643","2021",11,11,0,198868.2,2041.727,100.6364
"17420","51644","2021",7,7,0,122657.1,1715.286,77.28571
"17421","51645","2021",2,2,0,201525,1529.5,136.5
"17422","51646","2021",3,3,0,103166.7,983.6667,101
"17423","51647","2021",11,9,2,124027.3,1960.364,88.09091
"17424","51648","2021",2,2,0,151750,1265,120
"17425","51649","2021",128,72,56,96421.56,1122.273,87.35156
"17426","51654","2021",1,1,0,188000,1958,96
"17427","51655","2021",1,1,0,235000,2398,98
"17428","51656","2021",2,2,0,221580,1775,130.5
"17429","51657","2021",5,5,0,291900,2541.4,122
"17430","51660","2021",31,31,0,205289.4,2089.806,100.0323
"17431","51662","2021",43,33,10,245300.9,2396.558,102.8372
"17432","51663","2021",29,11,18,119650,1662.552,70.37931
"17433","52001","2021",2,2,0,80500,1028.5,65.5
"17434","52003","2021",3,3,0,106000,1053.333,97.33333
"17435","52005","2021",1,1,0,280000,718,390
"17436","52006","2021",3,3,0,105333.3,1169.667,111
"17437","52007","2021",2,2,0,51000,422.5,127.5
"17438","52008","2021",10,10,0,80780,808.8,100.1
"17439","52011","2021",2,2,0,250000,1523.5,154
"17440","52014","2021",2,2,0,108700,1142,114
"17441","52017","2021",9,9,0,105781.1,961.3333,103.8889
"17442","52021","2021",4,4,0,171948.5,1278.25,140.25
"17443","52022","2021",3,3,0,78000,871.3333,93.33333
"17444","52023","2021",4,4,0,63250,807.75,89.75
"17445","52027","2021",2,2,0,58000,604,99
"17446","52029","2021",1,1,0,68000,420,162
"17447","52030","2021",1,1,0,70000,875,80
"17448","52031","2021",1,1,0,57000,891,64
"17449","52034","2021",1,1,0,184500,1538,120
"17450","52035","2021",2,2,0,165000,1325,120
"17451","52037","2021",9,9,0,114922.2,1594,89.11111
"17452","52042","2021",1,1,0,90000,1023,88
"17453","52043","2021",2,2,0,98990,609,161.5
"17454","52044","2021",3,3,0,84000,1233.333,68.66667
"17455","52045","2021",34,34,0,147952.1,1574,95.38235
"17456","52047","2021",4,4,0,56500,543.75,105.25
"17457","52050","2021",26,26,0,102436.3,1073.923,92.46154
"17458","52055","2021",3,3,0,89333.33,691,128.6667
"17459","52056","2021",3,3,0,154833.3,929.6667,167.6667
"17460","52057","2021",2,2,0,44500,394,110
"17461","52058","2021",14,14,0,129502.9,1084,128.7143
"17462","52059","2021",2,2,0,121000,928.5,119.5
"17463","52060","2021",32,27,5,69090.16,773.7812,93.9375
"17464","52061","2021",4,4,0,126450,957.5,121.75
"17465","52064","2021",9,9,0,96866.67,789.5556,124.7778
"17466","52065","2021",2,2,0,23850,363,65.5
"17467","52069","2021",2,2,0,103000,768,137
"17468","52072","2021",5,5,0,146500,1398.6,110
"17469","52074","2021",7,7,0,78237.29,692.5714,115.1429
"17470","52075","2021",1,1,0,165000,988,167
"17471","52076","2021",3,3,0,158133.3,1649.333,108
"17472","52079","2021",4,4,0,82750,887,82
"17473","52082","2021",1,1,0,90000,529,170
"17474","52083","2021",5,5,0,67100,629.4,103
"17475","52084","2021",1,1,0,149000,1057,141
"17476","52087","2021",3,3,0,148000,1380.333,107.6667
"17477","52088","2021",8,8,0,127575,1166.375,107.25
"17478","52090","2021",1,1,0,1e+05,794,126
"17479","52091","2021",1,1,0,50876,397,128
"17480","52093","2021",31,29,2,92425.81,1020.452,93.19355
"17481","52094","2021",5,5,0,87143.8,891,96.4
"17482","52095","2021",7,7,0,63757.14,556.4286,109.2857
"17483","52099","2021",10,9,1,139420,1352.7,104.6
"17484","52102","2021",4,3,1,142475,1219,106.75
"17485","52104","2021",23,23,0,149093.9,1360.13,111.0435
"17486","52106","2021",2,2,0,113500,1085,103
"17487","52107","2021",5,5,0,145693,1203.8,119
"17488","52108","2021",2,2,0,85000,647,130
"17489","52110","2021",4,4,0,96175,850.25,111.25
"17490","52113","2021",6,6,0,74050,913.3333,79.16667
"17491","52114","2021",17,16,1,122138.5,983.4706,125.2941
"17492","52115","2021",3,3,0,119333.3,858,138
"17493","52118","2021",4,4,0,95125,842.75,111.5
"17494","52119","2021",5,4,1,111944,1068.8,107.8
"17495","52120","2021",3,3,0,79000,810.3333,96.33333
"17496","52121","2021",250,146,104,124586.4,1413.096,89.98
"17497","52122","2021",1,1,0,35000,398,88
"17498","52123","2021",17,17,0,125320.6,1134.706,111.4118
"17499","52125","2021",12,11,1,138425.1,1404.25,103
"17500","52127","2021",1,1,0,706800,2348,301
"17501","52128","2021",3,3,0,105666.7,889,121.6667
"17502","52130","2021",3,3,0,36666.67,436.6667,86.66667
"17503","52131","2021",1,1,0,109500,702,156
"17504","52132","2021",1,1,0,120000,1500,80
"17505","52133","2021",1,1,0,45000,366,123
"17506","52134","2021",3,3,0,55489.67,627,86.66667
"17507","52138","2021",1,1,0,30000,370,81
"17508","52140","2021",10,10,0,88762,1173.8,88.2
"17509","52141","2021",4,4,0,152971.2,1583,94.75
"17510","52142","2021",1,1,0,130000,1327,98
"17511","52145","2021",1,1,0,79350,794,100
"17512","52146","2021",2,2,0,139185,972.5,134.5
"17513","52149","2021",1,1,0,51800,475,109
"17514","52155","2021",7,7,0,95228.57,1078.143,90.14286
"17515","52156","2021",8,8,0,60412.5,734,82.125
"17516","52158","2021",7,7,0,80857.14,822.8571,100.4286
"17517","52163","2021",4,4,0,105000,836.25,123
"17518","52165","2021",3,3,0,91916.67,776.6667,120.6667
"17519","52167","2021",2,2,0,177375,1289,139.5
"17520","52168","2021",1,1,0,45000,562,80
"17521","52170","2021",1,1,0,163000,604,270
"17522","52171","2021",5,5,0,69300,724.6,105.2
"17523","52172","2021",5,5,0,103500,613.8,179.8
"17524","52173","2021",1,1,0,25000,417,60
"17525","52174","2021",1,1,0,23723,474,50
"17526","52175","2021",2,2,0,130550,813,156.5
"17527","52177","2021",10,9,1,85000,944.4,98.1
"17528","52178","2021",5,5,0,103978,710.4,153
"17529","52181","2021",1,1,0,78000,867,90
"17530","52182","2021",27,26,1,146444.4,1418.926,105.6667
"17531","52183","2021",1,1,0,795000,9938,80
"17532","52187","2021",4,4,0,59618.75,790.75,77.75
"17533","52189","2021",5,5,0,112333,887.4,148.6
"17534","52190","2021",2,2,0,102900,864,139
"17535","52193","2021",6,6,0,163333.3,1415,124.1667
"17536","52194","2021",25,25,0,98620,1112.84,89.32
"17537","52196","2021",1,1,0,120000,588,204
"17538","52200","2021",1,1,0,113500,1320,86
"17539","52201","2021",2,2,0,71000,513.5,146
"17540","52203","2021",2,2,0,135000,1115,116.5
"17541","52204","2021",1,1,0,119110,1134,105
"17542","52205","2021",15,15,0,114520,1053.133,111.9333
"17543","52206","2021",2,2,0,52500,663,78
"17544","52207","2021",2,2,0,129000,1216,115.5
"17545","52211","2021",12,12,0,67458.33,728.25,95.75
"17546","52212","2021",1,1,0,120000,1379,87
"17547","52213","2021",3,3,0,105031.7,1145,102
"17548","52216","2021",1,1,0,133000,950,140
"17549","52217","2021",2,2,0,57535,441,131.5
"17550","52220","2021",4,4,0,119725,1165.5,101.5
"17551","52221","2021",4,4,0,155250,1176.25,120
"17552","52223","2021",1,1,0,27500,382,72
"17553","52227","2021",2,2,0,115500,831,156.5
"17554","52228","2021",1,1,0,190000,686,277
"17555","52229","2021",3,3,0,72000,896.6667,86.33333
"17556","52230","2021",2,2,0,85500,686,112
"17557","52231","2021",2,2,0,151500,1300,120.5
"17558","52235","2021",3,3,0,73100,944.3333,78.33333
"17559","52237","2021",3,3,0,69333.33,739.3333,102.3333
"17560","52240","2021",2,2,0,103500,747.5,118
"17561","52243","2021",1,1,0,45000,409,110
"17562","52244","2021",8,8,0,170962.5,1436.75,121.25
"17563","52245","2021",1,1,0,203500,841,242
"17564","52246","2021",6,6,0,100116.7,1067.5,89.33333
"17565","52248","2021",3,3,0,89000,1168.333,74
"17566","52249","2021",2,2,0,208750,1416.5,118.5
"17567","52250","2021",39,36,3,77985.49,999,87.30769
"17568","52251","2021",9,9,0,162033.3,1637.889,99.88889
"17569","52253","2021",1,1,0,70000,598,117
"17570","52254","2021",1,1,0,110000,733,150
"17571","52258","2021",2,2,0,65000,716,91
"17572","52265","2021",11,11,0,84368.18,1096.636,78.54545
"17573","52267","2021",2,2,0,120000,1230,98
"17574","52269","2021",81,47,34,118658,1269.617,92.22222
"17575","52271","2021",2,2,0,64000,802,81
"17576","52272","2021",1,1,0,95000,1056,90
"17577","52274","2021",4,4,0,101750,706.5,146.75
"17578","52276","2021",3,3,0,101000,1093.667,108.3333
"17579","52277","2021",1,1,0,50000,376,133
"17580","52278","2021",1,1,0,25000,347,72
"17581","52280","2021",3,3,0,108600,1050.333,105.6667
"17582","52282","2021",3,3,0,143333.3,1027,139.3333
"17583","52284","2021",1,1,0,132000,917,144
"17584","52287","2021",1,1,0,46000,438,105
"17585","52288","2021",1,1,0,22000,500,44
"17586","52289","2021",2,2,0,54140,860.5,62.5
"17587","52290","2021",1,1,0,158000,1699,93
"17588","52292","2021",7,7,0,130571.4,1007.429,135
"17589","52294","2021",7,7,0,318828.6,2428.143,123.4286
"17590","52297","2021",1,1,0,218000,1090,200
"17591","52300","2021",2,2,0,82000,910,91
"17592","52302","2021",4,4,0,105950.5,1233,88
"17593","52305","2021",4,4,0,104500,1004,104.75
"17594","52306","2021",2,2,0,95000,1102.5,102.5
"17595","52307","2021",5,5,0,117000,1077.8,114.2
"17596","52308","2021",7,7,0,115699.3,993.8571,123.2857
"17597","52310","2021",1,1,0,65000,663,98
"17598","52312","2021",1,1,0,40000,667,60
"17599","52315","2021",3,3,0,164000,1304.333,128
"17600","52316","2021",2,2,0,45200,470,100
"17601","52320","2021",2,2,0,45000,615,70.5
"17602","52325","2021",1,1,0,60000,723,83
"17603","52327","2021",4,4,0,140250,1215.75,119.75
"17604","52330","2021",1,1,0,154000,901,171
"17605","52331","2021",30,30,0,124258.3,1201.9,109.9
"17606","52332","2021",21,21,0,97952.38,877.6667,110.6667
"17607","52335","2021",1,1,0,50000,472,106
"17608","52336","2021",1,1,0,157000,924,170
"17609","52341","2021",2,2,0,134000,1104.5,125.5
"17610","52346","2021",5,5,0,66000,835.2,83.2
"17611","52347","2021",2,2,0,72500,650,121.5
"17612","52348","2021",10,10,0,100680,947.1,110
"17613","52349","2021",1,1,0,135000,1627,83
"17614","52353","2021",42,38,4,82567.86,949.3095,87
"17615","52354","2021",1,1,0,53000,520,102
"17616","52355","2021",3,3,0,168733.3,1172.667,140
"17617","52356","2021",2,2,0,75000,846.5,85
"17618","52357","2021",4,4,0,196750,985.5,162.25
"17619","52358","2021",1,1,0,62800,341,184
"17620","52359","2021",3,3,0,70333.33,660.6667,108.3333
"17621","52360","2021",3,3,0,82833.33,1067,77
"17622","52364","2021",1,1,0,57200,520,110
"17623","52365","2021",2,2,0,108000,547,187.5
"17624","52366","2021",1,1,0,135000,1929,70
"17625","52367","2021",2,2,0,101000,1102,94
"17626","52370","2021",3,3,0,50166.67,601,82
"17627","52371","2021",3,3,0,108666.7,941,124.6667
"17628","52373","2021",2,2,0,65000,450,147.5
"17629","52374","2021",1,1,0,134120,1090,123
"17630","52375","2021",1,1,0,2e+05,1653,121
"17631","52376","2021",1,1,0,88000,957,92
"17632","52380","2021",5,5,0,70344,1132.2,75.4
"17633","52383","2021",5,5,0,165292,1429,103.4
"17634","52384","2021",1,1,0,112000,1018,110
"17635","52385","2021",1,1,0,35000,350,100
"17636","52386","2021",10,10,0,92300,773.1,120.1
"17637","52393","2021",1,1,0,40000,741,54
"17638","52396","2021",1,1,0,110000,965,114
"17639","52398","2021",7,7,0,74700,676.4286,125.1429
"17640","52399","2021",4,4,0,67000,691.75,95.5
"17641","52401","2021",3,3,0,139666.7,1159.333,106
"17642","52403","2021",1,1,0,54000,568,95
"17643","52405","2021",16,16,0,141468.8,1333.25,110.375
"17644","52407","2021",2,2,0,92500,1424,68
"17645","52411","2021",13,13,0,116246.2,1016.615,117.1538
"17646","52414","2021",2,2,0,89750,1009.5,90.5
"17647","52420","2021",1,1,0,26000,650,40
"17648","52421","2021",6,6,0,131333.3,1193.5,111
"17649","52422","2021",5,5,0,168600,1280,135.4
"17650","52423","2021",7,7,0,135542.9,1045,128.7143
"17651","52424","2021",1,1,0,74070,433,171
"17652","52425","2021",4,4,0,78575,939.5,89.25
"17653","52426","2021",1,1,0,50000,625,80
"17654","52428","2021",3,3,0,110920,908.6667,108.6667
"17655","52429","2021",6,6,0,107966.7,949.6667,108.5
"17656","52431","2021",6,6,0,83818,735.5,111.8333
"17657","52432","2021",11,11,0,79500,887.4545,88.18182
"17658","52433","2021",2,2,0,64000,403.5,160
"17659","52436","2021",1,1,0,47500,709,67
"17660","52440","2021",3,3,0,154153.3,1130.667,145
"17661","52443","2021",1,1,0,81000,736,110
"17662","52444","2021",4,4,0,85125,847.75,104.25
"17663","52445","2021",2,2,0,75695,721,105
"17664","52447","2021",4,4,0,123233.5,1193.25,95.5
"17665","52448","2021",333,245,88,107494.7,1206.03,89.23423
"17666","52449","2021",9,9,0,120722.2,1090.778,110.4444
"17667","52450","2021",3,3,0,74250,761.6667,95.66667
"17668","52452","2021",1,1,0,193000,975,198
"17669","52453","2021",1,1,0,48000,400,120
"17670","52455","2021",2,2,0,91250,958.5,147.5
"17671","52456","2021",4,4,0,71750,916.75,74.75
"17672","52457","2021",2,2,0,163250,1613,101.5
"17673","52459","2021",3,3,0,133666.7,1033,129.6667
"17674","52461","2021",4,4,0,106750,789,142.5
"17675","52464","2021",2,2,0,69000,657,109
"17676","52469","2021",7,7,0,155642.9,1322.714,120.8571
"17677","52472","2021",3,3,0,136333.3,1219.667,105
"17678","52473","2021",2,2,0,52500,537,97.5
"17679","52475","2021",1,1,0,98000,899,109
"17680","52476","2021",2,2,0,87336,986.5,82.5
"17681","52479","2021",6,6,0,123550,803,152.5
"17682","52480","2021",7,7,0,128871.4,1118.286,114
"17683","52482","2021",2,2,0,77000,569.5,136.5
"17684","52484","2021",3,3,0,110000,1008.667,110.3333
"17685","52486","2021",3,3,0,133666.7,1167,115.3333
"17686","52488","2021",2,2,0,84750,532,149
"17687","52490","2021",5,5,0,92170,866.2,96.6
"17688","52492","2021",7,7,0,142178.6,1313.143,109
"17689","52494","2021",2,2,0,162400,1211,133
"17690","52497","2021",1,1,0,121500,1180,103
"17691","52499","2021",5,5,0,80630,722.2,114.6
"17692","52500","2021",15,15,0,131432.9,1202.467,104.3333
"17693","52510","2021",3,3,0,82333.33,818.3333,100.6667
"17694","52511","2021",1,1,0,48000,480,100
"17695","52512","2021",1,1,0,33000,550,60
"17696","52514","2021",4,4,0,188000,1656,119.75
"17697","52515","2021",2,2,0,101716.5,855.5,117.5
"17698","52516","2021",1,1,0,131000,929,141
"17699","52517","2021",1,1,0,220000,3548,62
"17700","52520","2021",4,4,0,71823.75,665.5,94
"17701","52522","2021",5,5,0,96400,1133.2,78.2
"17702","52523","2021",1,1,0,26000,433,60
"17703","52524","2021",8,8,0,39225,558.375,73.875
"17704","52525","2021",1,1,0,152000,905,168
"17705","52526","2021",5,5,0,74936,556.2,145.4
"17706","52528","2021",2,2,0,92500,1112.5,84.5
"17707","52529","2021",17,16,1,79625.88,815.8824,97.64706
"17708","52534","2021",22,22,0,139410.5,1348,108.4545
"17709","52535","2021",12,12,0,120583.3,1267.917,92
"17710","52538","2021",3,3,0,171666.7,1516,124
"17711","52541","2021",2,2,0,99750,882,111.5
"17712","52542","2021",1,1,0,77000,481,160
"17713","52543","2021",7,7,0,132578.9,1160.571,109.1429
"17714","52547","2021",3,3,0,129000,1018.667,128
"17715","52550","2021",26,26,0,101957.5,1070.308,98.76923
"17716","53001","2021",21,21,0,164635.5,1640.714,103.3333
"17717","53002","2021",13,13,0,110206.2,1113,98.07692
"17718","53003","2021",51,51,0,109487.3,1100.294,95.43137
"17719","53005","2021",29,27,2,124305.4,1373.069,94.24138
"17720","53007","2021",35,35,0,178620.1,1615.486,110.0857
"17721","53008","2021",17,17,0,138420.8,1380.353,100.0588
"17722","53009","2021",8,8,0,130625,1346.125,94.25
"17723","53010","2021",5,5,0,66800,934.8,74.2
"17724","53011","2021",11,11,0,134213.3,1371.273,96.72727
"17725","53012","2021",6,6,0,119551.7,1479.167,81.16667
"17726","53013","2021",10,10,0,88260,893.1,95.9
"17727","53015","2021",21,21,0,138619,1460.333,94.19048
"17728","53016","2021",25,23,2,99100,1024.24,103.72
"17729","53017","2021",16,15,1,103356.2,1031.688,102.6875
"17730","53018","2021",17,17,0,112347.1,1188.412,103.3529
"17731","53021","2021",12,12,0,207312.5,1633.167,133.0833
"17732","53022","2021",15,15,0,131413.3,1363.933,98.86667
"17733","53023","2021",8,8,0,160625,1520.625,109.5
"17734","53025","2021",19,19,0,147399.1,1361.737,108.8421
"17735","53026","2021",9,9,0,140111.1,1344.778,98.22222
"17736","53027","2021",5,5,0,186912.4,1144.2,145.4
"17737","53028","2021",9,9,0,143341.7,1351.556,113.7778
"17738","53029","2021",36,36,0,119671.4,1041.833,109.7222
"17739","53030","2021",4,4,0,60375,676.25,83.5
"17740","53031","2021",9,9,0,145444.4,1343.111,103.5556
"17741","53033","2021",2,2,0,277510,3964.5,70
"17742","53034","2021",95,95,0,214185.8,2113.337,104.6632
"17743","53035","2021",10,10,0,146538.8,1439.4,107.5
"17744","53036","2021",20,20,0,115778.5,1066.35,108.1
"17745","53037","2021",14,14,0,130250,1348.643,97.07143
"17746","53038","2021",1,1,0,138000,1200,115
"17747","53039","2021",19,17,2,138183.7,1345.211,109
"17748","53040","2021",9,9,0,116766.7,1319.778,83.88889
"17749","53041","2021",8,8,0,143080,1291.75,110.375
"17750","53042","2021",19,19,0,98515.79,1127.368,94.10526
"17751","53043","2021",9,9,0,152111.1,1176,122.7778
"17752","53045","2021",11,11,0,156500,1624.091,101.7273
"17753","53046","2021",6,6,0,132333.3,1123,127.1667
"17754","53047","2021",2,2,0,121400,1303,101
"17755","53048","2021",27,25,2,111230,1380.296,83.44444
"17756","53049","2021",10,10,0,147000,1630.3,98.6
"17757","53051","2021",9,9,0,113681.9,1241.667,93.66667
"17758","53052","2021",5,5,0,160700,1238.6,125.8
"17759","53053","2021",11,11,0,97000,1133.364,96.09091
"17760","53054","2021",70,65,5,249772,2312.971,109.9143
"17761","53055","2021",11,10,1,81523.55,1054.545,78.54545
"17762","53056","2021",12,12,0,167558.3,1636.25,101.8333
"17763","53057","2021",5,5,0,88740,1282,77.2
"17764","53058","2021",7,7,0,151042.9,1288.143,120.1429
"17765","53059","2021",8,8,0,129687.5,1371.5,91.375
"17766","53061","2021",9,8,1,75361.11,786.6667,95.77778
"17767","53062","2021",291,250,41,166034.7,1728.639,95.39175
"17768","53063","2021",11,11,0,123272.7,1018.818,121
"17769","53064","2021",20,20,0,103235.1,1329.9,91.8
"17770","53066","2021",21,21,0,169071.4,1482.286,113.9524
"17771","53067","2021",13,13,0,122107.7,1114.385,110.1538
"17772","53068","2021",4,4,0,222525,1226.25,186.25
"17773","53069","2021",7,7,0,73442.86,828.5714,84.57143
"17774","53071","2021",10,10,0,115500.5,1038.8,122.6
"17775","53072","2021",19,19,0,136126.3,1316.421,105.3684
"17776","53073","2021",21,21,0,118001.7,1212.571,97.09524
"17777","53074","2021",11,10,1,142386.4,1547.455,96
"17778","53075","2021",7,7,0,123871.4,1113.571,112
"17779","53076","2021",4,4,0,155194.2,1929,88.5
"17780","53077","2021",43,43,0,149994.6,1492.605,100.0233
"17781","53078","2021",9,9,0,171295.6,1557.111,110.7778
"17782","53079","2021",12,12,0,73700,924,81.33333
"17783","53080","2021",4,4,0,45500,551.5,84.75
"17784","53082","2021",9,9,0,144054.4,1471.778,98.55556
"17785","53083","2021",19,19,0,86247.89,853.3158,96.42105
"17786","53084","2021",99,97,2,129284.9,1319.394,100.2323
"17787","53085","2021",2,2,0,154000,1112,120
"17788","53086","2021",14,14,0,124542.9,1508.857,96.07143
"17789","53087","2021",3,3,0,141000,1274.333,114
"17790","53088","2021",15,15,0,102260,1110.133,91.46667
"17791","53089","2021",5,5,0,118400,1073.2,104.4
"17792","53090","2021",1,1,0,78600,689,114
"17793","53091","2021",15,15,0,79573.27,869.7333,92.8
"17794","53093","2021",7,7,0,126035.7,1247.286,99.57143
"17795","53094","2021",19,18,1,128786.8,1657.316,77.94737
"17796","53096","2021",106,101,5,98991.13,1077.264,93.39623
"17797","53097","2021",135,124,11,115454.8,1402.052,84.86667
"17798","53098","2021",10,10,0,128336.5,1406.9,98.5
"17799","53099","2021",10,10,0,161930,1762,94.4
"17800","53100","2021",33,33,0,86109.76,975.9091,92.21212
"17801","53101","2021",19,19,0,158322.6,1309.684,115.1579
"17802","53102","2021",1,1,0,1e+05,1149,87
"17803","53103","2021",32,32,0,152095.7,1520.938,101.5938
"17804","53104","2021",20,20,0,140000,1308.05,103.7
"17805","53105","2021",1,1,0,138000,1150,120
"17806","53106","2021",10,10,0,96310,842.6,111
"17807","53107","2021",45,42,3,88977.16,933.0444,95.17778
"17808","53108","2021",7,7,0,136671.4,1093,116.5714
"17809","53109","2021",17,17,0,113341.8,1134.059,100
"17810","53110","2021",13,13,0,97727.77,949.9231,121
"17811","53111","2021",8,8,0,124187.5,1100.75,116.75
"17812","53112","2021",12,12,0,75400.25,917,84.66667
"17813","53113","2021",10,10,0,101687,1021.5,98.8
"17814","53114","2021",5,5,0,93900,769.6,115.4
"17815","53115","2021",4,4,0,171575,1483.75,120.75
"17816","53116","2021",14,14,0,92871.43,1027.143,85
"17817","53117","2021",8,8,0,165663.8,1140,136.875
"17818","53118","2021",1,1,0,47000,723,65
"17819","53119","2021",70,70,0,233675.4,2051.771,114.7286
"17820","53120","2021",7,7,0,64000,821,74.42857
"17821","53121","2021",20,20,0,91465,1007,97.45
"17822","53122","2021",4,4,0,95750,1071.5,87.25
"17823","53123","2021",32,30,2,120707.5,1100.031,110.9688
"17824","53124","2021",21,21,0,129000,1221.714,105
"17825","53125","2021",19,19,0,105517.1,1035.263,104.3684
"17826","53126","2021",14,14,0,125508.7,1277.571,90.71429
"17827","53127","2021",52,52,0,87674.9,1056.904,86.59615
"17828","53128","2021",3,3,0,95866.67,1012.333,100.6667
"17829","53129","2021",2,2,0,187500,1531.5,122
"17830","53130","2021",859,427,432,164662.9,2099.22,79.63097
"17831","53131","2021",5,5,0,112200,1320.8,83.6
"17832","53132","2021",8,8,0,118656.2,1053.75,111.25
"17833","53133","2021",7,7,0,137790,968,130.1429
"17834","53134","2021",3,3,0,99333.33,1273.667,80
"17835","53135","2021",21,21,0,129384.8,1211.857,110.3333
"17836","53136","2021",11,11,0,182250,1299.182,145.0909
"17837","53137","2021",29,29,0,159215.7,1636.897,97.03448
"17838","53139","2021",7,7,0,72692.86,993,72.71429
"17839","53140","2021",49,41,8,183046.5,2010.224,92.22449
"17840","53141","2021",22,22,0,180278,1881.5,96.31818
"17841","53142","2021",9,9,0,62477.78,918.6667,71.44444
"17842","53143","2021",5,5,0,186200,1640.6,113
"17843","53144","2021",14,14,0,93214.29,1095.643,90.92857
"17844","53145","2021",10,10,0,114656.8,1263.7,89.6
"17845","53146","2021",25,25,0,155456.4,1538,102.68
"17846","53147","2021",179,138,41,128075.2,1484.866,88.22346
"17847","53148","2021",4,4,0,136975,969.5,132.75
"17848","53150","2021",11,11,0,126340,1273.182,103.5455
"17849","53151","2021",10,10,0,113550,1179.6,97.1
"17850","53152","2021",49,43,6,134107.3,1477.163,89.08163
"17851","53153","2021",9,9,0,157338.9,1373.444,109.1111
"17852","53154","2021",15,15,0,106506.7,1237.267,87.66667
"17853","53155","2021",26,26,0,141633.7,1329.615,101.6923
"17854","53156","2021",2,2,0,44017,854,56
"17855","53157","2021",13,13,0,207507.7,1821.769,113.5385
"17856","53158","2021",16,15,1,151647.3,1349.75,117.375
"17857","53160","2021",10,10,0,69686.5,834.4,91.1
"17858","53161","2021",51,47,4,113715.4,1189.314,96.2549
"17859","53162","2021",17,13,4,141956.6,1464.353,96
"17860","53163","2021",10,10,0,113800,1214.9,89.2
"17861","53164","2021",13,13,0,103346.2,890.7692,122.1538
"17862","53165","2021",3,3,0,110333.3,1045,115
"17863","53168","2021",22,22,0,136800.5,1392.955,100.5455
"17864","53169","2021",5,5,0,70000,1130.6,65
"17865","53170","2021",19,19,0,103317.4,1166.789,85.68421
"17866","53172","2021",7,7,0,158428.6,1613.143,103.4286
"17867","53173","2021",2,2,0,127500,1256.5,101
"17868","53174","2021",5,5,0,164870.4,1393.4,121.6
"17869","53175","2021",17,17,0,207626.5,1806.235,120.6471
"17870","53176","2021",8,8,0,126999.9,1247.375,106.125
"17871","53177","2021",7,7,0,103163.1,1058.143,108
"17872","53178","2021",7,7,0,135357.1,1306.857,108.5714
"17873","53179","2021",7,7,0,88142.86,974.1429,96.57143
"17874","53180","2021",11,11,0,131945.5,1257.909,108.9091
"17875","53181","2021",18,18,0,93025,1079.167,87.16667
"17876","53182","2021",48,47,1,111931.6,1299.438,86.64583
"17877","53185","2021",46,46,0,95691.54,1004.652,99.63043
"17878","53186","2021",30,29,1,141633.3,1531.167,100.6667
"17879","53187","2021",4,4,0,162895,1263.75,128
"17880","53188","2021",64,64,0,79502.66,935.0469,87.75
"17881","53189","2021",3,3,0,73333.33,961.3333,85.33333
"17882","53190","2021",9,9,0,98511.11,1162,84.33333
"17883","53191","2021",12,12,0,102554.2,1010.333,97.58333
"17884","53192","2021",5,5,0,108604,1046.6,97.8
"17885","53193","2021",11,11,0,178568.2,1396.273,138
"17886","53195","2021",5,5,0,205680,1805,115.8
"17887","53196","2021",9,9,0,118401,1199.333,105
"17888","53197","2021",26,26,0,101884.6,997.6154,101.6538
"17889","53198","2021",9,9,0,65683.33,813.3333,74.55556
"17890","53199","2021",7,7,0,76000,954.8571,78.71429
"17891","53200","2021",14,14,0,162260.9,1750,93.57143
"17892","53201","2021",89,81,8,195499.9,1982.82,99.51685
"17893","53202","2021",12,12,0,124610.8,1115.333,114.6667
"17894","53203","2021",16,16,0,93718.75,992.75,93.75
"17895","53204","2021",7,7,0,92898.57,928.1429,106.4286
"17896","53206","2021",5,5,0,109000,1246,87.8
"17897","53208","2021",13,13,0,75974.69,974.0769,79.76923
"17898","53209","2021",9,9,0,134277.8,1313.889,98
"17899","53210","2021",26,24,2,111984.2,1158.538,91.76923
"17900","53211","2021",18,18,0,108352,909.8889,115.8889
"17901","53212","2021",5,5,0,153654,1266,125.4
"17902","53213","2021",16,16,0,83575,1178.375,75.9375
"17903","53214","2021",3,3,0,132000,1287,103.3333
"17904","53216","2021",21,20,1,102614.3,1170.857,88.33333
"17905","53218","2021",13,13,0,150230.8,1361.231,109.5385
"17906","53219","2021",26,26,0,127237.5,1344.615,102.3846
"17907","53220","2021",1,1,0,30000,600,50
"17908","53221","2021",9,9,0,148544.7,1702.222,95.66667
"17909","53222","2021",7,7,0,228339.4,2501.429,93.42857
"17910","53223","2021",13,13,0,70769.23,830.9231,92.15385
"17911","53224","2021",12,12,0,193916.7,1969.833,103.5833
"17912","53225","2021",11,11,0,110528.2,1151.364,102.5455
"17913","53226","2021",11,11,0,167036.4,1398.091,117.2727
"17914","53228","2021",18,18,0,159722.2,1273.667,111.3889
"17915","53229","2021",29,29,0,217010.3,1887.517,121.3448
"17916","53230","2021",4,4,0,70500,683.75,102
"17917","53232","2021",4,4,0,130650,1238.75,101
"17918","53233","2021",7,7,0,138571.4,1109,116.2857
"17919","53234","2021",8,8,0,119500,965.5,118.25
"17920","53235","2021",9,9,0,99111.11,1068.111,95.33333
"17921","53236","2021",6,6,0,73000,723.6667,98.66667
"17922","53237","2021",5,5,0,116445,1248.6,94
"17923","53238","2021",10,10,0,120230,1030.2,124.4
"17924","53240","2021",6,6,0,144750,1367.667,103
"17925","53242","2021",9,9,0,149888.9,1369.333,107.4444
"17926","53243","2021",30,30,0,160908,1612.933,102.1667
"17927","53245","2021",21,21,0,83381.43,1021.19,85.14286
"17928","53246","2021",30,30,0,120600,1212.933,95.5
"17929","53247","2021",50,49,1,155808.1,1656.22,92.96
"17930","53248","2021",4,4,0,71950,1429.75,53.75
"17931","53249","2021",31,31,0,114994.2,1171.452,98.51613
"17932","53250","2021",9,9,0,82586.67,1038.778,83.22222
"17933","53251","2021",5,5,0,126624,1136.8,115.2
"17934","53253","2021",14,14,0,105067.9,1150.571,90.92857
"17935","53255","2021",37,37,0,115746,1155.568,98.94595
"17936","53256","2021",7,7,0,100636.6,914.1429,112
"17937","53257","2021",8,8,0,86575,817.5,109.625
"17938","53258","2021",15,15,0,129813.3,1220.267,108.9333
"17939","53259","2021",4,4,0,159375,989,154.5
"17940","53260","2021",2,2,0,170000,1076,159
"17941","53261","2021",1,1,0,297650,2918,102
"17942","53262","2021",16,16,0,148273.8,1272.688,117
"17943","53263","2021",5,5,0,117200,912.8,122.8
"17944","53264","2021",4,4,0,94837.5,799.25,114.25
"17945","53265","2021",25,25,0,139378,1248.92,111.28
"17946","53266","2021",5,5,0,140300,2017,79
"17947","53267","2021",31,31,0,110345.5,1188.71,95.96774
"17948","53269","2021",8,8,0,85325,1132.75,74
"17949","53270","2021",1,1,0,54000,771,70
"17950","53271","2021",52,50,2,84901,1064.865,81.98077
"17951","53272","2021",6,6,0,108750,1093.5,104.1667
"17952","53273","2021",22,22,0,147400.5,1391.364,104.4545
"17953","53276","2021",13,13,0,69538.46,887.7692,81.92308
"17954","54001","2021",6,6,0,184683.3,1474,125.5
"17955","54002","2021",3,2,1,132256.7,1399.333,95.66667
"17956","54003","2021",2,2,0,144000,671.5,214.5
"17957","54004","2021",3,3,0,185650,1845.667,104.6667
"17958","54005","2021",3,3,0,177666.7,1208,156
"17959","54006","2021",3,1,2,245500,1729.667,126.6667
"17960","54007","2021",10,10,0,166565.5,1466.6,124.6
"17961","54008","2021",12,12,0,154355.8,1523,107.75
"17962","54009","2021",1,1,0,40000,513,78
"17963","54010","2021",7,7,0,173071.4,1475,117.7143
"17964","54011","2021",4,4,0,114750,843.5,118.75
"17965","54012","2021",5,5,0,230280,1674.4,136
"17966","54014","2021",4,4,0,59500,541.75,119.75
"17967","54015","2021",2,2,0,60500,685.5,92
"17968","54016","2021",1,1,0,165000,1774,93
"17969","54017","2021",2,2,0,148250,749.5,221.5
"17970","54018","2021",6,5,1,174033.3,979.1667,151.1667
"17971","54020","2021",3,3,0,118583.3,1478,77.33333
"17972","54021","2021",6,6,0,125170.2,1226.333,94.33333
"17973","54022","2021",6,6,0,182966.7,1608.667,108.6667
"17974","54023","2021",8,8,0,102561.9,998.5,103.5
"17975","54024","2021",2,2,0,164500,1075.5,152.5
"17976","54025","2021",20,18,2,255376.5,2385.2,109.35
"17977","54026","2021",6,6,0,153691.7,1381.5,122.1667
"17978","54027","2021",10,9,1,181515,1643.4,110.1
"17979","54028","2021",46,30,16,116404.2,1414.696,86.54348
"17980","54029","2021",33,27,6,238791.2,2263.03,107.7273
"17981","54030","2021",1,1,0,142200,1094,130
"17982","54031","2021",9,9,0,148166.7,1672.778,85.33333
"17983","54032","2021",2,2,0,147700,1323,112.5
"17984","54034","2021",3,2,1,182008.3,1420,125.6667
"17985","54035","2021",8,8,0,78593.75,750.125,111.75
"17986","54036","2021",8,7,1,262010.9,2471.875,111
"17987","54037","2021",2,2,0,285500,2634.5,108
"17988","54038","2021",14,14,0,118535.7,1112.786,111.6429
"17989","54039","2021",54,42,12,116664.4,1231.796,99.90741
"17990","54040","2021",26,25,1,83829.23,853.3077,100.9231
"17991","54041","2021",4,4,0,64750,579.5,107.75
"17992","54042","2021",3,3,0,175881.7,1412.333,127
"17993","54043","2021",13,9,4,149419.4,1616.538,92.53846
"17994","54044","2021",1,1,0,90000,1429,63
"17995","54045","2021",4,3,1,200812.5,1739.25,112
"17996","54046","2021",8,8,0,142287.5,1232.375,117.375
"17997","54047","2021",5,5,0,100420,905.8,110.4
"17998","54048","2021",3,3,0,236750,2357.667,99.66667
"17999","54049","2021",11,11,0,183521.8,1773.091,103.6364
"18000","54051","2021",26,23,3,210062.3,1742.808,119.8846
"18001","54052","2021",2,2,0,62500,703,88
"18002","54053","2021",2,2,0,105800,579.5,160
"18003","54054","2021",20,15,5,178435,1546,117.95
"18004","54055","2021",2,2,0,140775,2378.5,73
"18005","54056","2021",2,2,0,328700,2094.5,159
"18006","54057","2021",1,1,0,160000,1067,150
"18007","54059","2021",9,9,0,150711.1,1223.889,131
"18008","54060","2021",11,11,0,171854.5,2055.818,82.72727
"18009","54061","2021",9,8,1,182591.1,1504.778,129.2222
"18010","54062","2021",6,6,0,287655.8,2043.167,146.5
"18011","54063","2021",2,2,0,165000,953.5,200
"18012","54064","2021",8,8,0,85812.5,893.625,95.125
"18013","54065","2021",17,17,0,89382.35,973.0588,95.47059
"18014","54066","2021",8,8,0,193090,1588.25,122.875
"18015","54067","2021",14,11,3,194627.5,1562.5,122.3571
"18016","54068","2021",2,2,0,123025,1263.5,91.5
"18017","54069","2021",4,3,1,295325,2573.75,112.5
"18018","54070","2021",3,3,0,339583.3,2433.333,134.6667
"18019","54071","2021",4,4,0,119737.5,812.75,145.25
"18020","54072","2021",2,2,0,124740,1261.5,86
"18021","54073","2021",12,12,0,156434,1577.167,99.91667
"18022","54074","2021",1,1,0,160900,1287,125
"18023","54075","2021",2,2,0,117500,1236,95
"18024","54076","2021",55,50,5,168477.8,1683.218,100.7273
"18025","54077","2021",21,19,2,105950,1138.19,99.95238
"18026","54079","2021",46,35,11,153421.7,1593.261,97.36957
"18027","54080","2021",19,16,3,126880.8,1083.421,130.8421
"18028","54081","2021",7,7,0,198062.9,1882.857,109.7143
"18029","54082","2021",1,1,0,169500,1994,85
"18030","54083","2021",1,1,0,236900,1645,144
"18031","54084","2021",22,22,0,131262.3,1261.227,108.4545
"18032","54085","2021",1,1,0,163000,1358,120
"18033","54086","2021",4,4,0,128956.2,1114.75,119.75
"18034","54087","2021",2,2,0,116500,1102.5,105
"18035","54088","2021",1,1,0,66000,1737,38
"18036","54089","2021",21,20,1,237483.3,2075.095,127.9048
"18037","54090","2021",57,51,6,209613.2,2176.07,96.54386
"18038","54091","2021",10,10,0,189030,1718.2,110.5
"18039","54092","2021",2,2,0,65240,1145.5,55.5
"18040","54094","2021",2,2,0,232000,1522.5,158.5
"18041","54096","2021",6,6,0,258183.3,2472.667,104.5
"18042","54097","2021",1,1,0,65000,650,100
"18043","54098","2021",2,2,0,169250,1316.5,97
"18044","54099","2021",178,114,64,146863.4,1574.871,90.95506
"18045","54100","2021",13,13,0,191358.5,1865.231,105.1538
"18046","54102","2021",10,9,1,168290,1422.5,127.1
"18047","54104","2021",3,3,0,90333.33,926.3333,96
"18048","54105","2021",10,10,0,119441.2,1128.9,106.1
"18049","54108","2021",1,1,0,161500,1700,95
"18050","54109","2021",15,15,0,195295.3,1698.6,120.1333
"18051","54110","2021",6,6,0,222483.3,2315.5,99.16667
"18052","54111","2021",43,37,6,146539.2,1732.93,86.67442
"18053","54112","2021",9,9,0,171178.9,1402.111,134.7778
"18054","54113","2021",18,18,0,221519.2,1929.5,122.7222
"18055","54114","2021",5,5,0,183200,1946,94
"18056","54115","2021",80,52,28,161010.4,1850.787,86.05
"18057","54116","2021",25,23,2,203173.8,1764.2,113.88
"18058","54118","2021",6,6,0,163566.7,2746.167,70.33333
"18059","54119","2021",3,3,0,99333.33,1089.333,90
"18060","54120","2021",3,3,0,113100,874.3333,128.3333
"18061","54121","2021",1,1,0,286238,2626,109
"18062","54122","2021",10,7,3,199055.5,1654,114.6
"18063","54123","2021",30,23,7,191406.3,1749.4,111.8333
"18064","54124","2021",1,1,0,40000,333,120
"18065","54125","2021",6,6,0,120166.7,1125.667,109.3333
"18066","54126","2021",1,1,0,130000,1215,107
"18067","54127","2021",5,5,0,274564,2392.6,119.6
"18068","54128","2021",9,9,0,145885.6,1354.333,110
"18069","54129","2021",21,21,0,73018.57,699.381,110.2381
"18070","54130","2021",2,2,0,219000,1362.5,149
"18071","54131","2021",1,1,0,65000,591,110
"18072","54133","2021",1,1,0,132400,946,140
"18073","54134","2021",5,5,0,106440,1085.8,113.4
"18074","54135","2021",22,19,3,151988,1423.682,107.0455
"18075","54136","2021",31,26,5,161435.5,1770.29,92.58065
"18076","54137","2021",9,8,1,126105.6,1532,95.55556
"18077","54138","2021",50,27,23,261667.6,2752.76,99.92
"18078","54140","2021",2,2,0,41000,423,97
"18079","54141","2021",5,5,0,192396,1572.2,128.4
"18080","54143","2021",4,4,0,114150,903.75,122.75
"18081","54144","2021",2,2,0,199600,2054.5,99
"18082","54145","2021",15,14,1,146332.8,1218.267,121.3333
"18083","54146","2021",8,8,0,129295,1199,104.875
"18084","54148","2021",10,9,1,111977,1186.2,98.1
"18085","54149","2021",30,28,2,214336.3,2420.9,88.9
"18086","54150","2021",36,32,4,158164,1707.944,97.41667
"18087","54151","2021",16,13,3,186622.3,2121.812,92
"18088","54152","2021",38,33,5,165429.9,1631.342,102.8947
"18089","54153","2021",2,2,0,58584,578,107
"18090","54154","2021",6,5,1,41833.33,551.1667,78.16667
"18091","54155","2021",3,3,0,182666.7,1117.667,152
"18092","54156","2021",6,6,0,150458.3,1153.333,128.5
"18093","54157","2021",91,74,17,162566,1617.648,102.0989
"18094","54158","2021",3,3,0,170166.7,1442.667,125
"18095","54159","2021",154,127,27,153917.6,1667.708,92.88312
"18096","54160","2021",1,1,0,167500,1081,155
"18097","54161","2021",4,4,0,92362.5,886.5,96.75
"18098","54162","2021",21,18,3,140246,1250.238,114
"18099","54163","2021",4,4,0,114112.5,903.75,132.5
"18100","54165","2021",7,6,1,524614.3,3025.571,165.4286
"18101","54167","2021",27,23,4,190485.9,1727.556,115.7037
"18102","54168","2021",3,3,0,430666.7,2666.333,162.3333
"18103","54171","2021",11,11,0,158068.2,1519.182,105.2727
"18104","54172","2021",2,2,0,125600,1422,84
"18105","54173","2021",3,3,0,148183.3,1401,118
"18106","54174","2021",65,34,31,135316.6,1572.785,83.47692
"18107","54175","2021",5,5,0,197930.4,1893.4,106.4
"18108","54176","2021",20,17,3,131680,1400.85,105
"18109","54177","2021",4,4,0,189110,1328.25,149.5
"18110","54178","2021",3,3,0,200333.3,1255.667,130.6667
"18111","54179","2021",1,1,0,210000,2059,102
"18112","54181","2021",12,11,1,213385,2309.5,89.25
"18113","54182","2021",8,8,0,130937.5,1176.5,121.25
"18114","54184","2021",147,51,96,159299.3,2019.231,78.22449
"18115","54186","2021",17,17,0,261135.6,2168.176,125.5882
"18116","54188","2021",17,15,2,169794.1,1500.235,116.4706
"18117","54189","2021",9,8,1,110166.7,854.3333,133.5556
"18118","54190","2021",1,1,0,135600,881,154
"18119","54191","2021",2,2,0,142500,1127.5,128.5
"18120","54192","2021",10,10,0,190966,1902.4,103.6
"18121","54194","2021",10,10,0,237855,1787.5,140.3
"18122","54196","2021",15,12,3,181906.7,2106.867,90
"18123","54197","2021",21,19,2,239785.8,1919.429,124.0476
"18124","54198","2021",4,4,0,128275,1325,99.75
"18125","54199","2021",6,6,0,89666.67,908,103.6667
"18126","54200","2021",2,2,0,170875,1107.5,156
"18127","54201","2021",3,3,0,98333.33,897.6667,100.3333
"18128","54202","2021",7,6,1,218107.1,1739.143,124.4286
"18129","54203","2021",1,1,0,92000,1278,72
"18130","54204","2021",3,3,0,86000,607.6667,126
"18131","54205","2021",31,29,2,124689.4,1390.581,89.64516
"18132","54206","2021",2,2,0,169275,1432.5,112
"18133","54207","2021",1,1,0,113410,995,114
"18134","54208","2021",1,0,1,78770,796,99
"18135","54211","2021",2,2,0,76750,726.5,117.5
"18136","54212","2021",5,5,0,174720,1906.2,97.8
"18137","54213","2021",4,4,0,204135,1557,129.5
"18138","54214","2021",7,6,1,183928.6,1493.286,117.2857
"18139","54215","2021",88,51,37,125857.1,1627.341,79.70455
"18140","54217","2021",3,3,0,117666.7,1139.333,109.6667
"18141","54218","2021",2,2,0,223350,1846,134.5
"18142","54220","2021",2,2,0,104000,704.5,150.5
"18143","54221","2021",2,2,0,96350,884,103.5
"18144","54222","2021",19,18,1,124860.5,1042.632,126.7368
"18145","54223","2021",2,2,0,42500,539.5,79
"18146","54225","2021",1,1,0,252000,1370,184
"18147","54227","2021",22,22,0,138267.1,1524.136,91.68182
"18148","54229","2021",1,1,0,45500,858,53
"18149","54231","2021",4,4,0,170937.5,1267.25,122.25
"18150","54232","2021",35,33,2,220412.1,1997.486,114.1714
"18151","54233","2021",1,1,0,110000,880,125
"18152","54234","2021",39,34,5,209796.5,2347.513,92.71795
"18153","54235","2021",2,2,0,101380,1030,97.5
"18154","54236","2021",4,4,0,126250,1111.25,124.5
"18155","54238","2021",3,3,0,87000,869,112.6667
"18156","54239","2021",2,2,0,248500,1742,147.5
"18157","54240","2021",1,1,0,203950,1632,125
"18158","54241","2021",1,1,0,156000,1191,131
"18159","54242","2021",2,2,0,175250,1636,109
"18160","54243","2021",4,4,0,104625,951,117.5
"18161","54244","2021",2,1,1,130250,922,143.5
"18162","54246","2021",1,1,0,87850,574,153
"18163","54247","2021",2,2,0,267500,1559.5,175
"18164","54248","2021",2,2,0,132909.5,1536,90.5
"18165","54249","2021",2,2,0,132200,1043,132.5
"18166","54250","2021",8,8,0,147618.8,1290,113.875
"18167","54251","2021",1,0,1,85000,850,100
"18168","54252","2021",8,7,1,196067.5,1600.375,125.75
"18169","54253","2021",9,6,3,126141.1,1393.222,84.66667
"18170","54254","2021",29,29,0,235519.1,2312,101.9655
"18171","54256","2021",1,1,0,212000,1828,116
"18172","54257","2021",62,54,8,272185.7,2604.726,104.4194
"18173","54258","2021",6,6,0,142135,1028.667,139.1667
"18174","54259","2021",4,4,0,144887.5,1003,135.5
"18175","54260","2021",12,12,0,180762.5,1568.667,117
"18176","54261","2021",86,57,29,128897.3,1616,79.2907
"18177","54262","2021",1,1,0,78000,1114,70
"18178","54263","2021",140,110,30,107906.8,1324.157,81.40714
"18179","54264","2021",3,3,0,239966.7,1950.333,122.6667
"18180","54265","2021",26,22,4,266140.4,2472.923,105.3077
"18181","54266","2021",5,5,0,133656,1291.4,105.8
"18182","54268","2021",3,3,0,85000,939.6667,85.66667
"18183","54269","2021",1,1,0,210000,1707,123
"18184","54270","2021",64,52,12,202677,2382.109,85.46875
"18185","54271","2021",2,2,0,116850,601.5,195
"18186","54272","2021",3,3,0,146523.3,1172,127.3333
"18187","54273","2021",154,113,41,134400.5,1426.903,94.31169
"18188","54274","2021",147,48,99,137763.7,1868.095,74.22449
"18189","54275","2021",4,4,0,72500,862.5,73.5
"18190","54276","2021",10,10,0,173649,1882.2,97.2
"18191","54277","2021",5,5,0,165263.2,1208.4,122.4
"18192","54278","2021",2,2,0,90500,769.5,131
"18193","54279","2021",16,13,3,142009.4,1505.125,106.625
"18194","54280","2021",138,83,55,92288.3,1099.594,83.94928
"18195","54281","2021",9,9,0,177555.6,1791.222,99.11111
"18196","54282","2021",2,2,0,203000,1438.5,146.5
"18197","54283","2021",4,4,0,102375,1471.25,74
"18198","54284","2021",26,26,0,120786.2,1240.346,92.30769
"18199","54285","2021",2,2,0,91800,716.5,125
"18200","54286","2021",24,22,2,151135.6,1520.625,101.5833
"18201","54287","2021",2,2,0,113000,956,121.5
"18202","54288","2021",6,6,0,127627,1113,115.5
"18203","54289","2021",2,2,0,173250,1749.5,98.5
"18204","54290","2021",2,2,0,142850,1330,113
"18205","54291","2021",3,3,0,165666.7,1590.333,100
"18206","54292","2021",3,3,0,98833.33,995.3333,119
"18207","54294","2021",3,3,0,96000,1316.667,71.33333
"18208","54295","2021",10,9,1,164521,1505.9,105.6
"18209","54296","2021",6,6,0,205512.5,1764.833,105.6667
"18210","54297","2021",5,5,0,134522,1188.4,111.4
"18211","54299","2021",1,1,0,114000,1357,84
"18212","54300","2021",93,59,34,183631.3,1989.602,92.02151
"18213","54301","2021",3,3,0,268021.7,1698.667,168
"18214","54302","2021",11,10,1,176713.6,1971.273,90.90909
"18215","54303","2021",4,4,0,142249.8,1364,109.75
"18216","54304","2021",244,72,172,178373,2129.627,82.53279
"18217","54305","2021",27,22,5,270403.5,2518.37,107.6667
"18218","54306","2021",6,5,1,113066.7,1012.667,122.1667
"18219","54307","2021",2,2,0,132350,1218,113
"18220","54308","2021",2,2,0,122500,1046.5,128
"18221","54309","2021",6,6,0,168104.7,1767.5,109.1667
"18222","54311","2021",2,2,0,118875,774,155
"18223","54312","2021",7,7,0,220417.9,1596.143,151
"18224","54313","2021",3,2,1,145300,1200,124.6667
"18225","54314","2021",34,27,7,227410.3,2373.294,96.61765
"18226","54315","2021",14,11,3,167967.9,1499.5,118.8571
"18227","54316","2021",5,5,0,209730,1513.2,136
"18228","54318","2021",77,67,10,171990.6,1826.117,95.68831
"18229","54320","2021",1,1,0,125000,1276,98
"18230","54321","2021",28,18,10,162027.5,2022.214,83.25
"18231","54322","2021",107,74,33,127293.9,1346.692,93.3271
"18232","54323","2021",218,131,87,152582.4,1805.335,88.42202
"18233","54324","2021",2,2,0,321395,1827.5,173
"18234","54325","2021",2,2,0,68500,794.5,94.5
"18235","54326","2021",2,2,0,69000,803.5,92.5
"18236","54327","2021",4,4,0,151250,1097.25,139.25
"18237","54328","2021",77,52,25,222464.4,2332.545,94.76623
"18238","54329","2021",254,122,132,109683.2,1245.417,89.00787
"18239","54330","2021",10,10,0,256150,1739.3,158.7
"18240","54331","2021",9,9,0,115983.3,1213.889,105.5556
"18241","54332","2021",25,15,10,139011,1643.64,86.88
"18242","54333","2021",4,4,0,107547.5,1234.25,81.75
"18243","54334","2021",6,6,0,213141.7,1681.5,135
"18244","54335","2021",8,8,0,183633.9,1809.375,101.875
"18245","54336","2021",10,10,0,211395,2390,99.6
"18246","54337","2021",3,3,0,365906.7,2956.667,127.6667
"18247","54338","2021",14,13,1,198907.1,2106.857,96.21429
"18248","54339","2021",126,55,71,175108.7,1945.508,85.15873
"18249","54340","2021",2,2,0,154000,1065.5,136.5
"18250","54343","2021",3,3,0,208721.3,1528.667,141.3333
"18251","54344","2021",2,2,0,131200,1524,91.5
"18252","54345","2021",1,1,0,54000,635,85
"18253","54348","2021",4,4,0,105350,1305,72.25
"18254","54349","2021",2,2,0,190800,1742,109
"18255","54350","2021",13,13,0,147742.3,1261.077,116.3077
"18256","54351","2021",24,23,1,164837.5,1712.875,97.25
"18257","54352","2021",15,15,0,156398.7,1627.533,99.66667
"18258","54353","2021",13,12,1,157000.4,1331.385,119.2308
"18259","54355","2021",2,2,0,146750,1564.5,104.5
"18260","54356","2021",1,1,0,142000,966,147
"18261","54357","2021",119,45,74,141301.1,1895.328,75
"18262","54358","2021",3,3,0,215916.7,1440.333,158
"18263","54359","2021",3,3,0,137933.3,1123.333,121.6667
"18264","54360","2021",5,5,0,188920,1519.2,127.6
"18265","54362","2021",29,28,1,128151.7,1468.172,90.03448
"18266","54363","2021",2,2,0,250550,1156,221
"18267","54364","2021",13,13,0,245956.3,2257.923,117.9231
"18268","54365","2021",4,4,0,90900,842.25,115.5
"18269","54366","2021",15,14,1,218330,2075.4,106.9333
"18270","54367","2021",39,34,5,222730.4,2317.923,96.17949
"18271","54368","2021",3,3,0,104033.3,1089,117
"18272","54369","2021",10,10,0,167250,1519.2,107.3
"18273","54370","2021",1,1,0,215000,1870,115
"18274","54371","2021",13,12,1,188080.8,1925,103.1538
"18275","54372","2021",5,5,0,168726,1357.8,120.4
"18276","54373","2021",5,5,0,183600,1568.4,152.2
"18277","54374","2021",3,3,0,148450,1740,85.66667
"18278","54375","2021",14,14,0,158496.4,1527.357,111.4286
"18279","54376","2021",6,6,0,190448.3,1781.833,110.1667
"18280","54377","2021",1,1,0,142500,620,230
"18281","54378","2021",9,9,0,112089.9,1091.556,103.8889
"18282","54379","2021",3,3,0,99333.33,674.3333,142.3333
"18283","54380","2021",2,2,0,131500,1779.5,72
"18284","54382","2021",81,57,24,177707.1,2033.21,88.51852
"18285","54383","2021",10,9,1,208652.5,1778.1,117.6
"18286","54385","2021",15,15,0,222091.4,2428.867,90.73333
"18287","54386","2021",2,2,0,85804.5,529,152.5
"18288","54388","2021",2,2,0,103000,863.5,119.5
"18289","54390","2021",1,1,0,130000,1226,106
"18290","54391","2021",38,35,3,113798.7,1286.632,89.78947
"18291","54392","2021",4,4,0,188932.5,1245.5,146.25
"18292","54393","2021",6,6,0,111583.3,829,126.8333
"18293","54394","2021",2,2,0,284825,1873.5,148.5
"18294","54395","2021",2318,228,2090,159019.9,2363.124,68.68378
"18295","54396","2021",7,7,0,79000,693.7143,120.4286
"18296","54397","2021",128,98,30,164336.7,1775.031,93.65625
"18297","54399","2021",3,3,0,122900,1042.667,110
"18298","54400","2021",17,16,1,181341.1,1636.765,110.8824
"18299","54401","2021",2,2,0,91500,870.5,116
"18300","54402","2021",7,7,0,144938.7,1498.286,97.28571
"18301","54403","2021",14,14,0,230921.4,1950.571,121.5
"18302","54404","2021",5,5,0,127140,1003.4,141
"18303","54405","2021",6,6,0,196826.7,1312.333,172.5
"18304","54406","2021",5,4,1,110700,932.6,125
"18305","54408","2021",3,3,0,146100,1345.667,108.6667
"18306","54409","2021",1,1,0,150000,1974,76
"18307","54410","2021",5,5,0,92620,1097.6,88.6
"18308","54411","2021",4,4,0,187500,2046.75,100.25
"18309","54412","2021",2,2,0,88750,830,111
"18310","54413","2021",1,1,0,89500,1078,83
"18311","54414","2021",9,9,0,166536.7,1616.333,94.77778
"18312","54415","2021",43,34,9,175954.1,1806.744,99.69767
"18313","54416","2021",4,4,0,125850,968,136.75
"18314","54417","2021",1,1,0,50000,1250,40
"18315","54418","2021",1,1,0,150000,1415,106
"18316","54419","2021",1,1,0,135000,1205,112
"18317","54420","2021",1,1,0,91000,740,123
"18318","54421","2021",8,8,0,76850,741.375,106.75
"18319","54423","2021",6,6,0,87516.67,1084,93.16667
"18320","54424","2021",1,1,0,110000,797,138
"18321","54425","2021",43,36,7,103337.4,1184.628,91.37209
"18322","54426","2021",5,4,1,134730,1427.4,90.6
"18323","54427","2021",4,4,0,191720.2,1469.5,119.75
"18324","54428","2021",16,9,7,84006.25,1084,71.5
"18325","54429","2021",5,5,0,194004,1591.8,131.4
"18326","54430","2021",77,57,20,132606.5,1562.753,86.68831
"18327","54431","2021",205,112,93,142693.4,1656.502,89.32195
"18328","54432","2021",34,30,4,122773.8,1494.147,86.67647
"18329","54433","2021",6,6,0,229155,2047.5,111.1667
"18330","54434","2021",4,4,0,132260,1308.25,133
"18331","54435","2021",6,6,0,122723.3,1449.167,98.16667
"18332","54436","2021",2,2,0,216650,2006.5,108.5
"18333","54437","2021",9,9,0,159166.7,1417.556,111.8889
"18334","54439","2021",70,53,17,236592.4,2262.043,102.5
"18335","54441","2021",1,1,0,287000,2050,140
"18336","54442","2021",2,2,0,228350,1537.5,150.5
"18337","54443","2021",2,2,0,79450,791.5,102
"18338","54444","2021",3,3,0,197496.7,1766.333,111
"18339","54445","2021",3,3,0,127600,979.3333,139.3333
"18340","54449","2021",9,9,0,220418.9,1744.556,123.3333
"18341","54450","2021",4,4,0,119500,909.5,132.5
"18342","54451","2021",68,44,24,154485.8,1745.544,87.95588
"18343","54452","2021",2,2,0,190000,1330.5,145.5
"18344","54453","2021",3,3,0,173000,1003,174.3333
"18345","54455","2021",1,1,0,55000,724,76
"18346","54456","2021",7,7,0,202057.1,1700.857,121.1429
"18347","54457","2021",2,2,0,179590,1805.5,112.5
"18348","54458","2021",1,1,0,114000,1056,108
"18349","54459","2021",34,33,1,245529.3,2247.265,113.6176
"18350","54460","2021",2,2,0,126200,992,125
"18351","54461","2021",1,1,0,155000,1667,93
"18352","54462","2021",41,33,8,149449.9,1552.293,95.04878
"18353","54463","2021",1,1,0,154200,1928,80
"18354","54464","2021",2,2,0,133750,1011,124
"18355","54465","2021",7,6,1,196164.3,1731,115.1429
"18356","54466","2021",4,4,0,111750,952.5,115.75
"18357","54467","2021",1,1,0,189525,1115,170
"18358","54468","2021",1,1,0,251000,2561,98
"18359","54469","2021",4,4,0,189081.2,1816.25,121.75
"18360","54470","2021",1,1,0,77000,1069,72
"18361","54471","2021",1,1,0,150000,1210,124
"18362","54472","2021",11,9,2,103090.9,1050.455,101.3636
"18363","54473","2021",1,1,0,105000,1167,90
"18364","54474","2021",4,4,0,186000,1038.75,182
"18365","54475","2021",2,2,0,123250,1286.5,110
"18366","54476","2021",7,7,0,138454.3,1356.857,103.2857
"18367","54478","2021",1,1,0,187200,2880,65
"18368","54479","2021",2,2,0,184000,1461,140
"18369","54481","2021",1,1,0,95000,805,118
"18370","54482","2021",204,57,147,160395.6,1920.926,80.67647
"18371","54483","2021",127,83,44,144519,1665.378,90.6378
"18372","54484","2021",3,3,0,124075,801.3333,152.3333
"18373","54485","2021",4,4,0,202225,1639.5,132.25
"18374","54486","2021",3,3,0,113333.3,1264.333,92.66667
"18375","54488","2021",2,2,0,25000,666.5,38
"18376","54489","2021",2,2,0,169580,1592,103
"18377","54490","2021",24,23,1,169145.8,1618.542,107.7083
"18378","54491","2021",5,5,0,239057,1761.2,136.6
"18379","54492","2021",1,1,0,176000,2708,65
"18380","54493","2021",55,42,13,149694.8,2022.782,76
"18381","54494","2021",1,1,0,1e+05,645,155
"18382","54495","2021",40,35,5,243158.9,2371.4,105.55
"18383","54496","2021",5,5,0,76000,747.2,101.8
"18384","54498","2021",66,60,6,230269.3,2313.576,102.9394
"18385","54499","2021",1,1,0,175000,1296,135
"18386","54500","2021",2,2,0,89500,1028.5,87
"18387","54502","2021",6,6,0,101858.5,723.1667,141
"18388","54504","2021",8,6,2,241932.5,1884.75,118.625
"18389","54505","2021",7,7,0,174542,1859.429,97
"18390","54508","2021",1,1,0,129000,2580,50
"18391","54509","2021",9,8,1,151887,1438,111.7778
"18392","54510","2021",3,3,0,190935.3,1241,141.3333
"18393","54513","2021",11,11,0,145545.5,1257.182,124
"18394","54514","2021",10,9,1,220711.5,1922.6,119.4
"18395","54515","2021",2,2,0,157800,1186,132
"18396","54517","2021",3,3,0,176600,1278.333,146
"18397","54518","2021",16,14,2,116478.9,1154.75,108.25
"18398","54519","2021",10,10,0,118105,1322.6,92.7
"18399","54520","2021",2,2,0,78750,625,135
"18400","54521","2021",44,33,11,197802.5,2264.705,82.61364
"18401","54522","2021",4,4,0,132450,993.75,144.75
"18402","54523","2021",1,1,0,147000,2100,70
"18403","54524","2021",1,1,0,30000,545,55
"18404","54525","2021",14,8,6,323606.2,2699.929,112.5714
"18405","54526","2021",160,93,67,168408.8,2095.581,80.20625
"18406","54527","2021",4,4,0,138125,1530.75,92
"18407","54528","2021",210,108,102,137283.1,1505.133,92.59048
"18408","54532","2021",3,3,0,120500,1009.667,108.6667
"18409","54533","2021",34,33,1,204192.7,1933.765,102.7647
"18410","54534","2021",5,5,0,165760,1335.4,127.4
"18411","54535","2021",4,4,0,172947.5,1956.5,92.5
"18412","54536","2021",42,40,2,149961.5,1583.357,90.90476
"18413","54537","2021",7,7,0,311320,2216.714,139.1429
"18414","54538","2021",6,6,0,139791.7,924.6667,143.6667
"18415","54539","2021",2,2,0,85000,887.5,103
"18416","54540","2021",16,15,1,77790.62,884.9375,95.25
"18417","54541","2021",1,1,0,113050,1108,102
"18418","54542","2021",38,36,2,189789.1,1819.368,103.1579
"18419","54543","2021",2,2,0,65250,720.5,92.5
"18420","54544","2021",1,1,0,152000,950,160
"18421","54545","2021",7,7,0,93464.29,716.5714,122
"18422","54546","2021",14,14,0,151952.9,1792.286,95.64286
"18423","54547","2021",390,89,301,136050.6,1978.379,68.99231
"18424","54548","2021",8,7,1,81982.5,851.125,93.375
"18425","54549","2021",56,42,14,140426,1588.625,90.83929
"18426","54550","2021",7,5,2,86528.57,1186,84.57143
"18427","54552","2021",4,3,1,95000,1267.25,86.25
"18428","54553","2021",5,5,0,124274,1300,96.6
"18429","54554","2021",2,2,0,232275,2181.5,106.5
"18430","54556","2021",3,3,0,106833.3,767,138
"18431","54557","2021",24,21,3,275101.7,2233.083,125.75
"18432","54558","2021",5,5,0,204207,2057.2,101
"18433","54559","2021",5,5,0,129900,1467.6,81
"18434","54561","2021",1,1,0,88000,880,100
"18435","54562","2021",2,2,0,119250,913,130
"18436","54563","2021",21,20,1,144123.6,1370.143,103.9524
"18437","54565","2021",3,3,0,152343.3,1170,131.3333
"18438","54566","2021",2,2,0,285000,1997.5,142.5
"18439","54567","2021",2,2,0,62125,627,99
"18440","54568","2021",5,5,0,106460,1190.6,92
"18441","54569","2021",1,1,0,38000,559,68
"18442","54570","2021",6,6,0,152316.7,1486.667,112.6667
"18443","54571","2021",8,8,0,193756.4,1784.125,117.875
"18444","54572","2021",7,7,0,279342.9,2568.143,113.8571
"18445","54573","2021",4,4,0,70568.5,930.5,71.75
"18446","54574","2021",3,3,0,202833.3,1998,106.6667
"18447","54575","2021",15,12,3,248512.7,2350.533,108.0667
"18448","54578","2021",197,100,97,188782.2,2239.02,85.18782
"18449","54579","2021",4,3,1,133000,1452.75,85.25
"18450","54580","2021",213,149,64,175055.1,2221.563,78.723
"18451","54581","2021",7,7,0,158057.1,1469.429,113.4286
"18452","54583","2021",7,7,0,180334.3,1490.429,115.4286
"18453","54584","2021",15,14,1,202685,1815.867,111.8
"18454","54585","2021",10,10,0,189640,1556.9,132.1
"18455","54586","2021",9,9,0,160301.1,1460,110
"18456","54587","2021",2,2,0,191665,1676,120
"18457","54588","2021",4,4,0,173187.5,1705,99
"18458","54589","2021",1,1,0,179850,1781,101
"18459","54590","2021",9,9,0,154094.4,1544.111,100
"18460","54591","2021",2,2,0,156750,1332.5,96
"18461","54592","2021",7,7,0,198128.6,1717.429,114.2857
"18462","54593","2021",8,8,0,173882.4,1506.25,117.25
"18463","54594","2021",1,1,0,186000,1069,174
"18464","54595","2021",4,4,0,184542.5,1396.25,130.75
"18465","54596","2021",20,20,0,169629.8,1888.6,93.4
"18466","54597","2021",5,5,0,176550,1252.2,142.6
"18467","54598","2021",10,10,0,152480.8,1141.3,145.6
"18468","54599","2021",3,3,0,210000,1368.667,172.6667
"18469","54600","2021",3,3,0,213266.7,1398.333,142.6667
"18470","54601","2021",2,2,0,97500,702.5,145
"18471","54602","2021",1,1,0,79500,1590,50
"18472","55001","2021",2,2,0,60902.5,850.5,62
"18473","55002","2021",1,1,0,55100,557,99
"18474","55004","2021",1,1,0,60000,1091,55
"18475","55007","2021",1,1,0,120000,1519,79
"18476","55008","2021",2,2,0,299250,1908,137
"18477","55009","2021",7,7,0,112171.4,1106,99.28571
"18478","55010","2021",31,29,2,117749.4,1266.71,96.06452
"18479","55011","2021",1,0,1,41000,366,112
"18480","55012","2021",9,9,0,89498.89,1032.778,116.4444
"18481","55013","2021",3,3,0,150658.3,1020.667,151.6667
"18482","55014","2021",8,8,0,93303.88,865.125,115
"18483","55015","2021",7,7,0,138785.7,1204,117.1429
"18484","55017","2021",2,2,0,55000,493.5,113.5
"18485","55018","2021",1,1,0,85000,1062,80
"18486","55021","2021",2,2,0,86215,980.5,90.5
"18487","55023","2021",1,1,0,85000,518,164
"18488","55024","2021",1,1,0,119000,1082,110
"18489","55025","2021",3,3,0,58333.33,672.6667,87.33333
"18490","55026","2021",2,2,0,80000,1191,65.5
"18491","55027","2021",2,2,0,95300,1009,99
"18492","55028","2021",1,1,0,125000,893,140
"18493","55029","2021",155,77,78,111299.3,1240.619,91.08387
"18494","55031","2021",5,5,0,165810,1463.8,116.2
"18495","55034","2021",4,4,0,203650,1041.5,137.5
"18496","55035","2021",5,5,0,171005,1450.8,125.2
"18497","55036","2021",1,1,0,69500,615,113
"18498","55037","2021",2,2,0,80000,914,86.5
"18499","55038","2021",1,1,0,80000,721,111
"18500","55040","2021",8,8,0,80743.75,760.75,107.375
"18501","55041","2021",7,7,0,170585.7,1437.286,122.8571
"18502","55042","2021",8,8,0,197150,1612.75,122.625
"18503","55043","2021",50,29,21,111730.9,1296.02,86.56
"18504","55045","2021",3,3,0,222191.7,1698.333,133
"18505","55047","2021",3,3,0,89000,718.6667,132.6667
"18506","55048","2021",5,5,0,100120,1273.8,83.8
"18507","55049","2021",7,7,0,116738.6,1369,89.85714
"18508","55051","2021",1,1,0,102000,638,160
"18509","55053","2021",8,8,0,104250,826.625,120.125
"18510","55054","2021",3,3,0,98500,931.3333,98.33333
"18511","55058","2021",5,5,0,133400,1279.6,100.6
"18512","55059","2021",2,2,0,115500,1106.5,104
"18513","55060","2021",6,6,0,140483.3,1175.667,126.5
"18514","55061","2021",3,3,0,117000,1120.667,105.3333
"18515","55063","2021",61,60,1,91209.26,1089.639,83.59016
"18516","55064","2021",1,1,0,25000,463,54
"18517","55065","2021",2,2,0,138250,1834,77
"18518","55066","2021",3,3,0,103000,658.3333,174.6667
"18519","55067","2021",1,1,0,135000,1015,133
"18520","55068","2021",4,4,0,102725,1257.25,90
"18521","55069","2021",1,1,0,193000,1142,169
"18522","55070","2021",2,2,0,217500,1778,131
"18523","55071","2021",2,2,0,45000,449,98.5
"18524","55073","2021",2,2,0,186750,1922.5,97
"18525","55075","2021",5,4,1,106000,1038.6,98
"18526","55076","2021",2,2,0,94750,624,155.5
"18527","55077","2021",4,4,0,203835,1901.25,103.5
"18528","55078","2021",2,2,0,60500,633,96.5
"18529","55079","2021",6,6,0,185180,1753,112.6667
"18530","55081","2021",1,1,0,113860,1074,106
"18531","55082","2021",1,1,0,108000,1662,65
"18532","55083","2021",1,1,0,1e+05,769,130
"18533","55084","2021",2,2,0,127315,780.5,165
"18534","55085","2021",2,2,0,92500,1276.5,80
"18535","55087","2021",1,1,0,160000,1509,106
"18536","55088","2021",6,6,0,70946.67,790.8333,89.5
"18537","55089","2021",2,2,0,53775,590.5,92.5
"18538","55093","2021",4,4,0,62615,603,106.25
"18539","55094","2021",7,7,0,119357.1,1277.571,96.28571
"18540","55097","2021",3,2,1,333833.3,2940,96.66667
"18541","55100","2021",4,4,0,75291,644.25,115
"18542","55101","2021",1,1,0,150000,1596,94
"18543","55102","2021",14,14,0,160450,1646.429,102.0714
"18544","55104","2021",2,2,0,43250,495,90
"18545","55105","2021",1,1,0,61000,466,131
"18546","55106","2021",3,3,0,111333.3,1043.333,108.6667
"18547","55109","2021",2,2,0,115500,576,214.5
"18548","55110","2021",4,4,0,77627.5,790.75,102.25
"18549","55111","2021",3,3,0,140133.3,1723.667,81.66667
"18550","55113","2021",1,1,0,70000,1167,60
"18551","55114","2021",2,2,0,84500,741.5,110
"18552","55115","2021",2,2,0,47000,634,73
"18553","55116","2021",2,2,0,109750,943.5,113.5
"18554","55117","2021",13,13,0,104386.5,1164.308,90.15385
"18555","55119","2021",3,3,0,51666.67,583.6667,92
"18556","55120","2021",3,3,0,117166.7,1130.333,99
"18557","55121","2021",3,3,0,89500,822,98.66667
"18558","55122","2021",73,57,16,119189.7,1299.863,97.06849
"18559","55123","2021",6,6,0,107245.8,811,135
"18560","55124","2021",6,6,0,133246.7,1227,109.1667
"18561","55125","2021",5,5,0,122220,1212.4,101.6
"18562","55127","2021",1,1,0,236000,3688,64
"18563","55132","2021",16,14,2,140859.4,1183.375,125.6875
"18564","55133","2021",1,1,0,163500,1635,100
"18565","55134","2021",2,2,0,108355,1577,64.5
"18566","55138","2021",3,3,0,145533.3,1228,122
"18567","55141","2021",1,1,0,45000,479,94
"18568","55142","2021",2,2,0,41450,462,91
"18569","55143","2021",2,2,0,157000,1288.5,121.5
"18570","55144","2021",2,2,0,68160,833,77
"18571","55145","2021",7,7,0,108006.1,1115.714,99.85714
"18572","55146","2021",5,5,0,100600,999.6,90.4
"18573","55148","2021",1,1,0,103300,743,139
"18574","55149","2021",3,3,0,125800,1041,121.6667
"18575","55150","2021",11,10,1,58868.18,647,92.36364
"18576","55153","2021",1,1,0,162166,1184,137
"18577","55154","2021",12,12,0,149144.2,1496.25,103.75
"18578","55155","2021",5,5,0,93100,1101.8,82.4
"18579","55156","2021",2,2,0,133000,1272,106
"18580","55157","2021",1,1,0,129750,1458,89
"18581","55158","2021",14,14,0,108867.9,1082.071,101.7143
"18582","55159","2021",9,9,0,80692.78,885.8889,95.11111
"18583","55163","2021",1,1,0,166000,2075,80
"18584","55165","2021",9,9,0,90022.22,914.8889,97.66667
"18585","55166","2021",8,8,0,127156.2,1570.125,83.75
"18586","55167","2021",11,10,1,75181.82,770.9091,92.36364
"18587","55168","2021",1,1,0,131350,966,136
"18588","55169","2021",7,5,2,137300,1438.429,94.85714
"18589","55170","2021",6,6,0,71591.67,723.6667,96.66667
"18590","55171","2021",3,3,0,151500,1057.333,147.3333
"18591","55172","2021",1,1,0,74138,618,120
"18592","55173","2021",1,1,0,70000,875,80
"18593","55174","2021",1,1,0,99200,1153,86
"18594","55177","2021",1,1,0,74350,432,172
"18595","55178","2021",4,4,0,123687.5,1177.5,113.75
"18596","55180","2021",1,1,0,36000,600,60
"18597","55181","2021",45,44,1,106100.8,1152.133,95.22222
"18598","55182","2021",5,5,0,172240,1300,134.8
"18599","55184","2021",29,29,0,102301.7,1019.586,104.9655
"18600","55185","2021",2,2,0,106500,1036,107
"18601","55186","2021",22,22,0,144766.4,1386.818,107.7273
"18602","55191","2021",2,2,0,205000,1934,106.5
"18603","55192","2021",3,3,0,129433.3,1226.667,105.3333
"18604","55193","2021",2,2,0,99600,1208,81.5
"18605","55195","2021",3,3,0,124833.3,814,140
"18606","55198","2021",8,7,1,124312.5,1171.75,103.375
"18607","55199","2021",2,2,0,54500,767.5,69.5
"18608","55200","2021",2,2,0,139800,1220.5,117.5
"18609","55201","2021",1,1,0,245495,1818,135
"18610","55202","2021",4,4,0,100500,1279.25,81.75
"18611","55204","2021",1,1,0,92000,730,126
"18612","55206","2021",1,1,0,105000,673,156
"18613","55208","2021",4,4,0,61700,779.25,81.5
"18614","55211","2021",1,1,0,1e+05,735,136
"18615","55212","2021",1,1,0,112500,1308,86
"18616","55214","2021",2,2,0,134500,806,166
"18617","55215","2021",12,12,0,83833.33,776.5833,112.5
"18618","55217","2021",5,5,0,122290,1287.6,90.8
"18619","55218","2021",1,1,0,85000,1000,85
"18620","55219","2021",2,2,0,113000,1006,108.5
"18621","55221","2021",4,4,0,134625,1162,125
"18622","55224","2021",2,2,0,111940,734.5,159.5
"18623","55226","2021",2,2,0,41000,530,89.5
"18624","55228","2021",6,6,0,90375,1030.667,88.83333
"18625","55229","2021",4,4,0,165875,1021.75,165.25
"18626","55232","2021",2,2,0,68325,566,123
"18627","55236","2021",10,10,0,137510.7,1235.8,114.3
"18628","55237","2021",2,2,0,91600,964.5,84.5
"18629","55242","2021",1,1,0,66000,574,115
"18630","55243","2021",1,1,0,131500,1801,73
"18631","55244","2021",6,6,0,88166.67,855,100.8333
"18632","55245","2021",2,2,0,106500,785,135.5
"18633","55246","2021",1,1,0,94200,725,130
"18634","55247","2021",1,1,0,66000,653,101
"18635","55248","2021",6,6,0,87291.67,872.1667,93
"18636","55250","2021",4,4,0,91875,997.25,115.75
"18637","55251","2021",1,1,0,61000,871,70
"18638","55253","2021",6,6,0,115233.3,1092.333,110.8333
"18639","55254","2021",3,3,0,123833.3,758.3333,160.3333
"18640","55255","2021",7,7,0,79142.86,794.8571,96.57143
"18641","55256","2021",1,1,0,70450,640,110
"18642","55257","2021",2,2,0,117500,1008.5,111.5
"18643","55258","2021",7,7,0,85050,836,104.8571
"18644","55264","2021",3,3,0,112866.7,954,118
"18645","55265","2021",4,4,0,198612.5,1078,184.75
"18646","55266","2021",2,2,0,58500,457,127
"18647","55267","2021",5,5,0,91300,750.2,119.8
"18648","55268","2021",6,6,0,130058.3,983.3333,137.3333
"18649","55269","2021",2,2,0,63000,1019,61.5
"18650","55271","2021",4,4,0,132137.5,862,162.5
"18651","55272","2021",4,4,0,175625,1388.5,141
"18652","55274","2021",4,4,0,113875,1109.5,97.25
"18653","55276","2021",1,1,0,72000,1309,55
"18654","55278","2021",4,4,0,128562.5,1275.5,97.25
"18655","55279","2021",8,8,0,90275,808.75,113.25
"18656","55281","2021",1,1,0,156500,894,175
"18657","55284","2021",2,2,0,72350,839,89.5
"18658","55285","2021",2,2,0,55375,563,93
"18659","55286","2021",2,2,0,176100,1632,108.5
"18660","55288","2021",15,15,0,113728,1203.8,95
"18661","55290","2021",2,2,0,100650,678,138
"18662","55291","2021",48,39,9,86633.65,971.9167,89.91667
"18663","55292","2021",1,1,0,107000,823,130
"18664","55293","2021",2,2,0,106500,943.5,102.5
"18665","55296","2021",11,11,0,126827.3,1062,105.2727
"18666","55297","2021",3,3,0,39333.33,575.3333,69.66667
"18667","55298","2021",5,5,0,107990,895.6,128
"18668","55299","2021",1,1,0,70000,700,100
"18669","55300","2021",2,2,0,87000,835.5,125
"18670","55301","2021",2,2,0,69500,698.5,99.5
"18671","55302","2021",20,20,0,105315,1095.1,91.9
"18672","55303","2021",2,2,0,103200,1011,100.5
"18673","55304","2021",3,3,0,76600,959.6667,81.33333
"18674","55306","2021",3,3,0,108836.7,1106,96.33333
"18675","55312","2021",1,1,0,168000,1333,126
"18676","55316","2021",4,4,0,115493.8,764,151.25
"18677","55317","2021",1,1,0,154000,1467,105
"18678","55320","2021",2,2,0,110100,1058.5,104
"18679","55321","2021",2,2,0,113443,1200,96.5
"18680","55323","2021",1,1,0,85000,810,105
"18681","55324","2021",11,11,0,122827.3,1189.455,103.7273
"18682","55325","2021",2,2,0,124116.5,1378,92
"18683","55326","2021",1,1,0,52275,653,80
"18684","55327","2021",2,2,0,121600,864.5,137
"18685","55328","2021",3,3,0,58733.33,667.6667,84.33333
"18686","55332","2021",1,1,0,148000,1574,94
"18687","55333","2021",1,1,0,130000,743,175
"18688","55334","2021",2,2,0,51500,512.5,100
"18689","55335","2021",4,3,1,63375,758,90.25
"18690","55336","2021",3,3,0,136333.3,1840,92
"18691","55338","2021",1,1,0,51218,657,78
"18692","55339","2021",1,1,0,90000,703,128
"18693","55340","2021",6,6,0,121288.3,990.5,119.6667
"18694","55343","2021",4,4,0,149250,846.75,158.25
"18695","55345","2021",2,2,0,166400,2297,73.5
"18696","55346","2021",6,6,0,103983.3,1450.333,80.5
"18697","55347","2021",9,9,0,120433.3,922.1111,135
"18698","55348","2021",10,10,0,81276,680.1,126.8
"18699","55349","2021",6,6,0,85833.33,834.3333,108.6667
"18700","55350","2021",1,1,0,50000,485,103
"18701","55351","2021",32,29,3,124896.9,1113.312,117.6875
"18702","55355","2021",4,4,0,86916.75,861.5,101.5
"18703","55357","2021",4,4,0,149180,1412.75,100.25
"18704","55358","2021",1,1,0,31100,518,60
"18705","55359","2021",2,2,0,97750,720.5,132
"18706","55360","2021",2,2,0,67237.5,613,113
"18707","55361","2021",1,1,0,1e+05,1235,81
"18708","55362","2021",2,2,0,37500,480.5,79
"18709","55364","2021",9,9,0,95866.67,897.6667,109.7778
"18710","55365","2021",3,3,0,146333.3,1193,119
"18711","55366","2021",20,20,0,139945,1222.9,122.35
"18712","55367","2021",2,2,0,92395,896.5,102.5
"18713","55368","2021",3,3,0,145166.7,873.6667,157
"18714","55369","2021",11,11,0,117528.2,1039.818,115
"18715","55371","2021",1,1,0,46000,505,91
"18716","55372","2021",7,7,0,111714.3,1009.429,112.7143
"18717","55374","2021",1,1,0,180000,1593,113
"18718","55375","2021",1,1,0,80000,1081,74
"18719","55376","2021",3,3,0,69750,687,103.6667
"18720","55377","2021",3,3,0,99666.67,921.3333,105
"18721","55378","2021",4,4,0,123700,1118.5,114.25
"18722","55379","2021",2,2,0,104000,1386.5,81
"18723","55380","2021",2,2,0,112500,1011,111.5
"18724","55381","2021",2,2,0,54975,735,75
"18725","55382","2021",4,4,0,154125,1496,102.5
"18726","55384","2021",4,4,0,68500,846.75,90.75
"18727","55385","2021",2,2,0,187275,1422,132
"18728","55386","2021",1,1,0,158000,590,268
"18729","55387","2021",2,2,0,123500,1052.5,115
"18730","55388","2021",2,2,0,87700,725.5,112
"18731","55389","2021",5,5,0,83820,716.4,118.6
"18732","55391","2021",4,4,0,117487.5,1147.5,101.25
"18733","55396","2021",4,4,0,123787.5,1012,129.5
"18734","55397","2021",1,1,0,20000,800,25
"18735","55398","2021",11,10,1,152268.2,1617,98.09091
"18736","55399","2021",2,2,0,103915,845.5,134
"18737","55400","2021",1,1,0,70000,579,121
"18738","55401","2021",6,6,0,128700,947.8333,130
"18739","55403","2021",2,2,0,112500,797,130
"18740","55404","2021",2,2,0,169450,1367.5,127
"18741","55405","2021",5,5,0,192820,1675.2,148.6
"18742","55406","2021",1,1,0,139500,649,215
"18743","55407","2021",4,4,0,85500,922.75,94.75
"18744","55408","2021",4,4,0,64000,795.75,81.75
"18745","55409","2021",2,2,0,82500,610.5,137.5
"18746","55410","2021",5,5,0,159875,1264.8,116.2
"18747","55411","2021",1,1,0,36000,720,50
"18748","55412","2021",2,2,0,102000,937.5,134
"18749","55414","2021",1,1,0,90000,1125,80
"18750","55416","2021",1,1,0,69000,862,80
"18751","55419","2021",2,2,0,126500,1073.5,125
"18752","55420","2021",2,2,0,99050,1008,99.5
"18753","55421","2021",1,1,0,229900,1437,160
"18754","55423","2021",6,6,0,78833.33,866.6667,106.6667
"18755","55424","2021",1,1,0,112030,958,117
"18756","55425","2021",1,1,0,59000,766,77
"18757","55426","2021",4,4,0,147225,1049.75,139.75
"18758","55427","2021",28,25,3,133679.6,1282.036,101.4643
"18759","55428","2021",1,1,0,52500,438,120
"18760","55430","2021",3,3,0,83166.67,929.6667,93.66667
"18761","55433","2021",5,5,0,100620,955.2,100.4
"18762","55434","2021",1,1,0,245000,1633,150
"18763","55435","2021",9,9,0,124048.9,1203.333,106.2222
"18764","55437","2021",1,1,0,97000,1054,92
"18765","55438","2021",3,3,0,129950,788.3333,160.3333
"18766","55439","2021",2,2,0,104000,829,129.5
"18767","55442","2021",1,1,0,95000,475,200
"18768","55443","2021",4,4,0,99887.5,1000.5,102
"18769","55444","2021",3,3,0,126259.7,1206.667,110
"18770","55446","2021",3,3,0,131000,968.6667,135.3333
"18771","55447","2021",6,6,0,113395.8,696.1667,150
"18772","55448","2021",2,2,0,69750,631.5,119
"18773","55449","2021",3,3,0,116333.3,990.3333,122.3333
"18774","55450","2021",2,2,0,166000,1544.5,102
"18775","55452","2021",1,1,0,112000,1366,82
"18776","55453","2021",3,3,0,85333.33,1186.667,79.33333
"18777","55456","2021",4,4,0,138825,1057.5,127.25
"18778","55457","2021",3,3,0,198333.3,1358,145.6667
"18779","55458","2021",5,5,0,145780,1356.4,105.4
"18780","55459","2021",6,6,0,58333.33,506.5,111.6667
"18781","55460","2021",1,1,0,157000,1308,120
"18782","55461","2021",9,9,0,157227.8,1020.889,140
"18783","55462","2021",8,8,0,130837.5,979.5,135.375
"18784","55463","2021",48,43,5,86686.67,889.8542,101.5625
"18785","55464","2021",1,1,0,45000,500,90
"18786","55465","2021",1,1,0,135850,860,158
"18787","55466","2021",2,2,0,107500,949.5,101
"18788","55467","2021",10,10,0,111800,870.1,128.9
"18789","55468","2021",1,1,0,122000,1506,81
"18790","55469","2021",3,3,0,54833.33,788.3333,56
"18791","55470","2021",2,2,0,101000,1303,75.5
"18792","55471","2021",1,1,0,117000,1035,113
"18793","55472","2021",2,2,0,130000,1242.5,104
"18794","55473","2021",2,2,0,77500,1148.5,65
"18795","55474","2021",6,6,0,92783.33,822.8333,116.3333
"18796","55475","2021",1,1,0,98000,784,125
"18797","55476","2021",3,3,0,78833.33,1020.333,78
"18798","55477","2021",6,6,0,104983.3,1140.5,92.33333
"18799","55481","2021",5,5,0,96868.4,780,122.4
"18800","55482","2021",2,2,0,129350,1087.5,96
"18801","55488","2021",5,5,0,141400,1522.4,93.4
"18802","55489","2021",1,1,0,216000,1543,140
"18803","55490","2021",5,5,0,88800,858.2,103.8
"18804","55492","2021",16,16,0,102200,1177.625,85.75
"18805","55493","2021",1,1,0,90000,1125,80
"18806","55494","2021",4,4,0,136341.8,1391.25,105
"18807","55495","2021",3,3,0,98966.67,727,135.3333
"18808","55496","2021",8,8,0,117375,1181.25,93.75
"18809","55497","2021",6,6,0,120000,1173.833,108.5
"18810","55498","2021",3,3,0,141905,973,145.6667
"18811","55500","2021",13,13,0,128559,1100.308,125.7692
"18812","55501","2021",2,2,0,147000,1215.5,136
"18813","55502","2021",21,21,0,121247.6,1200.333,97.47619
"18814","55503","2021",5,4,1,103500,914.4,122.4
"18815","55504","2021",5,5,0,72610,849,89.2
"18816","55505","2021",34,31,3,146543.5,1514.882,99.73529
"18817","55507","2021",4,4,0,76490,611.25,123.75
"18818","55508","2021",4,4,0,204025,2012.25,98
"18819","55509","2021",3,3,0,140000,1309.667,109.6667
"18820","55510","2021",1,1,0,140000,1474,95
"18821","55511","2021",4,4,0,78250,935,86.75
"18822","55512","2021",2,2,0,121875,954,120
"18823","55514","2021",6,6,0,131525,1178.333,114.5
"18824","55515","2021",1,1,0,60000,732,82
"18825","55516","2021",7,7,0,83757.14,1051.429,95.85714
"18826","55517","2021",7,6,1,95228.57,866.8571,112.4286
"18827","55518","2021",4,4,0,61375,779.5,86.75
"18828","55519","2021",16,16,0,103562.5,1132.875,92.3125
"18829","55520","2021",4,4,0,101750,1356.25,82.75
"18830","55521","2021",3,3,0,98333.33,742,154
"18831","55523","2021",1,1,0,255000,2107,121
"18832","55525","2021",1,1,0,182000,2193,83
"18833","55526","2021",3,3,0,85066.67,922.6667,93
"18834","55527","2021",7,6,1,81542.86,776.2857,102.2857
"18835","55528","2021",1,1,0,196500,1003,196
"18836","55530","2021",2,2,0,96000,802.5,129.5
"18837","55531","2021",3,3,0,127023.3,1209.667,104.3333
"18838","55532","2021",5,5,0,92460,827,127
"18839","55533","2021",15,12,3,86961.87,933.3333,88.86667
"18840","55535","2021",1,1,0,206000,1373,150
"18841","55536","2021",1,1,0,45000,479,94
"18842","55540","2021",1,1,0,57500,757,76
"18843","55541","2021",6,6,0,108050,1113.833,95.33333
"18844","55543","2021",13,13,0,131457.7,1235.462,119.2308
"18845","55544","2021",4,4,0,125023,1380.75,98
"18846","55545","2021",230,129,101,125159,1443.083,87.9087
"18847","55546","2021",6,6,0,115000,1309.5,89.5
"18848","55551","2021",31,30,1,103374.5,1098.613,96.93548
"18849","55552","2021",1,1,0,110000,629,175
"18850","55553","2021",14,12,2,130348.6,1115.357,113.3571
"18851","55554","2021",2,2,0,87875,818,97
"18852","55555","2021",1,1,0,135000,912,148
"18853","55557","2021",2,2,0,275075,1278,221.5
"18854","55561","2021",4,4,0,73768.75,690.5,108.25
"18855","55562","2021",3,3,0,81833.33,697.6667,104.6667
"18856","55566","2021",2,2,0,150500,1197.5,133.5
"18857","55567","2021",2,2,0,114500,940.5,120.5
"18858","55568","2021",3,3,0,115000,1191.667,103
"18859","55569","2021",3,3,0,81666.67,798.3333,100.6667
"18860","55570","2021",2,2,0,166450,1441,117
"18861","55571","2021",5,5,0,68200,640.4,114.4
"18862","55573","2021",23,23,0,140105.7,1210.043,122.3478
"18863","55574","2021",1,1,0,372000,2188,170
"18864","55575","2021",1,1,0,45000,464,97
"18865","55577","2021",2,2,0,80550,608,123.5
"18866","55579","2021",1,1,0,62000,428,145
"18867","55581","2021",2,2,0,146000,959.5,144
"18868","55582","2021",1,1,0,48000,400,120
"18869","55583","2021",2,2,0,72500,769,93.5
"18870","55584","2021",4,4,0,107875,934.5,108
"18871","55586","2021",2,2,0,122435,664,184.5
"18872","56001","2021",42,42,0,162585.7,1513.952,111.3095
"18873","56002","2021",51,49,2,280759.2,2751.686,105.451
"18874","56003","2021",77,56,21,563143.8,4659.351,115.1429
"18875","56004","2021",38,34,4,163669.7,2429.368,74.10526
"18876","56005","2021",157,70,87,321944.3,4667.611,67.54777
"18877","56006","2021",12,12,0,134598.4,1433.833,95.33333
"18878","56007","2021",265,113,152,259551.5,3259.196,80.3434
"18879","56008","2021",84,78,6,603837.7,4469.893,134.4286
"18880","56009","2021",24,24,0,382583.5,4639.333,90.25
"18881","56010","2021",114,98,16,182067.2,1856.877,99.01754
"18882","56011","2021",39,39,0,175181.6,1527.769,117.3333
"18883","56012","2021",11,11,0,166881.8,2100.455,86.09091
"18884","56013","2021",69,64,5,293111.7,3043.913,98.13043
"18885","56014","2021",28,28,0,134512.5,1379.607,100
"18886","56015","2021",26,25,1,273733.6,2467,112.6538
"18887","56017","2021",36,36,0,172644.2,1775.361,103.5
"18888","56018","2021",28,25,3,266503.1,2914.857,90.89286
"18889","56019","2021",5,5,0,89250,942.6,94.2
"18890","56020","2021",9,9,0,191005.4,1712.111,113.3333
"18891","56021","2021",13,13,0,233538.5,2128.846,111.9231
"18892","56022","2021",22,22,0,232142.7,1965.045,116.6818
"18893","56023","2021",79,60,19,255676.9,2708.684,95.22785
"18894","56024","2021",25,25,0,123155.1,1186.28,106.72
"18895","56025","2021",3,3,0,79500,611,128.6667
"18896","56026","2021",34,34,0,118758.9,1126.324,105.2353
"18897","56027","2021",13,13,0,94093.08,1033.923,93.76923
"18898","56028","2021",32,32,0,159796.1,1622.125,95.375
"18899","56029","2021",6,6,0,172200,2055,82
"18900","56030","2021",18,18,0,198073.9,2471.611,84.72222
"18901","56031","2021",50,50,0,195681.8,1865.38,104.56
"18902","56032","2021",20,20,0,116424.1,1253.75,96.3
"18903","56033","2021",48,48,0,112587.8,1220.979,88.5
"18904","56034","2021",206,99,107,354843,5068.699,77.76214
"18905","56035","2021",9,9,0,82447.56,1023.111,84.55556
"18906","56036","2021",68,54,14,241993.5,2199.912,110.2794
"18907","56039","2021",15,14,1,190375.7,1610.733,121.6667
"18908","56040","2021",45,45,0,219471.3,2120.8,106.3556
"18909","56041","2021",48,47,1,118436.6,1578.625,85.85417
"18910","56042","2021",27,27,0,220411,2055.741,106.8148
"18911","56043","2021",9,9,0,130622.2,1411.444,97.88889
"18912","56044","2021",13,13,0,151827.7,1200.154,115.0769
"18913","56045","2021",5,5,0,220816,2382.6,92.6
"18914","56046","2021",71,71,0,454767,3566.704,130.6761
"18915","56047","2021",28,28,0,110781.4,1220.893,92.5
"18916","56048","2021",28,27,1,87394.11,1045.25,86.35714
"18917","56050","2021",14,14,0,167685.7,1541.5,109.0714
"18918","56051","2021",12,12,0,113958.3,1097.917,103.25
"18919","56052","2021",97,76,21,330194.9,4062.948,84.26804
"18920","56053","2021",91,84,7,220712.8,2275.242,99.53846
"18921","56054","2021",75,58,17,270707.5,3478.693,81.30667
"18922","56055","2021",61,39,22,250199.3,3218.77,86.45902
"18923","56056","2021",5,5,0,138680,1045.4,135.8
"18924","56057","2021",83,81,2,128103,1405.59,97.86747
"18925","56058","2021",41,39,2,208809.8,2178.951,98.82927
"18926","56060","2021",15,15,0,91349.93,1155.6,80.06667
"18927","56061","2021",68,67,1,127027.5,1416.132,91.69118
"18928","56062","2021",16,15,1,303576.2,3614.688,90.6875
"18929","56063","2021",29,28,1,252161.1,2361.552,112.5517
"18930","56065","2021",7,7,0,203785.7,1769.286,118
"18931","56066","2021",109,105,4,107384.8,1133.266,96.00917
"18932","56067","2021",95,89,6,275660.5,2293.147,121.8211
"18933","56068","2021",3,3,0,84847,917,91
"18934","56069","2021",60,58,2,281996.3,3873.433,80.56667
"18935","56070","2021",46,46,0,123103.1,1340.13,92.84783
"18936","56071","2021",10,10,0,169815,1608.2,108.4
"18937","56072","2021",11,11,0,106589.5,1105.636,89.18182
"18938","56073","2021",40,40,0,100387.8,1057.85,97.95
"18939","56074","2021",25,25,0,151992,1540.72,99.36
"18940","56075","2021",54,51,3,138343.5,1433.407,97.48148
"18941","56076","2021",36,36,0,120580,1266.611,92.52778
"18942","56077","2021",12,12,0,240341.7,2110.5,113.1667
"18943","56078","2021",215,149,66,270237.2,3169.609,88.87442
"18944","56079","2021",21,21,0,119967.1,1446.476,87.52381
"18945","56080","2021",35,33,2,99718.66,1128.629,88.02857
"18946","56081","2021",49,49,0,92682.06,1022.816,92.4898
"18947","56082","2021",5,5,0,126700,1520,89.2
"18948","56083","2021",277,158,119,172465.9,2108.758,82.14079
"18949","56084","2021",15,15,0,294534,2995.467,96.6
"18950","56085","2021",2,2,0,370000,5093.5,73.5
"18951","56086","2021",5,5,0,321600,4869.2,65.8
"18952","56087","2021",22,19,3,482015.5,5736.182,91.22727
"18953","56088","2021",7,7,0,401285.7,4653.286,91.57143
"18954","56089","2021",47,47,0,170692,1594.043,108.7021
"18955","56090","2021",98,89,9,190450.6,1970.786,99.05102
"18956","56091","2021",41,37,4,139486.5,1479.707,95
"18957","56092","2021",10,10,0,95150,1106.4,93.7
"18958","56093","2021",17,17,0,150283.8,1482.588,106
"18959","56094","2021",70,60,10,282699.1,2454.614,116.6286
"18960","56096","2021",9,7,2,248277.8,2443.556,103.4444
"18961","56097","2021",48,39,9,221779.1,2247.375,101.3125
"18962","56098","2021",301,198,103,185523.6,2111.405,88.62458
"18963","56099","2021",13,13,0,159931.5,1527.769,136.3846
"18964","56100","2021",64,63,1,110343.6,1121.547,100.0938
"18965","56101","2021",102,91,11,205648.1,2112.314,99.41176
"18966","56102","2021",28,28,0,114170.6,1249.857,89.92857
"18967","56103","2021",8,8,0,101421.2,1205.75,88
"18968","56104","2021",9,9,0,190555.6,1726.889,114.6667
"18969","56105","2021",39,39,0,110947.9,1199.821,94.48718
"18970","56106","2021",17,15,2,562882.4,5123.059,116.7059
"18971","56107","2021",120,77,43,398156.2,4070.358,100.3
"18972","56108","2021",14,14,0,167435.7,1930.214,91.92857
"18973","56109","2021",27,27,0,229895,2167.963,108.7037
"18974","56110","2021",23,23,0,85789.57,1057.913,80.30435
"18975","56111","2021",42,42,0,150819.3,1741.143,86.19048
"18976","56112","2021",24,24,0,128438.9,1408.542,92.75
"18977","56113","2021",18,18,0,117861.1,1112.444,105.1667
"18978","56114","2021",15,15,0,278543.3,3905.2,72.46667
"18979","56115","2021",23,23,0,252937.6,2138.304,117.087
"18980","56116","2021",34,29,5,497225.6,5047.529,99.70588
"18981","56117","2021",79,68,11,171148.4,1875.19,93.97468
"18982","56118","2021",56,48,8,252797.1,2968.554,86.07143
"18983","56119","2021",33,33,0,296999.8,2900.424,105.3333
"18984","56120","2021",24,24,0,224643.9,1953.917,115.6667
"18985","56121","2021",1164,343,821,173942.6,2368.546,73.88316
"18986","56122","2021",26,26,0,124332.7,1292.038,96.42308
"18987","56123","2021",52,51,1,163925.4,1766,98.11538
"18988","56124","2021",26,22,4,162772.7,1770.154,95.26923
"18989","56125","2021",31,31,0,146312.3,1483.806,102.2258
"18990","56126","2021",41,41,0,169525.4,1966.341,88.7561
"18991","56127","2021",62,60,2,113028.3,1218.919,94.83871
"18992","56128","2021",30,30,0,87932.83,1227.733,77.53333
"18993","56129","2021",30,30,0,109925.7,1083.367,104.7667
"18994","56130","2021",42,42,0,248094.5,2461.571,102.7857
"18995","56131","2021",34,34,0,131102.4,1448.765,91.41176
"18996","56132","2021",24,23,1,258063.8,2689.75,100.7083
"18997","56133","2021",4,4,0,204250,1742,118.5
"18998","56134","2021",31,31,0,102585.2,953.2581,106.871
"18999","56135","2021",17,17,0,144815.8,1580.529,91.58824
"19000","56136","2021",10,10,0,107815,1436.7,89
"19001","56137","2021",40,40,0,265569.9,2319.625,114.1
"19002","56139","2021",2,2,0,221000,1959.5,115
"19003","56140","2021",51,50,1,148849.5,1443.745,104.5686
"19004","56141","2021",35,35,0,186122.5,1731.629,111.2286
"19005","56143","2021",69,65,4,243301.8,2376.203,105.1594
"19006","56144","2021",68,67,1,116468.6,1235.838,94.42647
"19007","56145","2021",17,17,0,94072.47,1438.471,73.11765
"19008","56146","2021",22,22,0,135012.5,1429.773,97.09091
"19009","56147","2021",94,93,1,211944.1,2015.191,105.4894
"19010","56148","2021",16,16,0,255464.1,2363.438,109.625
"19011","56149","2021",30,30,0,186671.2,2190.267,89.46667
"19012","56151","2021",70,70,0,124149.6,1252.8,98.78571
"19013","56152","2021",69,51,18,311290,3801.971,83.86957
"19014","56153","2021",48,47,1,175611.2,1677.354,103.1875
"19015","56154","2021",31,31,0,126068.2,1449.581,89.3871
"19016","56155","2021",88,79,9,263920.7,3488.523,82.39773
"19017","56156","2021",14,14,0,98500,1132.571,91.57143
"19018","56157","2021",25,25,0,196580.4,1760.08,113.36
"19019","56158","2021",112,59,53,247213.4,2843.089,88.73214
"19020","56159","2021",28,28,0,167852.6,1801.607,95.64286
"19021","56160","2021",14,14,0,106835.7,1210.214,92.5
"19022","56161","2021",56,38,18,266135.1,3132.768,89.07143
"19023","56162","2021",243,193,50,325498.7,3344.786,101.0864
"19024","56163","2021",25,25,0,107120.8,1197.36,89.92
"19025","56164","2021",97,68,29,280994.9,2976.505,96.30928
"19026","56165","2021",135,100,35,153495.4,1731.007,90.47407
"19027","56166","2021",57,53,4,177609.6,1896,99.82456
"19028","56167","2021",35,34,1,330778.2,2998.971,111.7714
"19029","56168","2021",35,32,3,325549.3,3692.343,95.6
"19030","56169","2021",96,84,12,301139.9,2945.802,103.25
"19031","56170","2021",42,42,0,92162.02,1116.69,82.83333
"19032","56171","2021",34,34,0,165095.4,1672.706,99.52941
"19033","56172","2021",34,34,0,145227.9,1535.794,97.23529
"19034","56173","2021",98,98,0,130466.2,1412.061,92.57143
"19035","56174","2021",35,35,0,185073.4,1931.286,100.1714
"19036","56175","2021",59,57,2,282229.1,2409.492,120.0508
"19037","56176","2021",85,64,21,237357.4,2681.459,91.30588
"19038","56177","2021",113,98,15,215027.6,2223.124,96.74336
"19039","56178","2021",292,186,106,125064.7,1514.099,85
"19040","56179","2021",52,44,8,219001.9,2122.827,105.8654
"19041","56180","2021",7,7,0,106885.7,1219.286,85.57143
"19042","56181","2021",45,27,18,251521,3283.4,79.26667
"19043","56182","2021",22,22,0,117154.5,1493.545,75.95455
"19044","56184","2021",127,109,18,207686,2098.614,99.76378
"19045","56185","2021",106,101,5,275656.7,2532.368,111.3868
"19046","56186","2021",242,101,141,306232.3,4545.393,70.21488
"19047","56188","2021",22,22,0,128234.3,1280.864,104.9545
"19048","56189","2021",13,13,0,141605.4,1207.462,127.6923
"19049","56190","2021",29,29,0,137212.9,1392.345,97.93103
"19050","56191","2021",8,8,0,116686.8,1299.125,88.125
"19051","56193","2021",83,81,2,233348.4,2494.699,96.43373
"19052","56194","2021",37,37,0,147804.4,1454.297,103.9189
"19053","56195","2021",29,14,15,166703.2,2613.414,70.65517
"19054","56196","2021",22,12,10,164426.6,1934.318,81.68182
"19055","56197","2021",41,41,0,154444.2,1606.098,96.36585
"19056","56198","2021",21,21,0,126072.1,1214.381,112.4286
"19057","56199","2021",24,23,1,95130.21,1061.833,92.16667
"19058","56200","2021",21,21,0,120678.5,1257.81,94.7619
"19059","56201","2021",18,18,0,92855.44,1262,82.88889
"19060","56202","2021",2,2,0,147500,1594,92.5
"19061","56203","2021",17,16,1,124852.9,1350.824,90.82353
"19062","56204","2021",11,11,0,127647.3,1400.455,108.2727
"19063","56205","2021",15,14,1,497040.9,4428,113.4
"19064","56206","2021",147,102,45,285387,2786.014,103.6803
"19065","56207","2021",26,26,0,157560.4,1577.385,106.5
"19066","56208","2021",7,7,0,71428.57,1187.857,73.85714
"19067","56209","2021",5,5,0,73300,899.4,76.6
"19068","56210","2021",11,10,1,119636.4,1144.091,104.9091
"19069","56211","2021",12,12,0,87984.17,1075.333,77.5
"19070","56212","2021",39,39,0,177741.4,1652.359,106.2564
"19071","56213","2021",11,11,0,134237.7,1302.545,100
"19072","56214","2021",82,75,7,381921.6,4058.049,96.89024
"19073","56215","2021",20,20,0,132936,1283.25,103.05
"19074","56216","2021",11,11,0,91750.45,1157.182,82.72727
"19075","56218","2021",19,19,0,131060.2,1475.579,89
"19076","56219","2021",14,14,0,133795.2,1677.857,81.85714
"19077","56220","2021",14,14,0,250664.3,3408.071,78.07143
"19078","56221","2021",24,24,0,106405.9,1387.125,77.16667
"19079","56222","2021",43,39,4,175277.4,1958.535,96.48837
"19080","56223","2021",28,28,0,164240.6,1527.964,105.0357
"19081","56224","2021",5,5,0,164150,1527.6,109
"19082","56225","2021",4,4,0,112750,965.25,125.5
"19083","56226","2021",7,7,0,192785.7,1552.571,125.1429
"19084","56227","2021",12,12,0,117080.4,1617.25,86.16667
"19085","56228","2021",14,14,0,189063.6,1785.786,107.7857
"19086","56229","2021",32,32,0,126460.3,1153.719,108.1875
"19087","56230","2021",5,5,0,92611.2,860.6,89.6
"19088","56231","2021",53,48,5,278459.9,2332.132,124.3962
"19089","56232","2021",16,16,0,132630.6,1440.5,87.5
"19090","56233","2021",43,24,19,431366.7,4473.581,98.11628
"19091","56234","2021",93,76,17,394902.3,4570.161,88.05376
"19092","56236","2021",14,14,0,102642.4,1347.929,83.42857
"19093","56237","2021",13,13,0,163738.5,1619.769,102.6154
"19094","56238","2021",17,17,0,90713.53,988.6471,98.76471
"19095","56239","2021",20,20,0,153487.8,1534.65,101.35
"19096","56240","2021",284,231,53,352683.7,3833.215,97.39085
"19097","56241","2021",15,11,4,334006.8,4049.267,86
"19098","56242","2021",29,29,0,85735.97,1177,90.24138
"19099","56243","2021",147,82,65,307992.4,3441.966,88.82993
"19100","56244","2021",34,34,0,151971,1573.618,95.26471
"19101","56245","2021",11,11,0,51612.73,805.4545,68.36364
"19102","56246","2021",20,20,0,181876.8,1668.95,110.5
"19103","56247","2021",49,49,0,265521.1,2405.918,110.3673
"19104","56248","2021",76,70,6,306927,2819.408,111.6053
"19105","56249","2021",34,34,0,146579.3,1402.706,104.3529
"19106","56250","2021",11,11,0,139554.5,1412.545,91.72727
"19107","56251","2021",92,87,5,315260.4,2952.935,108.25
"19108","56252","2021",31,31,0,326986.8,2988.548,114.9355
"19109","56253","2021",10,10,0,93033,1061.8,90.8
"19110","56254","2021",23,23,0,183926.1,1781.826,104.2174
"19111","56255","2021",34,30,4,248577.2,2411.059,103.2941
"19112","56256","2021",2,2,0,62500,704.5,97.5
"19113","56257","2021",23,22,1,86550,908.8261,96.17391
"19114","56258","2021",72,44,28,514045,5729.361,86.88889
"19115","56259","2021",17,17,0,219436.5,2303.941,99.29412
"19116","56260","2021",1123,335,788,274235.3,3657.268,73.09884
"19117","56261","2021",19,19,0,158376.3,1635,93.31579
"19118","56262","2021",49,40,9,390371.1,3598.571,110.449
"19119","56263","2021",35,32,3,310245.4,2619.686,121.2571
"19120","56264","2021",10,10,0,99170,886.7,115.4
"19121","57620","2021",1,1,0,195000,2786,70
"19122","58001","2021",7,7,0,73821.43,976.8571,86.14286
"19123","58002","2021",20,20,0,85621.3,1194.9,75.45
"19124","58003","2021",15,15,0,91580,1059.733,87.06667
"19125","58004","2021",8,8,0,65947.5,879.25,83.375
"19126","58005","2021",3,2,1,71106.67,932.3333,82.66667
"19127","58006","2021",3,3,0,144428.3,1243.667,116.3333
"19128","58007","2021",6,6,0,114850,827,147
"19129","58008","2021",6,6,0,79996.67,1052.5,84.66667
"19130","58009","2021",2,2,0,66500,1059.5,62.5
"19131","58010","2021",16,16,0,92584.38,1115.812,90.9375
"19132","58011","2021",6,6,0,53416.67,626.1667,87
"19133","58012","2021",14,14,0,99885.71,1061.571,89.21429
"19134","58014","2021",2,2,0,114500,826.5,132
"19135","58015","2021",6,6,0,80000,714.3333,113.6667
"19136","58016","2021",1,1,0,68000,544,125
"19137","58017","2021",7,7,0,62544.57,801.8571,79.28571
"19138","58018","2021",1,1,0,75810,606,125
"19139","58019","2021",3,3,0,59833.33,1093,58
"19140","58020","2021",3,3,0,90666.67,966.3333,88.66667
"19141","58021","2021",3,3,0,62666.67,900,63.33333
"19142","58023","2021",3,3,0,143000,2097,75.66667
"19143","58024","2021",7,7,0,75090.71,1305.714,59.28571
"19144","58025","2021",3,3,0,96333.33,1015,93
"19145","58026","2021",1,1,0,66000,825,80
"19146","58027","2021",4,4,0,102660,1214.5,85.25
"19147","58028","2021",2,2,0,73000,764.5,96
"19148","58029","2021",3,3,0,84366.67,793.6667,117.6667
"19149","58030","2021",5,5,0,63790,1029.4,64.8
"19150","58031","2021",5,5,0,126900,827.8,144.8
"19151","58032","2021",2,2,0,63500,534.5,115.5
"19152","58033","2021",9,9,0,66388.89,1020.222,65
"19153","58034","2021",2,2,0,123725,1479.5,93.5
"19154","58035","2021",7,7,0,57785.71,798.2857,75.42857
"19155","58036","2021",13,13,0,86738.46,835.0769,106.9231
"19156","58037","2021",19,19,0,100100,1209.421,85.36842
"19157","58038","2021",1,1,0,68500,685,100
"19158","58039","2021",5,5,0,55800,810.8,77.8
"19159","58040","2021",2,2,0,67500,1321.5,48.5
"19160","58041","2021",3,3,0,39333.33,404,97.66667
"19161","58042","2021",1,1,0,361925,2381,152
"19162","58043","2021",1,1,0,41000,683,60
"19163","58044","2021",19,18,1,99144.79,1178.579,85.89474
"19164","58045","2021",7,7,0,83078.57,830.8571,97.57143
"19165","58046","2021",21,21,0,71845.95,838.8571,87.52381
"19166","58047","2021",14,14,0,59071.43,858.7857,70.21429
"19167","58048","2021",5,5,0,52400,699.8,79.6
"19168","58049","2021",3,3,0,103000,1347.333,73.66667
"19169","58050","2021",3,3,0,44166.67,734,60.66667
"19170","58051","2021",14,14,0,127253.6,1290,98.28571
"19171","58052","2021",4,4,0,164811,1393,124.5
"19172","58053","2021",7,7,0,89857.14,1006.857,90.71429
"19173","58054","2021",1,1,0,83000,1137,73
"19174","58055","2021",13,13,0,65223,757.6154,88.76923
"19175","58056","2021",3,3,0,101866.7,1376,79
"19176","58057","2021",23,23,0,122782.6,1321.391,94.69565
"19177","58058","2021",12,12,0,66041.67,739.1667,88.66667
"19178","58059","2021",95,78,17,116590.3,1185.589,97.52632
"19179","58060","2021",8,8,0,121218.8,1110.375,102.75
"19180","58061","2021",6,6,0,79416.67,850.3333,88.5
"19181","58062","2021",22,22,0,86077.27,874.1818,96
"19182","58063","2021",10,10,0,96300,1347,79.4
"19183","58064","2021",17,16,1,57294.12,785.2353,81.52941
"19184","58065","2021",18,18,0,65258.89,790,83.5
"19185","58066","2021",2,2,0,42500,680.5,65
"19186","58067","2021",22,22,0,147440,1428.909,113.7727
"19187","58068","2021",10,10,0,100710.3,1711.6,69.6
"19188","58069","2021",3,3,0,102000,1538.333,69
"19189","58070","2021",2,2,0,68500,1528,42
"19190","58071","2021",5,5,0,53300,819.8,65
"19191","58072","2021",11,11,0,115391.4,1278.455,91.72727
"19192","58074","2021",13,13,0,115446.2,1602.923,85.15385
"19193","58075","2021",3,3,0,81576.67,759.6667,96.33333
"19194","58076","2021",2,2,0,91609,1250.5,72
"19195","58077","2021",12,12,0,83216.67,1004,88.5
"19196","58078","2021",2,2,0,131000,729.5,167.5
"19197","58079","2021",38,34,4,93321.71,1006,95.94737
"19198","58080","2021",3,3,0,91666.67,1157,79.66667
"19199","58081","2021",9,9,0,76500,986.5556,76.33333
"19200","58082","2021",14,14,0,72689.29,970.0714,72.14286
"19201","58083","2021",26,25,1,83807.69,1003.885,92.88462
"19202","58084","2021",7,7,0,89642.86,840.5714,109.8571
"19203","58085","2021",18,18,0,73000,817.2778,94.94444
"19204","58086","2021",181,156,25,104119.6,1238.994,85.61878
"19205","58087","2021",11,11,0,53536.36,788.8182,66.90909
"19206","58088","2021",48,44,4,150457.9,1534.521,96.75
"19207","58089","2021",9,9,0,109000,1005.111,106.5556
"19208","58090","2021",3,3,0,64333.33,728,78.33333
"19209","58092","2021",5,5,0,68200,744.8,80.2
"19210","58093","2021",1,1,0,15000,500,30
"19211","58094","2021",16,16,0,94149.5,1187.125,89.1875
"19212","58095","2021",74,50,24,73723.78,901.2838,79.74324
"19213","58096","2021",5,5,0,26700,423.6,63.6
"19214","58097","2021",1,1,0,65000,1083,60
"19215","58098","2021",4,4,0,59625,713.75,84
"19216","58099","2021",5,5,0,131000,995.6,118.6
"19217","58101","2021",3,3,0,31750,753.3333,42
"19218","58102","2021",29,29,0,91386.86,979.5172,93.82759
"19219","58103","2021",9,9,0,90111.11,812.7778,104.6667
"19220","58104","2021",13,13,0,96158.77,960.3077,100.2308
"19221","58105","2021",2,2,0,95630.5,1437.5,67
"19222","58106","2021",16,16,0,132001.1,1471.75,101.375
"19223","58107","2021",3,3,0,102366.7,865.6667,116.6667
"19224","58108","2021",4,4,0,88092.5,1523.75,61
"19225","58109","2021",13,13,0,58115.38,722.4615,84.61538
"19226","58110","2021",5,5,0,54760,1131.6,48.4
"19227","58111","2021",6,6,0,108121.7,1107.167,101
"19228","58112","2021",12,12,0,116520.8,1116.5,99.83333
"19229","58113","2021",1,1,0,24000,800,30
"19230","58114","2021",2,2,0,143725,1347.5,105
"19231","58115","2021",2,2,0,94000,994.5,108.5
"19232","58116","2021",1,1,0,54000,1125,48
"19233","58117","2021",55,42,13,102444.5,1150.509,87.72727
"19234","58118","2021",17,16,1,90911.76,924.8235,108.3529
"19235","58119","2021",1,1,0,185000,1088,170
"19236","58120","2021",7,7,0,125052,1323.429,86.85714
"19237","58121","2021",61,52,9,105938.4,1217.393,83.7541
"19238","58122","2021",9,9,0,78233.33,1267.556,72.11111
"19239","58123","2021",1,1,0,140000,1037,135
"19240","58124","2021",10,10,0,118033,1355.9,87.3
"19241","58125","2021",6,6,0,104416.7,1251.167,92
"19242","58126","2021",2,2,0,98750,1438.5,66
"19243","58127","2021",1,1,0,127000,1588,80
"19244","58129","2021",4,4,0,99112.5,1154,86.75
"19245","58130","2021",9,9,0,79525.56,842.2222,88.22222
"19246","58131","2021",39,38,1,113284.6,1292.436,88.41026
"19247","58132","2021",4,4,0,74250,718.75,103
"19248","58133","2021",7,7,0,78571.43,792.5714,92.28571
"19249","58134","2021",53,43,10,86769.53,1011.094,84.01887
"19250","58136","2021",1,1,0,40000,444,90
"19251","58137","2021",3,3,0,94000,1090.667,79
"19252","58138","2021",4,4,0,134325,919.5,127
"19253","58139","2021",2,2,0,40250,1069.5,38
"19254","58140","2021",6,6,0,85608.33,990.5,83
"19255","58141","2021",4,4,0,86795,1006.5,85
"19256","58142","2021",7,7,0,58571.43,871.7143,68.57143
"19257","58143","2021",2,2,0,65000,1550,60
"19258","58144","2021",15,15,0,95693.33,968,98.4
"19259","58145","2021",29,29,0,89029.48,998.2414,87.06897
"19260","58146","2021",18,18,0,91250,1049.111,86.05556
"19261","58147","2021",7,7,0,105142.9,1079.714,100.7143
"19262","58148","2021",7,7,0,125227.1,1075.714,106.5714
"19263","58149","2021",32,28,4,77551.16,844.5312,86.3125
"19264","58150","2021",1,1,0,40000,500,80
"19265","58151","2021",55,54,1,61895.58,796.2182,77.98182
"19266","58152","2021",13,13,0,132907.7,1571.538,95.23077
"19267","58153","2021",2,2,0,179695,1340,150.5
"19268","58154","2021",3,3,0,72333.33,879.3333,89.66667
"19269","58155","2021",12,12,0,108137.5,1221.333,96.16667
"19270","58156","2021",4,4,0,101000,974.25,103.75
"19271","58157","2021",13,13,0,105418.8,906.6923,107.6923
"19272","58158","2021",2,2,0,112000,946.5,118
"19273","58159","2021",2,2,0,72000,1126.5,76
"19274","58160","2021",54,48,6,152578.9,1612.074,94.51852
"19275","58161","2021",4,4,0,75799.75,1019.75,87.25
"19276","58162","2021",3,3,0,117333.3,601,166.6667
"19277","58163","2021",11,11,0,76181.82,1001.182,86.09091
"19278","58164","2021",12,12,0,107295.5,1067.917,99.75
"19279","58165","2021",5,4,1,33400,513.6,70.2
"19280","58166","2021",6,6,0,77816.67,1024.5,74.83333
"19281","58168","2021",4,4,0,69500,793.75,85.5
"19282","58169","2021",1,1,0,48000,600,80
"19283","58170","2021",6,6,0,77000,649.5,114
"19284","58171","2021",9,9,0,54611.11,875.6667,69
"19285","58172","2021",3,3,0,69000,693.6667,104.6667
"19286","58173","2021",6,6,0,92333.33,739.8333,130.3333
"19287","58174","2021",3,3,0,125703,1058.667,118.6667
"19288","58175","2021",6,6,0,91158.33,896.6667,104
"19289","58176","2021",5,5,0,131160,1253,112.6
"19290","58177","2021",14,14,0,78804.29,1032.643,81.5
"19291","58178","2021",5,5,0,82000,1101.8,81.4
"19292","58179","2021",8,8,0,75437.5,884.75,91.625
"19293","58180","2021",15,15,0,140283.3,1371.933,109.6667
"19294","58181","2021",3,3,0,78733.33,1043.667,71.33333
"19295","58182","2021",17,17,0,68947.06,964.1176,79.64706
"19296","58183","2021",4,4,0,79225,898.75,95.5
"19297","58184","2021",5,5,0,58000,829.6,67.6
"19298","58185","2021",22,22,0,103898.9,1214.5,85.13636
"19299","58186","2021",1,1,0,40000,449,89
"19300","58187","2021",6,6,0,57333.33,777.6667,75.16667
"19301","58188","2021",1,1,0,49000,942,52
"19302","58189","2021",8,8,0,113212.5,1295.875,76.5
"19303","58190","2021",3,3,0,67666.67,946.3333,68.66667
"19304","58191","2021",2,2,0,78500,767,92.5
"19305","58192","2021",2,2,0,107500,1086,102.5
"19306","58193","2021",35,35,0,95100,928.1714,107.3714
"19307","58194","2021",570,224,346,95798.43,1208.937,77.83509
"19308","58195","2021",11,11,0,66650,1084.273,70.72727
"19309","58196","2021",5,5,0,101291,1287,95
"19310","58197","2021",1,1,0,28000,737,38
"19311","58198","2021",3,3,0,66166.67,894,101.3333
"19312","58199","2021",11,11,0,126429.5,1167.273,103
"19313","58200","2021",3,3,0,77166.67,903.6667,76.33333
"19314","58201","2021",3,3,0,48500,857.6667,56.66667
"19315","58202","2021",3,3,0,90906.67,897,112
"19316","58203","2021",2,2,0,40000,745,54
"19317","58204","2021",13,13,0,100306.2,1041.308,95
"19318","58205","2021",22,22,0,92713,1068.818,89.54545
"19319","58207","2021",17,15,2,109679.4,1420.647,81.17647
"19320","58208","2021",4,4,0,65561.25,1115.5,64
"19321","58209","2021",4,4,0,98250,1032.25,85
"19322","58210","2021",10,10,0,120128,1096.2,115.3
"19323","58211","2021",5,5,0,110610,1108,104.8
"19324","58212","2021",6,6,0,51290.5,868,64.66667
"19325","58213","2021",6,6,0,121150,1633.5,80.5
"19326","58214","2021",38,35,3,118934.7,1310.658,89.05263
"19327","58215","2021",42,40,2,93202.02,1098.048,84.61905
"19328","58216","2021",3,3,0,116333.3,1493.333,72
"19329","58217","2021",5,5,0,81245,875.2,92.8
"19330","58218","2021",27,27,0,83500,955.0741,89.40741
"19331","58219","2021",10,10,0,125286,1249.9,92
"19332","58220","2021",14,14,0,118002.9,1467.286,95.5
"19333","58221","2021",7,7,0,90925.71,838.1429,101
"19334","58222","2021",2,2,0,121000,1659.5,72
"19335","58223","2021",7,7,0,76571.43,839,88.57143
"19336","58224","2021",4,4,0,87500,1327.5,87.5
"19337","58225","2021",4,3,1,77500,855.25,97.5
"19338","58226","2021",2,2,0,238320,1619.5,115
"19339","58227","2021",27,25,2,88655.56,1114.148,86.55556
"19340","58228","2021",8,8,0,80187.5,999.5,80
"19341","58229","2021",8,8,0,143445,1463.75,97.625
"19342","58230","2021",2,2,0,117000,1614.5,80.5
"19343","58231","2021",4,4,0,105832.8,1253,80.75
"19344","58232","2021",14,14,0,102675,1010.786,98.35714
"19345","58233","2021",11,11,0,95462.36,1000.455,103
"19346","58235","2021",6,6,0,138466.7,1823.5,77.5
"19347","58236","2021",8,8,0,95837.5,1038.5,86.5
"19348","58237","2021",2,2,0,106500,922,120
"19349","58238","2021",27,27,0,132896.3,1571,91.11111
"19350","58239","2021",3,3,0,132666.7,836.6667,150.3333
"19351","58240","2021",2,2,0,38012.5,588,61
"19352","58241","2021",6,6,0,59333.33,809.1667,85
"19353","58242","2021",3,3,0,85318.33,1131.333,105.3333
"19354","58243","2021",2,2,0,55000,730.5,72
"19355","58244","2021",4,4,0,72125,696,108.75
"19356","58245","2021",8,8,0,54875,634.625,88.375
"19357","58246","2021",32,28,4,85037.19,853.6875,97.28125
"19358","58247","2021",4,4,0,58200,870.25,66.75
"19359","58248","2021",4,4,0,108225,1164,90.75
"19360","58249","2021",10,10,0,162115,1497.9,90.2
"19361","58250","2021",34,30,4,88914.71,1012.912,86.5
"19362","58251","2021",12,12,0,86427.83,942.75,92.66667
"19363","58252","2021",4,4,0,107250,891.75,125
"19364","58253","2021",5,5,0,72595,931.4,80.4
"19365","58254","2021",9,9,0,107933.3,1160.111,96
"19366","58255","2021",11,11,0,114339.5,1182.727,98.09091
"19367","58256","2021",6,6,0,77000,909.6667,86
"19368","58258","2021",3,3,0,110333.3,1344.333,74.66667
"19369","58259","2021",3,3,0,111866.7,1119,102.6667
"19370","58260","2021",23,23,0,107643.3,1055.261,101.3478
"19371","58261","2021",15,15,0,96936.33,1001.467,97.66667
"19372","58262","2021",6,6,0,86626.67,792.8333,129
"19373","58263","2021",2,2,0,51750,713,73.5
"19374","58264","2021",24,23,1,87583.33,1047.5,87.20833
"19375","58265","2021",1,1,0,48000,1143,42
"19376","58266","2021",5,5,0,58600,645.2,87.6
"19377","58267","2021",12,12,0,50358.33,657,78.91667
"19378","58268","2021",2,2,0,126000,1097.5,107.5
"19379","58269","2021",8,8,0,79875,1251.75,74
"19380","58270","2021",3,3,0,96666.67,1035.333,104.3333
"19381","58271","2021",1,1,0,23000,354,65
"19382","58272","2021",5,5,0,78110,1100.8,68.8
"19383","58273","2021",17,15,2,110764.7,1222.118,91.64706
"19384","58274","2021",2,2,0,70375,1593,44
"19385","58275","2021",7,7,0,59751.29,791.1429,79
"19386","58276","2021",4,4,0,84000,904,83.5
"19387","58277","2021",10,10,0,90000,1303.1,79.3
"19388","58278","2021",16,15,1,114025,1331.625,83.5625
"19389","58279","2021",5,5,0,62944,771.2,79.6
"19390","58280","2021",10,10,0,121923,1138.4,113.1
"19391","58281","2021",11,11,0,94075.55,1115.818,83.36364
"19392","58282","2021",10,10,0,55400,717.6,74.9
"19393","58283","2021",3,3,0,77500,861.3333,88.33333
"19394","58285","2021",3,3,0,69316.67,644.3333,103
"19395","58286","2021",13,12,1,84383.46,921.3077,102.6154
"19396","58287","2021",7,7,0,75057.14,1019.286,82
"19397","58288","2021",4,4,0,119000,923.25,167.25
"19398","58289","2021",13,13,0,70782.54,1007.385,69.61538
"19399","58290","2021",1,1,0,108000,806,134
"19400","58291","2021",3,3,0,72333.33,953,69
"19401","58292","2021",6,6,0,86296.67,781.3333,121.3333
"19402","58293","2021",5,5,0,86620,989.2,83.2
"19403","58294","2021",2,2,0,96500,1335.5,69.5
"19404","58295","2021",17,17,0,88629.41,906.5294,98.58824
"19405","58297","2021",2,2,0,86950,797.5,108
"19406","58298","2021",3,3,0,88666.67,1214,77
"19407","58299","2021",5,5,0,57600,710.8,87
"19408","58300","2021",13,12,1,114561.5,1212.308,93.23077
"19409","58301","2021",4,4,0,66500,972.25,69.75
"19410","58302","2021",14,14,0,111012.9,1427.786,85.5
"19411","58303","2021",111,96,15,119576.9,1401.658,85.06306
"19412","58304","2021",32,30,2,60520.31,821.4375,78.875
"19413","58305","2021",2,2,0,41730,705.5,58
"19414","58306","2021",4,4,0,120600,1143,130.25
"19415","58307","2021",1,1,0,102000,523,195
"19416","58308","2021",2,2,0,136000,2371.5,71.5
"19417","58309","2021",20,20,0,94865.85,1113.85,90.3
"19418","58310","2021",1,1,0,90000,763,118
"19419","58311","2021",6,6,0,78750,1163.833,77.66667
"19420","58312","2021",6,6,0,90233.33,779.3333,107.8333
"19421","58313","2021",2,2,0,43500,659,67
"19422","59001","2021",9,9,0,217718.3,1641.556,131.3333
"19423","59002","2021",44,44,0,127460.6,1478.455,92.27273
"19424","59003","2021",6,6,0,165883.3,1509.167,112.3333
"19425","59004","2021",13,13,0,285642.3,2357,119.8462
"19426","59005","2021",56,56,0,262002.1,2500.839,105.6786
"19427","59006","2021",2,2,0,180000,1345,136.5
"19428","59007","2021",9,9,0,190855.6,1672.889,115.7778
"19429","59008","2021",115,115,0,113435,1205.148,95.84348
"19430","59009","2021",898,464,434,250848.8,3586.057,75.06236
"19431","59010","2021",4,4,0,170562.5,1259,134
"19432","59011","2021",134,124,10,213285.7,2236.851,98.24627
"19433","59012","2021",52,52,0,109582.7,1106.327,100.0385
"19434","59013","2021",18,18,0,313413.9,3334.611,97.33333
"19435","59014","2021",197,158,39,111012.7,1374.528,85.69036
"19436","59015","2021",46,46,0,167344.8,1666.652,98.65217
"19437","59016","2021",38,38,0,193072.6,1871.605,104.5
"19438","59017","2021",487,352,135,146111.6,1921.057,80.16632
"19439","59018","2021",19,19,0,169913.2,1614.947,111.6842
"19440","59019","2021",14,14,0,184252.9,1643.857,115.4286
"19441","59021","2021",12,12,0,158554.2,1420.5,122.25
"19442","59022","2021",30,30,0,351818.3,2836.1,122.5
"19443","59023","2021",11,11,0,177734.5,1728.455,104.2727
"19444","59024","2021",67,66,1,129661.6,1431.239,92.47761
"19445","59025","2021",13,13,0,359784.6,2819.769,121.3077
"19446","59026","2021",16,16,0,129248.4,1350.812,97.375
"19447","59027","2021",13,13,0,193210.8,2047.846,100.2308
"19448","59028","2021",76,76,0,120479.1,1419.776,86.90789
"19449","59029","2021",19,19,0,328554.5,2663.632,125.7895
"19450","59031","2021",6,6,0,234016.7,2770.667,114
"19451","59032","2021",77,60,17,127095.9,1941.714,79.7013
"19452","59033","2021",92,92,0,113865.2,1200.543,95.43478
"19453","59034","2021",34,32,2,322226.9,3029.471,111.9118
"19454","59035","2021",38,37,1,131475.4,1208.737,105.3421
"19455","59036","2021",46,45,1,102620.7,1006.196,103.3913
"19456","59037","2021",43,43,0,103776.5,1082.628,94.13953
"19457","59038","2021",24,24,0,147172.6,1309.792,112.4167
"19458","59039","2021",11,11,0,207886.4,1949.818,108.2727
"19459","59041","2021",28,28,0,117229.9,1252.5,92.53571
"19460","59042","2021",33,33,0,336707.4,2712.333,126.5758
"19461","59043","2021",231,166,65,206839.8,2312.463,91.06061
"19462","59044","2021",61,56,5,297127.5,2790.721,105.4918
"19463","59045","2021",1,1,0,262000,1724,152
"19464","59046","2021",10,10,0,165287,1396,124.8
"19465","59047","2021",6,6,0,128208.3,934.3333,134.5
"19466","59048","2021",5,5,0,170510,1530,111.8
"19467","59049","2021",6,6,0,94168.83,1199.833,82.66667
"19468","59050","2021",2,2,0,157500,1259.5,122
"19469","59051","2021",104,92,12,158371.6,1942.577,85.56731
"19470","59052","2021",81,81,0,174453,2040.691,87.88889
"19471","59053","2021",48,46,2,158334.3,1502.333,105.9167
"19472","59054","2021",14,14,0,193671.4,2245.571,94.42857
"19473","59055","2021",8,8,0,119367.5,1160.875,109.75
"19474","59056","2021",12,11,1,272458.3,2863.583,96.91667
"19475","59057","2021",6,6,0,145875,1448.167,98.16667
"19476","59058","2021",6,6,0,186366.7,1613.5,118
"19477","59059","2021",6,6,0,71000,740.6667,96.33333
"19478","59060","2021",2,2,0,136000,1365.5,100.5
"19479","59061","2021",7,7,0,124253.6,1255.429,109.5714
"19480","59062","2021",2,2,0,115000,1573,74
"19481","59063","2021",29,28,1,94285.66,1027.931,92.03448
"19482","59064","2021",9,9,0,157936.6,1853.222,87.44444
"19483","59065","2021",5,5,0,182200,1476.8,132.6
"19484","59066","2021",1,1,0,135000,1534,88
"19485","59067","2021",50,39,11,212436.6,2083.26,107.46
"19486","59068","2021",39,38,1,107814.2,1162.308,93.07692
"19487","59069","2021",15,15,0,160260,1560.467,104.8
"19488","59070","2021",1,1,0,239800,2351,102
"19489","59071","2021",29,29,0,332190,2762.828,127.7586
"19490","59072","2021",2,2,0,314000,2597.5,121.5
"19491","59073","2021",8,8,0,262893.8,2519.125,106.25
"19492","59074","2021",39,39,0,111149,1082.872,103.8205
"19493","59075","2021",8,8,0,132406.2,1217,108.375
"19494","59076","2021",5,5,0,102200,792.2,122
"19495","59077","2021",3,3,0,202533.3,1203.667,156
"19496","59078","2021",2,1,1,116500,782,150.5
"19497","59079","2021",62,55,7,119853.4,1426.081,84.29032
"19498","59080","2021",44,44,0,252897.2,2526.136,106.3409
"19499","59081","2021",5,5,0,132250,1205.8,111.2
"19500","59082","2021",23,23,0,185196.9,1974.391,91.86957
"19501","59083","2021",2,2,0,337500,1976,169.5
"19502","59084","2021",15,15,0,193034.5,1704.667,114.2667
"19503","59085","2021",7,7,0,170220,1740.857,100.8571
"19504","59086","2021",30,29,1,220440,2144.167,105.6333
"19505","59087","2021",10,10,0,152025,1527.1,98.2
"19506","59088","2021",23,23,0,355823.9,2755.391,128
"19507","59089","2021",17,17,0,168235.3,1418,131.3529
"19508","59090","2021",145,135,10,504407.7,4141.469,120.3655
"19509","59091","2021",9,9,0,174352.8,1705.444,105.1111
"19510","59092","2021",44,44,0,128718.4,1494.318,87
"19511","59093","2021",3,3,0,93666.67,948.6667,98
"19512","59094","2021",110,106,4,135239.3,1571.327,90.24545
"19513","59096","2021",29,29,0,320512.6,3255.345,100.6552
"19514","59097","2021",7,7,0,114714.3,1125.857,99.57143
"19515","59098","2021",65,64,1,276270.6,2534.231,107.3692
"19516","59099","2021",30,30,0,134189.7,1166.633,114.5667
"19517","59100","2021",6,6,0,229781.7,2057.667,116
"19518","59101","2021",7,7,0,113935.7,1116.143,97.28571
"19519","59102","2021",8,8,0,182725,1328.625,139.75
"19520","59103","2021",5,5,0,207400,2005.8,106.4
"19521","59104","2021",36,35,1,96552.39,1114.861,87.72222
"19522","59105","2021",20,19,1,229391.6,2256.1,113
"19523","59106","2021",15,15,0,330876.7,3108.333,106.7333
"19524","59107","2021",153,64,89,166981,2792.15,67.13725
"19525","59108","2021",10,10,0,119870,1050.1,114.3
"19526","59109","2021",11,11,0,225819.8,2290.818,98.36364
"19527","59110","2021",11,11,0,224631.8,2067.273,111.8182
"19528","59111","2021",5,5,0,130380,1581.2,82.2
"19529","59112","2021",153,153,0,123663.8,1340.49,94.98693
"19530","59113","2021",17,17,0,165415.1,1707.118,99.82353
"19531","59114","2021",27,26,1,234445.1,2161.074,112.4444
"19532","59115","2021",7,7,0,93085.71,1269.714,69.28571
"19533","59116","2021",5,5,0,326070,2209,149
"19534","59117","2021",15,15,0,127007.3,1555.733,85.4
"19535","59118","2021",37,37,0,103458.4,980.0541,106.3514
"19536","59119","2021",3,3,0,272000,1701.667,156
"19537","59120","2021",32,31,1,218489.6,1861.281,111.625
"19538","59121","2021",5,5,0,133580,1242,112
"19539","59122","2021",516,380,136,123605.7,1435.068,87.14535
"19540","59123","2021",24,23,1,247431.2,2513.5,104.3333
"19541","59124","2021",30,30,0,412867.6,3178.7,126.9333
"19542","59125","2021",9,9,0,158627.8,1273.889,126.4444
"19543","59126","2021",15,15,0,191667.5,1839.867,104.9333
"19544","59127","2021",2,2,0,121750,3694,54.5
"19545","59128","2021",25,23,2,364153.6,3380.36,106.72
"19546","59129","2021",30,30,0,308686.6,2681,118.5333
"19547","59130","2021",14,14,0,180021.4,1742.286,103.7143
"19548","59131","2021",87,86,1,163271,1789.115,92.62069
"19549","59132","2021",16,16,0,121842.4,1196,104.4375
"19550","59133","2021",27,25,2,278514.3,2524.296,110.7037
"19551","59134","2021",23,23,0,133890.9,1297.87,102.8261
"19552","59135","2021",30,29,1,160502.3,1582.833,100.3667
"19553","59136","2021",110,101,9,85799.91,960.9273,89.31818
"19554","59137","2021",7,7,0,103511.4,886.7143,128.2857
"19555","59138","2021",17,17,0,118547.2,1169.235,99.58824
"19556","59139","2021",250,221,29,87688.34,1049.56,86.328
"19557","59140","2021",8,8,0,167368.8,1537.375,108
"19558","59141","2021",4,4,0,142825,979.75,152.75
"19559","59142","2021",7,7,0,159781.4,1971.286,87.28571
"19560","59143","2021",139,127,12,219409.1,2334.029,94.26619
"19561","59144","2021",11,10,1,207295.5,1640,134.3636
"19562","59145","2021",8,8,0,304325,2487.25,121.25
"19563","59146","2021",52,49,3,354697.1,3230.673,111.2115
"19564","59148","2021",3,3,0,138666.7,1393.333,98
"19565","59149","2021",18,18,0,145472.2,1202.944,117.1111
"19566","59150","2021",7,7,0,498482.9,3106.571,163.8571
"19567","59151","2021",14,14,0,130103.6,1443.786,88.14286
"19568","59152","2021",154,140,14,228135.7,2372.844,99.18182
"19569","59153","2021",74,69,5,134965.1,1458.784,92.91892
"19570","59155","2021",312,284,28,147581.9,1723.904,86.85256
"19571","59156","2021",36,34,2,153114.7,1682.111,91.86111
"19572","59157","2021",32,31,1,106005,1068.938,100
"19573","59158","2021",45,45,0,273519.2,2509.578,111.5333
"19574","59159","2021",10,10,0,204807,2274,92.3
"19575","59160","2021",43,42,1,116579,1139.023,102.3023
"19576","59161","2021",13,13,0,222220,1895.385,118.2308
"19577","59162","2021",9,9,0,194755.6,1728.333,111.7778
"19578","59163","2021",443,308,135,230469.4,2590.928,85.2009
"19579","59164","2021",1,1,0,85000,773,110
"19580","59165","2021",81,81,0,162753.9,1803.802,90.38272
"19581","59166","2021",16,16,0,273088.6,2191.812,119.625
"19582","59167","2021",3,3,0,311416.7,1516.667,208
"19583","59168","2021",81,72,9,300347.3,2922.753,101.2099
"19584","59169","2021",5,5,0,119144.8,1490.4,83.2
"19585","59170","2021",48,48,0,114740.5,1380.875,83.85417
"19586","59172","2021",217,212,5,79952.65,983.6544,82.93088
"19587","59173","2021",21,21,0,308159.3,2825.952,113.5714
"19588","59174","2021",3,3,0,194826.7,1431,133.3333
"19589","59175","2021",5,5,0,213140,2472.8,88.6
"19590","59176","2021",4,4,0,155887.5,1748.5,86.25
"19591","59177","2021",4,4,0,152189.8,1408.25,95
"19592","59178","2021",544,318,226,139892.4,1704.114,86.50919
"19593","59179","2021",103,101,2,112339,1255.136,91.02913
"19594","59180","2021",18,18,0,302002.8,2339,129.8333
"19595","59181","2021",4,4,0,161375,1343.75,125
"19596","59182","2021",4,4,0,167500,1551.5,109.5
"19597","59183","2021",1264,743,521,160387.3,1909.027,85.24367
"19598","59184","2021",9,9,0,175366.7,1590.556,113.2222
"19599","59185","2021",16,16,0,168388.4,1590.75,102.6875
"19600","59187","2021",2,2,0,132500,1326.5,87.5
"19601","59189","2021",19,19,0,196250,1905.158,107.8947
"19602","59190","2021",11,11,0,193331.5,1771.818,106.3636
"19603","59191","2021",11,11,0,95113.64,941.6364,97.09091
"19604","59192","2021",19,19,0,122838,1255.947,95.05263
"19605","59193","2021",47,46,1,242904.2,2555.489,95.61702
"19606","59194","2021",22,22,0,164209.1,1451.045,115.4545
"19607","59195","2021",7,7,0,296685.7,2862.429,112.2857
"19608","59196","2021",15,15,0,350518.4,3459.133,107.2
"19609","59197","2021",20,20,0,304978.5,2676.65,112.7
"19610","59198","2021",5,4,1,118657.6,1338.4,92.6
"19611","59199","2021",12,12,0,179341.7,1401.667,117.5
"19612","59200","2021",10,10,0,190395,1866,102.1
"19613","59201","2021",6,6,0,326425,3076.833,105.5
"19614","59202","2021",83,71,12,179400.4,2131.217,86.3012
"19615","59203","2021",30,30,0,167293.5,1915.367,94.86667
"19616","59204","2021",5,5,0,135980,1452.2,90.6
"19617","59205","2021",103,102,1,113227.2,1302.515,86.86408
"19618","59206","2021",43,43,0,107089.4,1144.07,95.97674
"19619","59207","2021",34,34,0,96074.09,1156.471,83.26471
"19620","59208","2021",5,5,0,546200,3159.8,166.8
"19621","59209","2021",6,6,0,131666.7,1255,106
"19622","59210","2021",22,22,0,170830.6,1821.091,97.22727
"19623","59211","2021",6,6,0,222654.2,1936.667,113
"19624","59212","2021",87,79,8,197215.5,1930.736,104.2989
"19625","59213","2021",7,7,0,168941.4,1685.571,92.71429
"19626","59214","2021",16,16,0,157405.9,1632.625,96.5625
"19627","59215","2021",10,10,0,308540,2445.2,130.9
"19628","59216","2021",7,7,0,132142.9,1612.714,93.71429
"19629","59217","2021",5,5,0,247710,3337.6,117.6
"19630","59218","2021",15,15,0,129290,1462.733,96.6
"19631","59219","2021",3,3,0,262000,1835.333,139.3333
"19632","59220","2021",289,236,53,201876.5,2471.104,82.82353
"19633","59221","2021",40,25,15,185817.1,1982.6,87.475
"19634","59222","2021",40,40,0,305184.2,2445.95,130.95
"19635","59223","2021",6,6,0,129110,1250.333,104.1667
"19636","59224","2021",26,26,0,134441.9,1571.038,86.96154
"19637","59225","2021",67,67,0,131573.4,1343.687,100.2836
"19638","59226","2021",13,13,0,135084.6,1069.154,126.6154
"19639","59227","2021",59,59,0,144358.5,1525.254,94.71186
"19640","59228","2021",19,19,0,180690.5,1841.158,99.89474
"19641","59229","2021",7,7,0,146030,1248.286,116.2857
"19642","59230","2021",59,56,3,119695.1,1415.932,91.66102
"19643","59231","2021",15,15,0,142616.7,1427.4,104.5333
"19644","59232","2021",7,7,0,281877.9,2433.143,126.4286
"19645","59233","2021",6,6,0,153966.7,1313,118.3333
"19646","59234","2021",66,65,1,148317,1598.833,96.18182
"19647","59236","2021",4,4,0,122250,1203.75,105.25
"19648","59237","2021",11,11,0,245738.2,2290.364,110.3636
"19649","59238","2021",24,24,0,196437.5,1868.958,105.3333
"19650","59239","2021",36,36,0,222055.6,2106.861,109.5
"19651","59241","2021",9,9,0,104139,1060.444,105
"19652","59242","2021",3,3,0,175333.3,1256.667,137
"19653","59243","2021",25,20,5,114011.7,1665.68,85.44
"19654","59244","2021",17,17,0,175738.4,1528.765,125.5882
"19655","59246","2021",11,11,0,86545.45,999.2727,83.36364
"19656","59247","2021",17,17,0,263376.5,2872.765,93.17647
"19657","59249","2021",134,131,3,94889.63,1141.03,88.47761
"19658","59250","2021",35,33,2,291448.7,2717.971,110.7143
"19659","59251","2021",4,4,0,248325,1702.75,135.5
"19660","59252","2021",32,30,2,244423.2,2501.438,96.53125
"19661","59253","2021",83,82,1,109580.3,1133.277,98.56627
"19662","59254","2021",12,12,0,149855,1499.833,100.6667
"19663","59255","2021",7,7,0,146435.7,1123.429,133
"19664","59256","2021",47,44,3,252850,2904.681,90.17021
"19665","59257","2021",18,18,0,359166.7,3089.444,117.7778
"19666","59258","2021",35,35,0,302368.3,2694.086,116.6
"19667","59259","2021",9,9,0,206380.4,1719,117.3333
"19668","59260","2021",58,58,0,192183.3,2136.603,93.65517
"19669","59261","2021",27,26,1,89468.52,944.8148,99.51852
"19670","59262","2021",34,34,0,229876.8,2000.353,118.9118
"19671","59263","2021",16,16,0,201195,1774.812,113.5625
"19672","59264","2021",6,6,0,189835.8,1688.833,106
"19673","59265","2021",31,31,0,218022.3,1708.452,129.6129
"19674","59266","2021",60,59,1,270188.2,2468.933,110.9167
"19675","59267","2021",4,4,0,155750,953.5,161
"19676","59268","2021",82,77,5,158874.3,1772.963,91.12195
"19677","59269","2021",16,16,0,137189,1442.375,96.5625
"19678","59270","2021",4,4,0,151575,1125.5,138.25
"19679","59271","2021",102,93,9,139817.3,1497.814,94.5
"19680","59272","2021",87,86,1,123131.2,1603.046,82.48276
"19681","59273","2021",148,129,19,164849.9,1822.642,89.88514
"19682","59274","2021",5,5,0,117460,1045.4,108.4
"19683","59275","2021",17,17,0,600650.3,3967.471,148.6471
"19684","59276","2021",30,30,0,145903.4,1544.7,94.76667
"19685","59277","2021",2,2,0,291450,2779,110.5
"19686","59278","2021",80,71,9,235960.7,2598.037,90.6
"19687","59279","2021",301,264,37,192238.1,2225.757,85.59468
"19688","59280","2021",6,6,0,163000,1569.667,106.5
"19689","59281","2021",20,20,0,238603,2531.7,95.7
"19690","59282","2021",8,8,0,198095,1497.5,130.125
"19691","59283","2021",5,5,0,213085,2012.6,112.8
"19692","59284","2021",62,58,4,174631.5,1712.613,101.6935
"19693","59285","2021",46,46,0,135652.4,1473.37,94.08696
"19694","59286","2021",230,172,58,186275.9,2307.683,81.81304
"19695","59287","2021",4,4,0,132815,1175.25,119.25
"19696","59288","2021",26,26,0,138543.3,1372.577,98.19231
"19697","59289","2021",27,27,0,127622.8,1189.519,107.3333
"19698","59290","2021",3,3,0,155666.7,1636.333,89
"19699","59291","2021",145,141,4,99846.59,1140.007,89.57241
"19700","59292","2021",28,28,0,112335,1266.393,88.25
"19701","59293","2021",23,23,0,201515.2,1949.783,100.5652
"19702","59294","2021",3,3,0,153766.7,1090.333,132.6667
"19703","59295","2021",305,263,42,178383.3,1947.279,92.21967
"19704","59296","2021",12,12,0,204686.7,1818,112
"19705","59297","2021",36,36,0,147067.6,1455.083,100.6944
"19706","59299","2021",198,189,9,313481.3,2865.308,105.3333
"19707","59300","2021",5,5,0,172750,1526,114
"19708","59301","2021",49,48,1,169060,1685.633,103.5714
"19709","59302","2021",42,41,1,128024.6,1506.548,86.14286
"19710","59303","2021",25,25,0,337469,3332.92,109
"19711","59304","2021",2,2,0,625077.5,2657,237.5
"19712","59305","2021",22,22,0,209678.2,1869.864,114.6818
"19713","59306","2021",2,2,0,213250,1930,112
"19714","59307","2021",10,10,0,138451,1572.5,89.7
"19715","59308","2021",11,11,0,279736.4,2347.727,117.0909
"19716","59309","2021",41,41,0,176686,1592.976,112.8537
"19717","59310","2021",11,11,0,200743.6,1670.273,137
"19718","59311","2021",10,10,0,99002,1056.8,98.1
"19719","59312","2021",12,12,0,118571,1130.583,100.0833
"19720","59313","2021",15,15,0,164476.7,1614.267,104.2
"19721","59314","2021",34,34,0,161819.1,1578.735,102.5588
"19722","59315","2021",5,5,0,116760,1126,94.4
"19723","59316","2021",47,47,0,272350.4,2584.383,103.766
"19724","59317","2021",126,124,2,171315.2,2164.548,78.07143
"19725","59318","2021",17,17,0,202835.9,1769.824,116.7647
"19726","59319","2021",34,34,0,226016.5,2045.882,113.2059
"19727","59320","2021",20,20,0,259782.4,2288.5,112.05
"19728","59321","2021",14,14,0,88225,919.7857,96.57143
"19729","59322","2021",38,36,2,136405.9,1471.789,97.81579
"19730","59323","2021",17,17,0,240006.5,1864.765,125.8235
"19731","59324","2021",102,100,2,109914.4,1260.52,89.47059
"19732","59325","2021",10,10,0,190435,1888.7,103.7
"19733","59326","2021",11,11,0,164178.4,1681.182,95.45455
"19734","59327","2021",67,66,1,150946.8,1751.284,88.34328
"19735","59328","2021",511,325,186,308371,3524.448,86.3092
"19736","59329","2021",56,54,2,177346.4,1752.786,100.4643
"19737","59330","2021",24,24,0,291679.8,2495.417,113.125
"19738","59331","2021",37,37,0,118943.9,1299.568,111.7297
"19739","59332","2021",39,24,15,130407.1,1878.641,70.89744
"19740","59333","2021",1,1,0,170000,756,225
"19741","59334","2021",26,25,1,158445,1657.538,97.61538
"19742","59335","2021",35,33,2,305821.9,2323.2,134
"19743","59336","2021",34,34,0,119056.8,1212.059,97.58824
"19744","59337","2021",6,6,0,218583.3,2103.167,110.5
"19745","59338","2021",6,6,0,192908.3,1903.167,100.8333
"19746","59339","2021",112,104,8,258070,2606.491,101.4643
"19747","59340","2021",66,53,13,225338.5,2394.758,93.25758
"19748","59341","2021",7,6,1,107867.9,912.5714,126.5714
"19749","59342","2021",6,6,0,137983.3,1413.833,98.16667
"19750","59343","2021",118,108,10,304114.8,3127.466,98.26271
"19751","59344","2021",31,31,0,114361.1,1253.226,90.77419
"19752","59345","2021",38,37,1,140658.8,1458,97.47368
"19753","59346","2021",47,47,0,261979.8,2885.83,94.59574
"19754","59347","2021",9,9,0,86283.44,997.5556,87.66667
"19755","59348","2021",16,16,0,157256.2,1541,102.875
"19756","59349","2021",23,23,0,126443,1187.391,111.6087
"19757","59350","2021",4476,1165,3311,217044.2,3628.31,63.94482
"19758","59351","2021",6,6,0,206700,1673,128
"19759","59352","2021",145,112,33,315896.8,3026.276,102.3931
"19760","59353","2021",8,8,0,201336.2,1634,111
"19761","59354","2021",10,10,0,182365.2,1719.9,105.1
"19762","59356","2021",25,25,0,443455.7,3291.08,135.4
"19763","59357","2021",26,26,0,161873.1,1709.731,97.61538
"19764","59358","2021",13,13,0,170315.4,1641.077,111.1538
"19765","59359","2021",90,89,1,184313.5,1854.644,99.61111
"19766","59360","2021",379,210,169,178626.3,2596.05,70.48021
"19767","59361","2021",51,51,0,89634.92,1071.961,86.33333
"19768","59363","2021",9,9,0,206236.7,1587.333,129.4444
"19769","59364","2021",10,10,0,379833,3385.3,111.2
"19770","59365","2021",71,58,13,91416.24,1136.282,77.74648
"19771","59366","2021",6,6,0,255140,2191,130.6667
"19772","59367","2021",225,173,52,193794.2,2303.187,85.12444
"19773","59368","2021",551,192,359,272057.6,3481.065,77.47731
"19774","59369","2021",45,45,0,162855.3,1573.267,107.0667
"19775","59370","2021",8,7,1,153818.8,1610.25,98.25
"19776","59371","2021",6,6,0,326242.7,2739.333,119.5
"19777","59372","2021",11,11,0,95072.73,1132.364,87.09091
"19778","59374","2021",3,3,0,209505.7,1252.667,159.6667
"19779","59375","2021",65,65,0,183572.8,1912.215,96.6
"19780","59377","2021",23,23,0,141541.1,1370.957,109.0435
"19781","59378","2021",748,415,333,338754,3671.63,89.86364
"19782","59379","2021",4,4,0,211387.5,2071.75,104
"19783","59381","2021",10,10,0,241906,1835.2,137.6
"19784","59382","2021",17,17,0,106770.6,904.7647,120.5882
"19785","59383","2021",176,137,39,136574.2,2235,77.02841
"19786","59384","2021",22,22,0,119810,1265,93.31818
"19787","59385","2021",39,38,1,97122.64,1081.538,88.82051
"19788","59386","2021",173,139,34,252205.8,3112.919,82.43931
"19789","59387","2021",20,20,0,107877.1,1378.1,84.9
"19790","59388","2021",31,31,0,227712.9,2055.903,114.4194
"19791","59389","2021",46,46,0,118858.2,1260.87,94.26087
"19792","59390","2021",29,29,0,126125.3,1470.931,83.89655
"19793","59391","2021",9,9,0,156738.9,1306.444,114.6667
"19794","59392","2021",364,269,95,97710.72,1203.478,84.75275
"19795","59393","2021",15,15,0,193677.4,2002.133,108.1333
"19796","59394","2021",11,11,0,88871.82,827.6364,121.5455
"19797","59395","2021",7,7,0,92964.43,1095.571,89.42857
"19798","59396","2021",11,11,0,208911.8,1574,128.5455
"19799","59397","2021",5,5,0,138510,1453.2,87.2
"19800","59398","2021",60,58,2,523641,3502.883,151.0167
"19801","59399","2021",11,11,0,234990.8,2348.545,104.8182
"19802","59400","2021",139,129,10,157490.5,1647.626,96.26619
"19803","59401","2021",27,26,1,243038.3,2275.667,108.037
"19804","59402","2021",8,8,0,194981.2,1546.5,124.75
"19805","59403","2021",7,7,0,195349.3,1940,102.8571
"19806","59405","2021",4,4,0,132725,1735,75.75
"19807","59406","2021",7,7,0,118085.7,1119.286,111.5714
"19808","59407","2021",6,6,0,194683.3,1436,121.1667
"19809","59408","2021",24,24,0,288960.4,2092.458,136.1667
"19810","59409","2021",38,38,0,130993.6,1387.763,95.26316
"19811","59410","2021",248,130,118,182522.7,2392.202,74.2621
"19812","59411","2021",47,47,0,315774.6,2750,116.8298
"19813","59412","2021",7,7,0,98214.29,987.8571,94.42857
"19814","59413","2021",6,6,0,126400,1250.333,105
"19815","59414","2021",38,37,1,166493.9,1836.368,94.39474
"19816","59415","2021",6,6,0,139440,1333.833,105.1667
"19817","59416","2021",35,35,0,178828,1752.086,101.6286
"19818","59418","2021",15,15,0,146086.7,1481.2,102.6
"19819","59419","2021",22,22,0,280564.3,2463.182,115.8182
"19820","59420","2021",1,1,0,180000,698,258
"19821","59421","2021",245,193,52,361259.5,3436.18,100.3959
"19822","59422","2021",8,8,0,169762.5,1607.625,111.625
"19823","59423","2021",23,23,0,199136,1887.783,102.5652
"19824","59424","2021",15,13,2,98778.67,992.9333,100.6667
"19825","59425","2021",4,4,0,229625,2048.5,113.75
"19826","59426","2021",152,138,14,248136.3,2605.053,96.38816
"19827","59427","2021",7,7,0,313921.4,2731.714,117.4286
"19828","59428","2021",55,55,0,131064.9,1440.673,97.01818
"19829","59429","2021",39,39,0,124757.7,1288.179,95.10256
"19830","59430","2021",27,27,0,115800.2,1219.333,101.037
"19831","59431","2021",102,99,3,244042.7,2253.794,106.6667
"19832","59432","2021",3,3,0,123333.3,1013,112.3333
"19833","59433","2021",19,19,0,179389.5,1703.211,103.3158
"19834","59434","2021",18,18,0,268549.4,2127.333,125.1667
"19835","59435","2021",35,35,0,272990.9,2243.2,122
"19836","59436","2021",9,8,1,181106.7,1574.333,118.2222
"19837","59437","2021",13,13,0,348399.2,2822.538,121.6923
"19838","59438","2021",6,6,0,177733.3,1116.5,150.1667
"19839","59439","2021",5,5,0,139400,1133,111.6
"19840","59440","2021",4,4,0,101375,1300.5,77.75
"19841","59441","2021",6,6,0,210416.7,1846.833,107
"19842","59442","2021",2,2,0,187500,1272.5,146.5
"19843","59443","2021",4,4,0,160492.5,1500.25,110.5
"19844","59444","2021",13,13,0,159051.5,1488.231,110
"19845","59445","2021",8,8,0,180416.5,1795,105
"19846","59446","2021",8,8,0,249162.5,2210.75,111.375
"19847","59447","2021",114,113,1,119420.8,1289.175,90.67544
"19848","59448","2021",5,5,0,171330,1613.6,107.6
"19849","59449","2021",120,105,15,195565.2,2286.292,89.875
"19850","59450","2021",9,9,0,116044.4,1040.667,110.2222
"19851","59451","2021",7,7,0,239003,2029.143,125.2857
"19852","59452","2021",56,56,0,173615.6,1731.804,100.3393
"19853","59453","2021",8,8,0,234880,2373.75,104.25
"19854","59454","2021",11,8,3,206125.1,1611,121.4545
"19855","59455","2021",17,17,0,157441.2,1385.647,115.2353
"19856","59456","2021",57,54,3,137610,1592.228,86.75439
"19857","59457","2021",138,117,21,239459.2,2699.855,91.49275
"19858","59458","2021",24,24,0,318420.8,2811.917,117.6667
"19859","59459","2021",64,58,6,151106.4,1636.281,91.71875
"19860","59461","2021",3,3,0,132000,1086,131
"19861","59462","2021",62,51,11,236194,2639.726,90.06452
"19862","59463","2021",17,17,0,193741.2,1789.412,110.5294
"19863","59464","2021",38,38,0,134843.9,1242.237,107.7368
"19864","59465","2021",10,10,0,92776,1023.4,85.2
"19865","59466","2021",50,39,11,266390.9,2834.66,96.16
"19866","59467","2021",27,27,0,106616.7,1109.037,102.1481
"19867","59468","2021",3,3,0,364411.7,2659,131.3333
"19868","59469","2021",4,4,0,329240,2690,123.75
"19869","59470","2021",37,33,4,310230.4,2895.054,110.0811
"19870","59471","2021",37,37,0,168808.1,1721.27,98.7027
"19871","59472","2021",13,13,0,116618.5,1005.692,113.1538
"19872","59473","2021",7,7,0,168285.7,1516.286,121.4286
"19873","59474","2021",10,10,0,116200,1025.7,115.6
"19874","59475","2021",22,21,1,168838.2,1797.409,93.54545
"19875","59476","2021",42,40,2,189575.7,1828.119,100.5952
"19876","59477","2021",64,60,4,202990.9,2165.031,93.75
"19877","59478","2021",14,14,0,218779.9,1919.714,113
"19878","59479","2021",40,40,0,156555.9,1689.125,95.025
"19879","59480","2021",16,16,0,208886.2,1917.312,106.6875
"19880","59481","2021",71,71,0,146744.9,1372.366,105.9155
"19881","59482","2021",70,66,4,292413.2,2849.629,102.9571
"19882","59483","2021",3,3,0,150666.7,1487.333,102
"19883","59484","2021",62,57,5,111414.5,1243.097,89.70968
"19884","59485","2021",25,25,0,98148.4,965.56,100.52
"19885","59486","2021",38,38,0,162373.9,1717.895,96.02632
"19886","59487","2021",25,23,2,458514.4,3667.84,127.36
"19887","59488","2021",43,40,3,132156.2,1381.884,95.34884
"19888","59489","2021",43,43,0,199327.1,1787.372,113.6279
"19889","59490","2021",2,2,0,175000,1650.5,105.5
"19890","59491","2021",134,133,1,124526.9,1399.246,90.74627
"19891","59492","2021",6,6,0,130050,1620.5,80.33333
"19892","59493","2021",1,1,0,87000,551,158
"19893","59494","2021",4,4,0,162652.8,1595.5,103.25
"19894","59495","2021",24,24,0,136001,1454.958,93.79167
"19895","59496","2021",2,2,0,110000,1265.5,87
"19896","59497","2021",40,40,0,170770.6,1639.8,105.9
"19897","59498","2021",5,5,0,88100,1048,89.2
"19898","59499","2021",23,23,0,174448.6,1691.435,104.8261
"19899","59500","2021",5,5,0,134500,1185.8,115.8
"19900","59501","2021",22,22,0,186004.5,1850,103.9545
"19901","59502","2021",15,15,0,102853.3,1340.933,85.46667
"19902","59503","2021",2,2,0,141000,1485.5,85
"19903","59504","2021",45,45,0,125088.6,1357.8,93.28889
"19904","59505","2021",7,7,0,217004.3,2177.571,102.1429
"19905","59506","2021",7,7,0,162648.9,1233,134.4286
"19906","59507","2021",333,220,113,191947.2,2505.505,79.75976
"19907","59508","2021",207,178,29,280809.7,2779.778,100.4541
"19908","59509","2021",64,63,1,162629.5,1670.375,96.25
"19909","59511","2021",35,35,0,275858.1,2505.629,109.7714
"19910","59512","2021",1222,814,408,143077.3,1768.456,86.34615
"19911","59513","2021",1,1,0,273000,2874,95
"19912","59514","2021",61,54,7,127484.6,1314.525,94.59016
"19913","59515","2021",4,4,0,148250,1788.5,80.75
"19914","59516","2021",12,12,0,157251.7,1712.5,92.08333
"19915","59517","2021",10,10,0,179470,1568,126.8
"19916","59518","2021",3,3,0,186666.7,1656.667,116.6667
"19917","59519","2021",23,22,1,257266.1,2325.609,113.7826
"19918","59520","2021",14,14,0,129700,1334.714,101.2857
"19919","59521","2021",6,6,0,132333.3,1358.167,97.33333
"19920","59522","2021",30,30,0,426599.1,3448.733,127.7
"19921","59523","2021",31,31,0,407755.4,3452.419,116.8065
"19922","59524","2021",92,85,7,215176.2,2347.304,91.96739
"19923","59525","2021",41,41,0,89112.44,979.2927,90.29268
"19924","59526","2021",220,209,11,169852,1784.977,95.52727
"19925","59527","2021",235,130,105,237746.1,3238.813,73.22979
"19926","59528","2021",24,24,0,127075,1188.792,110.375
"19927","59529","2021",4,4,0,244775,1638.5,154.5
"19928","59530","2021",4,4,0,119711.2,1493.75,82.5
"19929","59531","2021",8,8,0,125962.5,1480.875,84.125
"19930","59532","2021",3,3,0,231666.7,2390.333,95.33333
"19931","59533","2021",31,30,1,106974.2,1103.258,98.03226
"19932","59534","2021",10,10,0,115894.4,1206.3,103.5
"19933","59535","2021",21,21,0,235135,2307.619,102.4286
"19934","59536","2021",9,9,0,271869.8,1948.222,139.4444
"19935","59537","2021",8,8,0,137743.8,1326,102.375
"19936","59538","2021",4,4,0,171925,2436.5,72.25
"19937","59539","2021",8,8,0,163817.5,1525.75,106.875
"19938","59541","2021",14,14,0,109357.1,1087.071,102.0714
"19939","59542","2021",8,8,0,136062.5,1200.25,111.875
"19940","59543","2021",13,13,0,129863.1,1229.538,113.4615
"19941","59544","2021",154,114,40,169858.4,1863.779,90.84416
"19942","59545","2021",17,17,0,87194.12,1079.176,83.88235
"19943","59546","2021",29,29,0,205001.4,1724.966,119.2759
"19944","59547","2021",15,15,0,96235,1152.8,81.4
"19945","59548","2021",7,7,0,189475,2021.143,95
"19946","59549","2021",5,5,0,211912.2,1374.4,141.6
"19947","59550","2021",47,47,0,177066.6,1987.894,88.21277
"19948","59551","2021",23,23,0,293068.3,2363.522,126.6957
"19949","59552","2021",4,4,0,216337.5,1813,118.25
"19950","59553","2021",69,69,0,343649.3,2741.536,123.8261
"19951","59554","2021",3,3,0,334500,2425,135
"19952","59555","2021",10,10,0,101450.2,1118.1,106
"19953","59556","2021",1,1,0,95000,841,113
"19954","59557","2021",39,31,8,164240.5,2063.897,79.12821
"19955","59558","2021",20,20,0,147185,1302.85,109.65
"19956","59559","2021",35,35,0,264617.4,2136.971,123.1429
"19957","59560","2021",177,129,48,201067.9,2553.695,80.90395
"19958","59562","2021",2,2,0,100250,1297,73.5
"19959","59563","2021",4,4,0,128750,1402.75,90.25
"19960","59564","2021",33,26,7,132869.2,1557.091,87.27273
"19961","59565","2021",2,2,0,144775,1367,117
"19962","59566","2021",62,57,5,245756.3,2864.774,86.62903
"19963","59567","2021",7,7,0,247385.7,1717.143,160.8571
"19964","59568","2021",5,5,0,182820,1414.2,134.2
"19965","59569","2021",200,172,28,118165,1304.07,87.75
"19966","59570","2021",7,7,0,254528.6,1832.286,141.5714
"19967","59571","2021",81,79,2,97886.25,1024.062,93.33333
"19968","59572","2021",24,24,0,101391.7,905.125,108.4583
"19969","59573","2021",2,2,0,194156.5,1339,174
"19970","59574","2021",152,140,12,133557.5,1410.296,95.36184
"19971","59575","2021",2,2,0,187325,2115.5,92.5
"19972","59576","2021",18,18,0,215838.3,2133.111,102.6111
"19973","59577","2021",13,13,0,213746.2,2066.615,106.7692
"19974","59578","2021",21,21,0,207101,1903.048,110.7619
"19975","59579","2021",23,23,0,191087,1764.696,109.7391
"19976","59580","2021",56,55,1,190829.4,2121.018,96.94643
"19977","59581","2021",35,34,1,224724.3,2343.686,99.11429
"19978","59582","2021",12,12,0,208787.5,2047.083,110
"19979","59583","2021",6,6,0,105200,1377.833,78.33333
"19980","59584","2021",12,12,0,131275,1263.167,103.4167
"19981","59585","2021",47,38,9,235436.8,2634.468,91.91489
"19982","59586","2021",97,90,7,283803.7,2901.495,97.94845
"19983","59587","2021",6,6,0,200458.3,1788.167,106.1667
"19984","59588","2021",98,96,2,279910.6,2499.959,116.4286
"19985","59589","2021",39,39,0,148362.8,1579.795,92.20513
"19986","59590","2021",12,12,0,154562.5,1480.417,106.9167
"19987","59591","2021",4,4,0,191752.5,1600.75,127.5
"19988","59592","2021",59,59,0,220857.1,2196.966,104.2712
"19989","59593","2021",6,6,0,294083.3,1982.333,154.3333
"19990","59594","2021",15,15,0,196716.7,1967.4,102.8667
"19991","59595","2021",4,4,0,131137.5,1307,101.25
"19992","59596","2021",9,9,0,335616.7,2499.333,135.1111
"19993","59597","2021",10,10,0,185028,1922.7,90.8
"19994","59598","2021",49,49,0,263222.5,2559.122,104.3673
"19995","59599","2021",1586,1090,496,152816.1,1856.446,83.1652
"19996","59600","2021",10,10,0,474321,3576,132.9
"19997","59601","2021",20,17,3,107564.5,988,110.7
"19998","59602","2021",22,21,1,354269.5,2789.409,121.1364
"19999","59603","2021",78,71,7,116760.6,1358.603,87.61538
"20000","59604","2021",14,14,0,115142.9,1103.786,111.8571
"20001","59605","2021",21,21,0,210930.5,1925.762,122.619
"20002","59606","2021",838,386,452,139207.1,1897.636,76.37112
"20003","59607","2021",5,5,0,148574,1344.8,118.2
"20004","59608","2021",23,23,0,163950,1466.348,109.087
"20005","59609","2021",29,24,5,272659.3,2929.103,94.82759
"20006","59610","2021",15,15,0,175052.7,1834.6,100.2
"20007","59611","2021",36,36,0,397454.8,3617.472,116.0833
"20008","59612","2021",12,12,0,158870.8,1290.833,134.0833
"20009","59613","2021",18,18,0,164848.9,1537.778,106.2222
"20010","59614","2021",28,28,0,87432.14,951.2857,96
"20011","59615","2021",38,38,0,253223.7,2060.763,127.2368
"20012","59616","2021",119,118,1,128816.8,1365.849,96.54622
"20013","59617","2021",3,3,0,239367.3,1805.333,132
"20014","59618","2021",9,9,0,141738.9,1370.111,103.8889
"20015","59619","2021",8,8,0,252506.2,1788,156.625
"20016","59620","2021",11,11,0,149076.4,1511.909,103.6364
"20017","59622","2021",9,9,0,118021.1,1149.667,108.6667
"20018","59623","2021",9,9,0,135965.6,1395.333,100.3333
"20019","59624","2021",29,29,0,122640.6,1055.276,114.5172
"20020","59625","2021",6,6,0,90679.17,1190.833,77.5
"20021","59626","2021",17,17,0,238190.9,1961.882,128.3529
"20022","59627","2021",8,8,0,110500,1212.5,97
"20023","59628","2021",6,6,0,159425.8,1715.5,91.83333
"20024","59629","2021",20,20,0,170629.5,1722.75,105.5
"20025","59630","2021",37,37,0,201723,2404.946,87.62162
"20026","59631","2021",36,36,0,79979.61,902.8611,89.47222
"20027","59632","2021",52,51,1,166367.1,1571.462,104.2115
"20028","59633","2021",4,4,0,135200,1122,126
"20029","59634","2021",9,9,0,182708.4,1638.333,114.5556
"20030","59635","2021",4,4,0,238625,1469,170.75
"20031","59636","2021",178,138,40,339072,3446.281,97.53371
"20032","59637","2021",18,18,0,157450.3,1651.5,93.44444
"20033","59638","2021",20,20,0,290859.5,3170.25,92.9
"20034","59639","2021",12,12,0,195705.8,1857,109.8333
"20035","59640","2021",9,9,0,179372.6,1990.556,90.88889
"20036","59641","2021",39,39,0,204026.4,1862.487,111.9231
"20037","59642","2021",4,4,0,176750,1483.25,121.5
"20038","59643","2021",3,3,0,325466.7,2835,114
"20039","59645","2021",9,9,0,118311.1,1325.222,94.44444
"20040","59646","2021",386,303,83,301492.7,3214.324,92.33679
"20041","59647","2021",38,38,0,123537.3,1253.816,97.65789
"20042","59648","2021",201,116,85,187226,2202.896,82.49254
"20043","59649","2021",2,2,0,198500,1548.5,148
"20044","59650","2021",579,539,40,161939.6,1979.902,83.69948
"20045","59651","2021",32,32,0,96979.69,1156.5,83.90625
"20046","59652","2021",4,4,0,118000,1327.75,87.5
"20047","59653","2021",102,97,5,224911.6,2517.667,90.5098
"20048","59654","2021",78,76,2,121298.5,1454.5,86.92308
"20049","59656","2021",96,58,38,243981.4,2981.781,85.01042
"20050","59657","2021",9,9,0,218587.2,1901.111,114.1111
"20051","59658","2021",4,4,0,268750,2270.25,113.75
"20052","59659","2021",36,36,0,96547.53,1010.917,93.88889
"20053","59660","2021",40,40,0,340888.9,3167.925,108.8
"20054","59662","2021",16,16,0,182319.1,2155.562,92.5625
"20055","59663","2021",72,65,7,204923.8,1971.736,108.4861
"20056","59664","2021",6,6,0,151933.3,1423,105.5
"20057","59665","2021",6,6,0,192516.7,1814,108
"20058","59666","2021",14,14,0,225771.4,1933.286,120.9286
"20059","59667","2021",1,1,0,152000,1206,126
"20060","59668","2021",20,15,5,237016,2631.95,91.9
"20061","59669","2021",15,15,0,196620,1653.933,119
"20062","59670","2021",21,21,0,234329.3,2280.571,108.9048
"20063","60001","2021",9,9,0,117082.1,1361.778,93.77778
"20064","60002","2021",12,12,0,239565,2375.667,107.8333
"20065","60003","2021",5,5,0,260947,2163.8,120.8
"20066","60004","2021",6,6,0,277756.7,2788.167,95.5
"20067","60005","2021",25,24,1,199956.4,2174.04,100.6
"20068","60006","2021",15,14,1,200210,2616.267,77.33333
"20069","60007","2021",30,29,1,228027.4,2345.2,98.3
"20070","60008","2021",10,10,0,222977.5,1731.8,121.7
"20071","60009","2021",17,17,0,206294.1,2154.471,99.58824
"20072","60010","2021",33,31,2,252543.5,2807.303,93.63636
"20073","60011","2021",5,5,0,132600,1501.2,94.4
"20074","60012","2021",68,64,4,224665.9,2639.044,91.44118
"20075","60013","2021",17,17,0,274929.9,2427,126.4706
"20076","60015","2021",23,19,4,185171.7,2043.522,94.30435
"20077","60016","2021",3,2,1,203333.3,2372.667,91
"20078","60017","2021",22,22,0,137340.9,1547.591,93.18182
"20079","60019","2021",5,5,0,230080,1870.4,125.4
"20080","60020","2021",3,3,0,257233.3,2068.333,133.3333
"20081","60021","2021",6,6,0,88098.17,868,103.1667
"20082","60022","2021",8,8,0,390550,3115.875,134.875
"20083","60024","2021",14,13,1,196328.6,2061.143,100.5714
"20084","60025","2021",23,23,0,180899.1,1847.783,103.6087
"20085","60026","2021",7,7,0,174857.1,1990,93.28571
"20086","60027","2021",4,4,0,290434.5,3032.25,100.5
"20087","60028","2021",10,9,1,481817,3875,133.9
"20088","60029","2021",26,25,1,188215.4,2203.654,85.84615
"20089","60030","2021",11,11,0,217118.2,2126.545,103.1818
"20090","60031","2021",4,4,0,268669.5,2020.75,157.25
"20091","60032","2021",17,17,0,169882.4,1747.176,103.4706
"20092","60033","2021",12,12,0,477309.2,5559.25,94.83333
"20093","60034","2021",18,17,1,191627.8,1912.222,103.2222
"20094","60035","2021",2,2,0,83400,1057,78.5
"20095","60036","2021",4,4,0,184591,2059.75,94.75
"20096","60037","2021",4,4,0,109475,1451.5,69.75
"20097","60039","2021",3,3,0,104166.7,889.3333,114
"20098","60040","2021",12,12,0,225416.7,2207.167,102.25
"20099","60041","2021",17,17,0,184466.2,2071.647,91.29412
"20100","60042","2021",28,28,0,230946.4,2583.25,92.60714
"20101","60043","2021",4,4,0,138350,1638.75,85
"20102","60044","2021",32,31,1,171287.1,2296.438,80.375
"20103","60045","2021",5,3,2,307430,2872,106.8
"20104","60046","2021",4,4,0,221750,2101,107
"20105","60047","2021",7,7,0,341517,2779.571,124.5714
"20106","60048","2021",4,4,0,178140,1804.75,104.5
"20107","60049","2021",3,3,0,130000,1186.667,106.6667
"20108","60050","2021",8,8,0,260750,2842.25,92
"20109","60051","2021",1,1,0,120100,1092,110
"20110","60052","2021",1,1,0,285000,1875,152
"20111","60053","2021",6,6,0,134083.3,1244.333,112.8333
"20112","60054","2021",10,10,0,204635,1805.3,117.8
"20113","60055","2021",4,4,0,130675,1192,125.75
"20114","60057","2021",739,315,424,143726.8,1958.069,74.26522
"20115","60058","2021",4,4,0,103750,1631,63
"20116","60059","2021",4,4,0,97850,1557.25,64
"20117","60060","2021",14,13,1,302110.7,2795.786,108.8571
"20118","60061","2021",3,3,0,211300,1865.667,112.3333
"20119","60063","2021",22,22,0,228600,2301,102.9545
"20120","60064","2021",15,15,0,200466.7,2280.533,92.06667
"20121","60065","2021",20,20,0,225606.2,2406.95,97.7
"20122","60066","2021",4,4,0,209750,2392.5,103
"20123","60067","2021",23,21,2,218535.7,2471.609,92.04348
"20124","60068","2021",54,47,7,172625.6,2137.13,82.53704
"20125","60069","2021",20,15,5,255585,2520.7,107.25
"20126","60070","2021",4,4,0,365250,2392.5,149
"20127","60071","2021",1,1,0,2e+05,2062,97
"20128","60072","2021",7,7,0,218235.7,1528.714,135.8571
"20129","60073","2021",11,11,0,119142.7,1476.091,87.54545
"20130","60074","2021",14,13,1,298122.1,2945.429,106
"20131","60075","2021",3,3,0,95266.67,1125.667,81.33333
"20132","60076","2021",6,6,0,160466.7,1414,123.3333
"20133","60077","2021",4,4,0,226445,1809,131.5
"20134","60078","2021",1,1,0,80000,2500,32
"20135","60079","2021",12,12,0,261370.8,2653.75,103.1667
"20136","60081","2021",2,2,0,257000,2041.5,128
"20137","60082","2021",9,9,0,177003.3,1534.222,113.5556
"20138","60083","2021",18,18,0,152635.6,2080.222,74.05556
"20139","60084","2021",3,3,0,197333.3,1591,124.3333
"20140","60085","2021",1,1,0,113000,1378,82
"20141","60086","2021",28,22,6,276197.5,2702.179,105.5714
"20142","60087","2021",5,5,0,254073.4,2913.2,86.4
"20143","60088","2021",76,66,10,249895.9,2987.039,88.64474
"20144","60089","2021",12,12,0,282825,2565.833,111.6667
"20145","60090","2021",2,2,0,387532.5,4421,89
"20146","60091","2021",5,5,0,308200,2820.2,113.4
"20147","60092","2021",1,1,0,240000,1538,156
"20148","60093","2021",7,7,0,221714.3,1917.857,108.8571
"20149","60094","2021",8,8,0,215268.1,1977.5,114.5
"20150","60095","2021",2,2,0,435615,3294,128
"20151","60097","2021",3,3,0,305233.3,1908.333,169.3333
"20152","60098","2021",5,5,0,84500,881.2,89.8
"20153","60099","2021",4,4,0,215750,2451.5,88.5
"20154","60100","2021",2,2,0,702125,3439,192.5
"20155","60101","2021",17,17,0,231972.4,2529.588,94.05882
"20156","60102","2021",22,22,0,204965.5,2358.273,89.86364
"20157","60103","2021",35,35,0,169946.6,2117.286,89.42857
"20158","60104","2021",71,70,1,142359.9,1544.901,94.61972
"20159","60105","2021",4,4,0,142625,1328.25,106.25
"20160","60106","2021",28,23,5,170006.7,2125.071,83.21429
"20161","60107","2021",45,39,6,200563,2305.822,89.95556
"20162","60108","2021",6,6,0,148169.2,1490.167,107.8333
"20163","60109","2021",1,1,0,215095,1582,136
"20164","60110","2021",3,3,0,139000,1996.333,72.66667
"20165","60111","2021",2,2,0,134750,771.5,153
"20166","60112","2021",4,4,0,166500,2070.5,85.5
"20167","60113","2021",7,7,0,204035.7,2292.714,98.28571
"20168","60114","2021",2,2,0,179700,1857.5,97
"20169","60115","2021",15,15,0,151284.1,1349.4,116.4
"20170","60116","2021",50,47,3,190710.5,2185.76,92.9
"20171","60117","2021",4,4,0,148500,1343.25,111.5
"20172","60118","2021",4,4,0,165600,1487.75,117.25
"20173","60119","2021",11,11,0,166090.9,1727,94.63636
"20174","60120","2021",18,18,0,189644.4,2003.611,101.7778
"20175","60122","2021",16,16,0,140468.8,1386.375,107.25
"20176","60123","2021",9,9,0,114500,1369.667,94.11111
"20177","60124","2021",6,6,0,149416.7,1388,112.3333
"20178","60125","2021",13,13,0,200561.5,2152.923,96.30769
"20179","60126","2021",2,2,0,223185,1401.5,157
"20180","60127","2021",6,6,0,138833.3,1479.833,90.16667
"20181","60128","2021",5,5,0,156900,1351.8,114.8
"20182","60129","2021",21,21,0,150870.5,1576.524,94.90476
"20183","60130","2021",12,12,0,199750,2245.333,90.75
"20184","60131","2021",1,1,0,115000,1438,80
"20185","60132","2021",5,5,0,138830,1267.2,112.6
"20186","60133","2021",9,9,0,171026.7,1671.111,103.8889
"20187","60134","2021",36,36,0,237378.5,2519.972,96.25
"20188","60135","2021",36,24,12,189856,2227.778,88.11111
"20189","60136","2021",4,4,0,142593.8,1575.75,88.5
"20190","60137","2021",2,2,0,173250,1942,87
"20191","60138","2021",14,13,1,389839.3,3557.929,115.3571
"20192","60139","2021",162,102,60,231720.9,3348.685,72.24074
"20193","60140","2021",8,8,0,234625,2165.5,112.75
"20194","60141","2021",199,31,168,295429.9,4298.799,68.8794
"20195","60142","2021",68,43,25,285467.5,3368.926,87.61765
"20196","60143","2021",38,29,9,228923.6,2449.184,93
"20197","60144","2021",3,3,0,376666.7,3350,125
"20198","60145","2021",16,16,0,226363.1,2201.25,115.5
"20199","60146","2021",5,5,0,97200,1259.4,80.8
"20200","60147","2021",15,15,0,172900,2018.6,86.86667
"20201","60148","2021",7,7,0,255438.6,2598.857,109.8571
"20202","60149","2021",26,24,2,213487.1,2447.654,90.19231
"20203","60150","2021",12,11,1,273993.3,2531.167,84.33333
"20204","60151","2021",40,37,3,234762.8,2406.95,99.975
"20205","60152","2021",5,5,0,196300,1966.6,104.4
"20206","60153","2021",2,2,0,184150,1673,109.5
"20207","60154","2021",25,24,1,246086.7,2696.32,96.24
"20208","60155","2021",61,48,13,204751.6,2779.131,79.81967
"20209","60156","2021",29,26,3,243376.5,2573.897,96.72414
"20210","60157","2021",183,96,87,150102.7,2214.492,74.22951
"20211","60158","2021",4,4,0,165250,1701.5,96
"20212","60159","2021",660,179,481,199261.9,2648.906,73.99848
"20213","60160","2021",14,14,0,191203.6,1869.643,106.7857
"20214","60162","2021",8,7,1,196079.5,2268,96.75
"20215","60163","2021",7,7,0,133428.6,2060.429,84.71429
"20216","60164","2021",12,12,0,170622.9,1877.083,95.91667
"20217","60165","2021",9,9,0,220190,1928.222,142.8889
"20218","60166","2021",11,9,2,214250,2258.818,100.8182
"20219","60167","2021",8,8,0,197562.5,1999.125,106.875
"20220","60168","2021",1,1,0,135000,1552,87
"20221","60169","2021",15,15,0,210060.7,1999.467,107.1333
"20222","60170","2021",11,11,0,490845.5,3928,128.8182
"20223","60171","2021",2,2,0,144504,1288,111.5
"20224","60172","2021",59,32,27,327089.8,3704.814,90.01695
"20225","60173","2021",28,11,17,159757.1,2064.107,77.14286
"20226","60174","2021",1,1,0,154400,2115,73
"20227","60175","2021",264,83,181,123314.8,2050.568,61.67803
"20228","60176","2021",229,129,100,203800,2686.074,78.24017
"20229","60177","2021",5,5,0,159734,2343,70.4
"20230","60178","2021",36,31,5,177809.4,1847.028,102.9167
"20231","60179","2021",2,2,0,118167,1444.5,78.5
"20232","60180","2021",7,7,0,156571.4,1695.857,101.2857
"20233","60181","2021",15,15,0,147147.4,1690.8,100.2667
"20234","60182","2021",3,3,0,126511.7,1446.667,88
"20235","60183","2021",12,12,0,182010.8,1300.083,133.5
"20236","60184","2021",3,3,0,219766.7,2046,99.33333
"20237","60185","2021",15,15,0,255264.8,2822.067,101.6667
"20238","60186","2021",2,2,0,148500,1318.5,112.5
"20239","60187","2021",19,19,0,154028.4,2014.368,80.63158
"20240","60188","2021",36,36,0,202825.4,2045.25,104.3611
"20241","60189","2021",15,15,0,170095.3,1641.2,103.1333
"20242","60190","2021",5,5,0,184000,2059.6,95
"20243","60191","2021",12,12,0,158925,1657.75,100
"20244","60193","2021",2,2,0,110000,1803,60.5
"20245","60194","2021",2,2,0,122500,1194.5,105
"20246","60195","2021",9,9,0,310942.2,2528.444,119.4444
"20247","60196","2021",15,15,0,257623.3,2054.867,136.3333
"20248","60197","2021",13,13,0,265940,2792.308,101
"20249","60198","2021",3,3,0,176333.3,2290,82.33333
"20250","60199","2021",7,7,0,161285.7,1514,110.5714
"20251","60201","2021",6,6,0,126478.3,1635.333,78.83333
"20252","60203","2021",2,2,0,176500,1664,81
"20253","60204","2021",5,5,0,123770,773.2,160.2
"20254","60205","2021",1,1,0,134085,1577,85
"20255","60206","2021",13,13,0,252700,2188.538,120.4615
"20256","60207","2021",3,3,0,297000,1834.333,166
"20257","60208","2021",5,5,0,378240,2685,144.4
"20258","60209","2021",7,7,0,217996.4,2856.571,80.57143
"20259","60210","2021",1,1,0,130000,1884,69
"20260","60211","2021",13,13,0,163142.3,2067.385,87.53846
"20261","60212","2021",25,23,2,235770,2843.36,83.2
"20262","60213","2021",21,19,2,411477,3145.714,132.619
"20263","60214","2021",5,5,0,153100,1664,100
"20264","60215","2021",1,1,0,230000,2170,106
"20265","60216","2021",1,1,0,234000,2089,112
"20266","60217","2021",2,2,0,187500,1443,161.5
"20267","60218","2021",23,22,1,254889.6,2951.13,93.91304
"20268","60219","2021",5,4,1,115200,1166,96.2
"20269","60220","2021",7,7,0,149902.9,1972,80.71429
"20270","60221","2021",12,12,0,112792.5,1320.583,87.33333
"20271","60222","2021",9,9,0,202387.2,2037.444,104.3333
"20272","60223","2021",52,52,0,215460.1,2171.423,101.9423
"20273","60224","2021",2,2,0,200400,2757,72.5
"20274","60225","2021",9,9,0,171633.3,1957.222,89.66667
"20275","60226","2021",2,2,0,324087.5,3358.5,101.5
"20276","60227","2021",3,3,0,157666.7,1590,105.3333
"20277","60228","2021",4,4,0,263750,1981,132.75
"20278","60229","2021",2,2,0,154000,1599,98.5
"20279","60230","2021",8,8,0,175875,2168.25,81.875
"20280","60231","2021",5,5,0,276600,2703.8,110.8
"20281","60232","2021",7,7,0,159157,1589.571,114.2857
"20282","60233","2021",14,13,1,107983.7,1049.286,103.2143
"20283","60234","2021",45,32,13,182631.8,2306.6,80.77778
"20284","60235","2021",11,11,0,214279.1,2074.727,102.3636
"20285","60236","2021",3,3,0,89966.67,1104.333,75.66667
"20286","60237","2021",1,1,0,125000,1042,120
"20287","60238","2021",30,28,2,275949.3,2740.833,100.1667
"20288","60239","2021",10,10,0,222473.7,2382.7,93.2
"20289","60240","2021",3,3,0,109133.3,1487,88.66667
"20290","60241","2021",7,5,2,332840,3259.286,101.8571
"20291","60242","2021",6,6,0,135333.3,1260,105
"20292","60243","2021",3,3,0,317333.3,1694.333,187.6667
"20293","60244","2021",3,3,0,150500,1311.667,120.3333
"20294","60245","2021",35,34,1,142640,1571,93.62857
"20295","60247","2021",4,4,0,148500,1604.75,110.25
"20296","60248","2021",4,4,0,114250,1404.75,79.5
"20297","60249","2021",3,3,0,238600,2018,118.3333
"20298","60250","2021",7,7,0,222642.9,2449.286,89.71429
"20299","60251","2021",2,2,0,195900,1709.5,114.5
"20300","60252","2021",13,13,0,140484.2,1614.846,97.61538
"20301","60253","2021",7,7,0,181285.7,1817.571,96.57143
"20302","60254","2021",5,5,0,225460,2909.2,89.4
"20303","60255","2021",7,7,0,112171.4,1189.571,86.28571
"20304","60256","2021",25,25,0,208631,2220.76,96.48
"20305","60257","2021",6,6,0,214582.2,2542.667,89
"20306","60258","2021",1,1,0,85000,794,107
"20307","60259","2021",17,16,1,275298.8,3003.235,96.94118
"20308","60260","2021",17,17,0,230757.1,2285.824,103.5882
"20309","60261","2021",11,11,0,312533.6,3089,104.7273
"20310","60262","2021",2,2,0,257000,2255.5,144
"20311","60263","2021",5,5,0,144640,1422.6,108
"20312","60264","2021",5,5,0,216200,2253.8,97.4
"20313","60265","2021",9,9,0,153333.3,1790.889,86.11111
"20314","60267","2021",1,1,0,180000,1091,165
"20315","60268","2021",6,6,0,152866.7,2050.333,89.16667
"20316","60269","2021",3,3,0,147500,1858.333,78
"20317","60270","2021",4,4,0,173750,1618.25,103
"20318","60271","2021",2,2,0,287500,3281,85
"20319","60272","2021",13,13,0,219876.9,2696.846,83.76923
"20320","60273","2021",9,9,0,267555.6,2327.222,121.2222
"20321","60274","2021",5,5,0,239696,2410.8,128
"20322","60275","2021",3,3,0,143333.3,1822.667,80.66667
"20323","60276","2021",2,2,0,127000,1429,89.5
"20324","60277","2021",20,19,1,199060,2060.95,95.7
"20325","60278","2021",4,4,0,75875,817.5,93.75
"20326","60280","2021",1,1,0,160000,1778,90
"20327","60281","2021",8,8,0,179787.5,1999.75,89.875
"20328","60282","2021",178,123,55,369862,3909.185,99.1236
"20329","60283","2021",1,1,0,77000,1069,72
"20330","60284","2021",25,25,0,203518.5,2314.08,92.28
"20331","60286","2021",44,42,2,148715.9,1990.25,87.79545
"20332","60287","2021",6,6,0,140341.3,1403.167,104.5
"20333","60288","2021",5,5,0,157600,1731.2,112.6
"20334","60289","2021",2,2,0,97500,1063,85
"20335","60290","2021",7,7,0,203000,1972.714,105.5714
"20336","60291","2021",24,24,0,120831.8,1227.5,106.75
"20337","60292","2021",1,1,0,190000,1462,130
"20338","60293","2021",13,13,0,301243.1,2833.385,112.0769
"20339","60294","2021",2,2,0,109750,1985.5,56
"20340","60295","2021",8,8,0,108250,1191.875,92.625
"20341","60296","2021",2,2,0,103500,1360,74.5
"20342","60297","2021",4,4,0,139375,1102,133.75
"20343","60298","2021",11,11,0,129131.8,1550,85.81818
"20344","60299","2021",11,11,0,128772.7,1522.455,89.54545
"20345","60301","2021",3,3,0,163333.3,1566,106.6667
"20346","60302","2021",6,6,0,161333.3,2365.833,75.33333
"20347","60303","2021",1,1,0,115000,846,136
"20348","60304","2021",6,6,0,188650,1672,128.3333
"20349","60305","2021",4,4,0,223500,1515.25,139
"20350","60306","2021",5,5,0,180400,1713.2,107
"20351","60307","2021",10,10,0,232555.5,2024.8,115.7
"20352","60308","2021",3,3,0,288000,1794.667,160.3333
"20353","60309","2021",15,15,0,311626.7,2998.4,107.6667
"20354","60310","2021",9,9,0,195809,1991.222,106.6667
"20355","60311","2021",2,2,0,101150,1175,95.5
"20356","60312","2021",3,3,0,140883.3,2515,57.66667
"20357","60313","2021",27,27,0,174866.2,2122.407,86.85185
"20358","60314","2021",7,7,0,137357.1,1557.429,93.42857
"20359","60315","2021",11,11,0,180754.5,1529.545,125.1818
"20360","60316","2021",6,6,0,198910,1987,100.3333
"20361","60317","2021",12,12,0,226442.9,2064.167,116.75
"20362","60318","2021",10,10,0,212575.9,2319.7,95.4
"20363","60319","2021",7,7,0,174857.1,1873,95.14286
"20364","60320","2021",2,2,0,265000,2187.5,118.5
"20365","60321","2021",14,14,0,209808.6,2276.429,100.4286
"20366","60322","2021",2,2,0,210500,1850,113.5
"20367","60323","2021",10,10,0,173075,1889.4,89
"20368","60324","2021",8,8,0,164840,1302.375,133.375
"20369","60325","2021",32,31,1,277621.1,2529.469,115.6562
"20370","60327","2021",18,18,0,236789.9,2413.5,103.0556
"20371","60329","2021",1,1,0,185000,1423,130
"20372","60330","2021",20,20,0,247827.5,2555.85,101.45
"20373","60331","2021",10,10,0,275365,2275.3,134.5
"20374","60332","2021",6,6,0,230500,2488.5,93.33333
"20375","60333","2021",19,17,2,161739.6,2022.211,86.10526
"20376","60334","2021",16,16,0,254255,2359.125,110.625
"20377","60335","2021",4,4,0,121600,1337.25,100.5
"20378","60336","2021",2,2,0,225000,1747,129.5
"20379","60337","2021",10,10,0,286365,2415.9,129.8
"20380","60338","2021",77,60,17,226215,2502.623,92.57143
"20381","60339","2021",6,6,0,201500,1667.333,133.3333
"20382","60340","2021",6,6,0,104316.7,1705.667,68.66667
"20383","60341","2021",26,25,1,326389.2,3055.038,111.6923
"20384","60342","2021",62,55,7,187665.7,2176.645,91.46774
"20385","60343","2021",8,8,0,182075,2011.875,95.25
"20386","60344","2021",5,5,0,177000,2167.6,85
"20387","60345","2021",2,2,0,125000,1407,113
"20388","60346","2021",213,146,67,479085.3,4116.122,121.108
"20389","60347","2021",6,6,0,108051.8,1110.667,98
"20390","60348","2021",3,3,0,173333.3,1398.333,126.3333
"20391","60350","2021",14,14,0,191917.5,1800.643,112.4286
"20392","60351","2021",5,5,0,151330,1387.2,105.4
"20393","60352","2021",2,2,0,278500,2648,108
"20394","60353","2021",7,7,0,147202.9,1526.143,107.1429
"20395","60355","2021",16,16,0,182725,2191.188,85.0625
"20396","60356","2021",7,6,1,231457.9,2485.714,90.42857
"20397","60357","2021",8,8,0,166280,1908.25,95.25
"20398","60358","2021",18,13,5,258799.7,2691.167,108.0556
"20399","60359","2021",3,3,0,179227,2215,84.33333
"20400","60360","2021",94,58,36,135927.7,2083.723,68.32979
"20401","60361","2021",4,4,0,227187.5,2883.5,87.25
"20402","60362","2021",4,4,0,111100,1095.25,109.75
"20403","60363","2021",6,6,0,311316.7,3282.667,98.5
"20404","60364","2021",6,6,0,139583.3,1680.333,85.16667
"20405","60365","2021",8,8,0,143749.2,1356.375,105
"20406","60366","2021",8,8,0,204750,2166.125,98.375
"20407","60367","2021",4,4,0,182975,2249.75,86.5
"20408","60368","2021",43,41,2,164149.5,2103.977,79.65116
"20409","60369","2021",24,20,4,249995.4,2131.083,120.7917
"20410","60370","2021",21,21,0,226506.6,2505.571,93.85714
"20411","60371","2021",3,3,0,142666.7,1467.667,94
"20412","60372","2021",8,8,0,181750,1671.125,118.75
"20413","60373","2021",10,10,0,182800,1913.5,101.3
"20414","60374","2021",29,29,0,147668.6,1653.586,94.24138
"20415","60375","2021",4,4,0,176987.5,2068.25,87.75
"20416","60376","2021",2,2,0,273500,1755.5,155.5
"20417","60377","2021",7,7,0,164714.3,1534.714,120.8571
"20418","60378","2021",5,5,0,199600,2073.2,98.2
"20419","60379","2021",13,13,0,183100,1642,112.9231
"20420","60380","2021",29,26,3,189189.7,1989.621,101
"20421","60381","2021",5,5,0,121600,913.2,127.6
"20422","60382","2021",140,77,63,188622,2561.336,74.79286
"20423","60383","2021",4,4,0,183250,1802.25,104
"20424","60385","2021",9,9,0,184400,2125.222,90.88889
"20425","60386","2021",4,4,0,244875,1700.5,144.25
"20426","60387","2021",13,13,0,119461.5,1419.846,85.46154
"20427","60388","2021",2,2,0,150000,1007.5,142.5
"20428","60389","2021",2,2,0,149500,1348.5,110.5
"20429","60390","2021",3,3,0,110000,1802.667,69.66667
"20430","60391","2021",3,3,0,279333.3,2555.667,110.6667
"20431","60392","2021",10,10,0,197905,2177.4,101.3
"20432","60393","2021",11,9,2,169400,2127.273,84.18182
"20433","60394","2021",2,2,0,152000,1335.5,114.5
"20434","60395","2021",166,132,34,194144.5,2346.277,85.65663
"20435","60396","2021",7,7,0,131735.7,1490.857,89.57143
"20436","60397","2021",4,4,0,95525,860.75,120.75
"20437","60398","2021",36,27,9,245627.7,2860.25,93.13889
"20438","60399","2021",3,3,0,166000,2033.333,86.33333
"20439","60400","2021",5,5,0,156200,1673.2,94.4
"20440","60401","2021",15,15,0,244787.3,2577.333,107.9333
"20441","60402","2021",37,32,5,217595.9,2295.108,95.72973
"20442","60403","2021",26,26,0,154620.8,1534.654,89.07692
"20443","60404","2021",15,14,1,192400,2267.667,87.26667
"20444","60405","2021",16,16,0,106875,1299.938,86.375
"20445","60406","2021",10,10,0,257580,2853.9,92.2
"20446","60407","2021",4,4,0,146125,1384.5,122.5
"20447","60408","2021",12,11,1,226715.5,2260.917,100.5
"20448","60409","2021",37,35,2,201059.2,2252.351,90.91892
"20449","60410","2021",3,3,0,58000,1293.667,48.33333
"20450","60411","2021",14,14,0,234257.1,2457.786,99.78571
"20451","60412","2021",13,13,0,261530.8,2773.615,96
"20452","60413","2021",7,7,0,361486.6,2800.286,141.5714
"20453","60414","2021",109,67,42,151849,1930.908,82.6422
"20454","60415","2021",2,2,0,561250,3241.5,171
"20455","60416","2021",3,3,0,149966.7,1096,146
"20456","60418","2021",6,6,0,174333.3,2237.167,86
"20457","60420","2021",9,9,0,232340.9,2234.111,104.5556
"20458","60421","2021",9,8,1,452541.6,3590.556,121.1111
"20459","60422","2021",1,1,0,255000,1889,135
"20460","60423","2021",21,21,0,168460.3,1867.762,97.19048
"20461","60424","2021",8,8,0,184062.5,1996.125,94.375
"20462","60425","2021",10,10,0,117150,1352.7,88.5
"20463","60426","2021",3,3,0,239500,2513,102.3333
"20464","60427","2021",2,2,0,319500,2623.5,120.5
"20465","60428","2021",11,11,0,276879.3,2347.091,124.1818
"20466","60429","2021",7,6,1,280485.7,2541.286,110.8571
"20467","60430","2021",26,26,0,319255.7,2657.115,110.2692
"20468","60431","2021",6,6,0,184083.3,1794.333,104.8333
"20469","60432","2021",16,11,5,280768.1,3406,84.25
"20470","60433","2021",14,14,0,272505.7,2513.429,121.2143
"20471","60434","2021",4,4,0,156500,1372.5,119.25
"20472","60435","2021",4,4,0,227625,1764.5,128.5
"20473","60436","2021",2,2,0,99974,1136,88
"20474","60438","2021",4,4,0,179500,1771.75,112.75
"20475","60439","2021",111,92,19,168030.2,1979.333,92.51351
"20476","60440","2021",6,6,0,185083.3,2414.5,82
"20477","60441","2021",4,4,0,201787.5,1235.75,162.5
"20478","60442","2021",3,3,0,176666.7,1753.667,104.3333
"20479","60443","2021",6,6,0,163833.3,1427.667,111.5
"20480","60444","2021",4,4,0,103335,1025.25,103.5
"20481","60445","2021",5,5,0,119480,1786.4,63.4
"20482","60446","2021",74,50,24,216099.8,2785.378,82.2027
"20483","60447","2021",13,13,0,253803.1,2825.846,101.1538
"20484","60448","2021",16,16,0,195093.8,2187.375,98.625
"20485","60449","2021",2,2,0,232250,1829.5,127.5
"20486","60450","2021",77,65,12,211940.9,2561.364,86.25974
"20487","60451","2021",26,24,2,190509.6,2149.154,88.46154
"20488","60452","2021",8,8,0,287783.8,3181.375,98.5
"20489","60454","2021",14,14,0,209865.1,2547.429,91.35714
"20490","60456","2021",19,19,0,198498.4,1951,108.7895
"20491","60457","2021",2,2,0,225000,2552,87.5
"20492","60458","2021",2,2,0,191500,2020.5,94.5
"20493","60459","2021",1,1,0,349000,2664,131
"20494","60460","2021",7,7,0,220857.1,2036.714,115.2857
"20495","60461","2021",1,1,0,188000,1790,105
"20496","60462","2021",44,41,3,191921.1,2227.295,92.97727
"20497","60463","2021",231,110,121,140798.6,1866.286,77.16883
"20498","60464","2021",16,16,0,212852.2,2303.625,99.9375
"20499","60465","2021",3,3,0,195333.3,1678,126.6667
"20500","60466","2021",2,2,0,125000,1156.5,104
"20501","60468","2021",8,8,0,126037.5,1357.75,90.625
"20502","60469","2021",11,11,0,255454.5,2430.818,111.2727
"20503","60470","2021",3,3,0,160000,1641.333,111.6667
"20504","60471","2021",170,114,56,122770.1,1489.729,84.32941
"20505","60472","2021",3,3,0,151808.3,1809.333,87
"20506","60473","2021",6,6,0,292750,3029.167,98.33333
"20507","60474","2021",2,2,0,113000,1295.5,92
"20508","60476","2021",2,2,0,146500,1256,116.5
"20509","60477","2021",22,22,0,175221.8,1907.136,98.90909
"20510","60478","2021",6,5,1,216783.3,2383.5,92.16667
"20511","60479","2021",11,11,0,245172.7,2483.545,102.6364
"20512","60480","2021",7,7,0,233857.1,1918.714,128.1429
"20513","60481","2021",8,8,0,249916.2,2286.125,112.25
"20514","60482","2021",63,52,11,356652.1,3615.381,103.4127
"20515","60483","2021",4,4,0,162000,1718.5,88.75
"20516","60484","2021",7,7,0,159571.4,1787.143,93.28571
"20517","60485","2021",4,4,0,128250,1600,85.75
"20518","60486","2021",4,4,0,105000,1002.5,95.5
"20519","60487","2021",6,6,0,276104.7,2841.667,112.3333
"20520","60488","2021",5,5,0,152780,1715.6,92.4
"20521","60489","2021",18,17,1,264794.4,2824.556,93.94444
"20522","60490","2021",4,4,0,274725,2542.5,123.5
"20523","60491","2021",26,21,5,211553.8,2394.115,88.30769
"20524","60492","2021",8,8,0,172281.2,1664.5,105.375
"20525","60493","2021",5,5,0,197860,2222.6,91.8
"20526","60494","2021",24,22,2,295325.4,3211.208,95.41667
"20527","60495","2021",6,6,0,149800,1860.667,83.33333
"20528","60496","2021",4,4,0,98750,1288.5,76
"20529","60497","2021",3,3,0,135000,1996,67.33333
"20530","60498","2021",5,5,0,135400,1896,74.4
"20531","60499","2021",4,4,0,146002.5,1579,98.75
"20532","60500","2021",65,37,28,261823.6,3272.8,81.8
"20533","60501","2021",22,22,0,195989.5,2297.364,91.22727
"20534","60503","2021",3,3,0,150373.3,1212.667,119.3333
"20535","60504","2021",18,18,0,227117.9,2550.722,94.38889
"20536","60505","2021",15,12,3,290746.7,3064.533,98.73333
"20537","60506","2021",8,8,0,120237.5,1574.375,80.25
"20538","60507","2021",8,8,0,213171.9,1867.5,122.25
"20539","60508","2021",58,46,12,230273.1,2581.845,91.48276
"20540","60509","2021",189,109,80,169754.3,2270.206,76.64021
"20541","60510","2021",7,7,0,188228.6,1859,105
"20542","60511","2021",5,5,0,123360,1416.4,90.6
"20543","60512","2021",7,7,0,170000,2139.714,83.57143
"20544","60513","2021",54,43,11,272622.6,3242.648,87.85185
"20545","60514","2021",2,2,0,175000,1443,117.5
"20546","60515","2021",9,9,0,198227.6,1756.444,114.2222
"20547","60516","2021",3,3,0,200333.3,1596.667,133.6667
"20548","60517","2021",9,9,0,265973.3,2872,98
"20549","60518","2021",4,4,0,183125,1849.25,104.75
"20550","60519","2021",1,1,0,107500,768,140
"20551","60520","2021",2,2,0,129500,1573.5,71
"20552","60521","2021",6,6,0,132650,1421.333,90.83333
"20553","60522","2021",2,2,0,52750,736.5,72.5
"20554","60523","2021",14,14,0,185535.7,2271.643,82.92857
"20555","60524","2021",43,26,17,143277.6,1978.465,76.06977
"20556","60525","2021",3,3,0,492130,2715,187.3333
"20557","60526","2021",22,21,1,151532.8,1849.364,88.72727
"20558","60527","2021",3,3,0,232333.3,2263.333,112
"20559","60528","2021",3,3,0,282088.3,2398.333,120.6667
"20560","60529","2021",1,1,0,305000,1883,162
"20561","60530","2021",2,2,0,135950,951,143
"20562","60531","2021",31,30,1,223364.2,2070.806,106.871
"20563","60533","2021",19,18,1,215397.3,2474.789,90.21053
"20564","60534","2021",16,16,0,217555,2176.75,101.625
"20565","60535","2021",2,2,0,230425,1575.5,144.5
"20566","60537","2021",37,35,2,154160.6,1737.054,90.89189
"20567","60538","2021",5,5,0,169320,1891.6,97.4
"20568","60539","2021",29,29,0,211981.7,2505.31,90.44828
"20569","60540","2021",4,4,0,177515.5,2264.5,76.75
"20570","60541","2021",8,8,0,235658.8,2375.625,110.5
"20571","60542","2021",11,11,0,168422.7,1745.364,98.90909
"20572","60543","2021",1,1,0,250000,3125,80
"20573","60544","2021",1,1,0,154000,1692,91
"20574","60545","2021",8,8,0,127821.2,1382.5,95.375
"20575","60546","2021",1,1,0,210000,4667,45
"20576","60547","2021",11,11,0,299288.1,2478.455,134.1818
"20577","60548","2021",13,13,0,246275,2738.077,93.38462
"20578","60549","2021",1,1,0,150000,2239,67
"20579","60550","2021",3,3,0,123666.7,1723,71.33333
"20580","60551","2021",9,9,0,382411.1,2275.778,147.8889
"20581","60552","2021",2,2,0,336975,2234,155.5
"20582","60553","2021",3,3,0,164444.3,2249.667,74.66667
"20583","60554","2021",5,5,0,230800,2535.2,97.6
"20584","60555","2021",3,3,0,100666.7,1467.333,69.66667
"20585","60556","2021",4,4,0,132875,1736.5,80.75
"20586","60557","2021",4,4,0,111250,1714.75,66.75
"20587","60558","2021",8,8,0,193500,2687.125,99.5
"20588","60559","2021",14,14,0,178839.3,1797.143,102
"20589","60560","2021",15,15,0,308414,2539.533,120.7333
"20590","60561","2021",4,4,0,200125,2303.25,92
"20591","60562","2021",23,22,1,224497.8,2334.957,97.56522
"20592","60563","2021",12,12,0,239679.2,2376.5,102.6667
"20593","60564","2021",7,7,0,168642.9,1856,95.28571
"20594","60565","2021",4,4,0,181500,1838.25,103.5
"20595","60566","2021",7,7,0,125486,1247,96.57143
"20596","60567","2021",18,18,0,180405.1,1954.389,96.5
"20597","60568","2021",5,5,0,217400,2260.2,103.2
"20598","60569","2021",5,5,0,263240,1933.4,135.6
"20599","60570","2021",21,21,0,283070,2381.762,124.0476
"20600","60572","2021",6,6,0,192000,2512.667,77.5
"20601","60573","2021",3,3,0,198966.7,2461.333,82.66667
"20602","60574","2021",7,7,0,188385.9,2169.143,91.14286
"20603","60575","2021",46,45,1,237716.8,2560.109,97.21739
"20604","60576","2021",8,8,0,259766.2,2457.5,107
"20605","60577","2021",41,41,0,159313.9,1830.244,86.85366
"20606","60578","2021",18,18,0,207905.6,2555.444,85.44444
"20607","60579","2021",3,3,0,621515.3,3290.333,188.3333
"20608","60581","2021",88,72,16,146086.6,1805.784,84.26136
"20609","60582","2021",17,17,0,191055.9,2200.294,89.17647
"20610","60583","2021",2,2,0,256050,2370,111
"20611","60584","2021",64,53,11,219355.9,2841.344,83.76562
"20612","60585","2021",4,4,0,147525,1804.5,83
"20613","60586","2021",15,15,0,190267.7,2174.533,90.06667
"20614","60587","2021",19,19,0,206031.6,2397.947,89.89474
"20615","60588","2021",3,3,0,98333.33,1264,77
"20616","60589","2021",35,19,16,215169.6,2954.714,73.51429
"20617","60590","2021",9,9,0,160934.4,2033.889,81.55556
"20618","60591","2021",21,21,0,243618.2,2530.143,102.8095
"20619","60592","2021",14,14,0,181541.1,1829.5,103.3571
"20620","60593","2021",4,4,0,129250,1745,80.5
"20621","60594","2021",10,10,0,176313.5,1759.2,104
"20622","60595","2021",5,5,0,187737.6,2010,94.6
"20623","60596","2021",12,12,0,98208.33,1263.917,80.58333
"20624","60597","2021",25,25,0,206229.6,2454.36,87.04
"20625","60598","2021",22,22,0,222608.9,2305.773,107.3636
"20626","60599","2021",6,6,0,95876.17,1222.167,77.5
"20627","60600","2021",16,16,0,395057.5,2838.688,140.0625
"20628","60601","2021",21,17,4,188133.3,2431.286,82.57143
"20629","60603","2021",14,14,0,185527.7,1785.929,102.7857
"20630","60604","2021",4,4,0,157250,1469.5,117.5
"20631","60605","2021",6,6,0,171150,1649.5,92.16667
"20632","60608","2021",2,2,0,188440,2032,83
"20633","60609","2021",18,18,0,182188.2,2068.5,92.16667
"20634","60610","2021",10,10,0,165990,1814.1,97.2
"20635","60611","2021",10,10,0,171801,1553.7,119.9
"20636","60612","2021",266,113,153,289945.4,3429.857,84.37594
"20637","60613","2021",4,4,0,235250,3144.75,76.25
"20638","60614","2021",4,4,0,145895,1947.25,75
"20639","60616","2021",61,60,1,160867.9,2040.344,81.29508
"20640","60617","2021",1,1,0,126500,1228,103
"20641","60618","2021",3,3,0,233320,2500.667,90.66667
"20642","60619","2021",16,12,4,227625,2667.125,91.0625
"20643","60620","2021",7,7,0,291701.4,2776.429,115.5714
"20644","60621","2021",3,3,0,134333.3,1540,83.33333
"20645","60622","2021",2,2,0,142345,1581.5,90
"20646","60623","2021",14,14,0,159035.7,1674.929,97.92857
"20647","60624","2021",3,3,0,122333.3,1291.667,103
"20648","60625","2021",12,12,0,149950,1527.75,97.08333
"20649","60626","2021",19,19,0,198042.6,2175.421,94.42105
"20650","60628","2021",11,11,0,193587.3,2110.455,99.81818
"20651","60629","2021",5,5,0,180800,1821.4,107.4
"20652","60630","2021",7,7,0,213571.4,2340.286,94.28571
"20653","60631","2021",21,17,4,274217.9,3242.857,84.80952
"20654","60632","2021",13,13,0,123384.6,1130.615,111.8462
"20655","60633","2021",10,10,0,173020,1503.5,118.8
"20656","60634","2021",1,1,0,153000,1093,140
"20657","60635","2021",12,7,5,172008.3,2551,70.16667
"20658","60636","2021",49,47,2,163857.8,2030.837,85.42857
"20659","60637","2021",4,4,0,173250,2725,64.5
"20660","60638","2021",5,5,0,238080,3011.2,79.6
"20661","60639","2021",8,8,0,246750,2192.5,115.625
"20662","60640","2021",5,5,0,284660,2507,116.8
"20663","60641","2021",32,31,1,204546.2,2046.031,103.6875
"20664","60642","2021",12,12,0,211701.7,2120.917,103.5
"20665","60643","2021",26,26,0,157693.1,1664.192,103.4615
"20666","60644","2021",49,48,1,228980.4,2402.592,96.97959
"20667","60645","2021",8,8,0,217018.8,2548.25,85.75
"20668","60646","2021",11,10,1,190636.4,2474.727,86.27273
"20669","60647","2021",26,24,2,146384.6,1936.846,83.73077
"20670","60648","2021",8,8,0,180750,1571.125,118.875
"20671","60650","2021",7,7,0,256728.6,2449.429,110.7143
"20672","60651","2021",31,27,4,244771.6,2496.323,109.0968
"20673","60652","2021",23,21,2,193137.3,2653.261,79.04348
"20674","60653","2021",3,3,0,192670,2310.667,90.33333
"20675","60654","2021",1,1,0,329000,1848,178
"20676","60655","2021",5,5,0,131100,1714.8,94.4
"20677","60656","2021",6,6,0,242258.3,2254,107
"20678","60657","2021",6,6,0,164203.3,1593.167,105.6667
"20679","60658","2021",7,7,0,184511.4,2200.143,85.14286
"20680","60659","2021",6,6,0,222753.5,2127.667,104.1667
"20681","60660","2021",5,5,0,252600,2233.4,124.4
"20682","60661","2021",23,18,5,183673.9,2182.739,88.21739
"20683","60662","2021",9,9,0,209429.7,1685.222,123.6667
"20684","60663","2021",3,3,0,222320.7,2278,98.33333
"20685","60664","2021",6,6,0,121333.3,1315,94.5
"20686","60665","2021",32,26,6,227264.7,2347.344,96.1875
"20687","60666","2021",22,22,0,313270.2,3229.727,104.1364
"20688","60667","2021",56,47,9,193121.3,2390.696,82.89286
"20689","60668","2021",7,7,0,222235.7,2072.143,113.4286
"20690","60669","2021",11,11,0,249903.8,2217.091,118.5455
"20691","60670","2021",76,66,10,248913.4,2542.039,103.0395
"20692","60671","2021",3,3,0,306333.3,2607,119
"20693","60672","2021",3,3,0,171166.7,1754.333,100.6667
"20694","60673","2021",2,2,0,97975,981.5,101.5
"20695","60674","2021",8,8,0,391873.8,3547.875,141.625
"20696","60675","2021",11,11,0,204065.8,2197.636,105.3636
"20697","60676","2021",11,11,0,169727.3,1736.455,101.9091
"20698","60677","2021",3,3,0,129150,2777,54.66667
"20699","60678","2021",12,9,3,223174.2,2964.083,95.41667
"20700","60679","2021",2,2,0,132500,1183,112
"20701","60680","2021",5,5,0,239765,2623.6,91.6
"20702","60681","2021",12,12,0,173726.2,1736.583,109.4167
"20703","60682","2021",4,4,0,489750,3421.5,150.25
"20704","60683","2021",5,5,0,227200,2619,88
"20705","60684","2021",63,54,9,192635.1,2406.476,82.44444
"20706","60685","2021",17,17,0,207808.8,2266.294,97.23529
"20707","60686","2021",38,36,2,284091.7,2824.237,105.1579
"20708","60687","2021",10,10,0,216936.7,2272.9,106.3
"20709","60688","2021",5,5,0,165500,1396,118.8
"20710","60689","2021",24,23,1,288080.9,2407,125.375
"20711","60691","2021",4,4,0,117725,1286.5,80
"20712","60692","2021",3,3,0,230500,1560,133.6667
"20713","60693","2021",6,6,0,96166.67,904.3333,104.3333
"20714","60695","2021",27,23,4,489656.2,4618.037,108.9259
"20715","60698","2021",5,5,0,143000,2404.6,63.4
"20716","60699","2021",1,1,0,257180,1169,220
"20717","60700","2021",13,13,0,239434.6,2064.538,120.0769
"20718","60701","2021",13,13,0,149130.8,1550.385,95.69231
"20719","60702","2021",2,2,0,164650,1462.5,111.5
"20720","60703","2021",8,8,0,216507.5,1953.75,112.625
"20721","61001","2021",370,207,163,106612,1358.581,78.8027
"20722","61002","2021",8,7,1,104625,1281.125,74.375
"20723","61005","2021",9,9,0,176631.3,1646.333,105.4444
"20724","61006","2021",144,96,48,108761.7,1365.84,79.86806
"20725","61007","2021",59,57,2,105221.9,1124.373,90.55932
"20726","61008","2021",35,35,0,89951.43,1196.343,75.62857
"20727","61010","2021",1,1,0,120000,1111,108
"20728","61012","2021",5,5,0,177340,1428.4,123.2
"20729","61013","2021",3,3,0,106368,938,117
"20730","61014","2021",4,4,0,203837.5,1656,125.5
"20731","61015","2021",6,6,0,134160.8,1340.833,102.8333
"20732","61017","2021",1,1,0,158000,952,166
"20733","61018","2021",3,3,0,166000,1791.667,97
"20734","61020","2021",1,1,0,40000,800,50
"20735","61021","2021",1,1,0,79300,991,80
"20736","61023","2021",9,9,0,167444.4,1530.111,108.3333
"20737","61024","2021",5,5,0,92460,1184.8,74.4
"20738","61026","2021",6,6,0,91666.67,1208.833,73.83333
"20739","61028","2021",12,12,0,129652.5,1266.333,104.3333
"20740","61029","2021",14,14,0,134522.5,1266.857,110.4286
"20741","61030","2021",1,1,0,224000,1566,143
"20742","61032","2021",10,10,0,111926.5,1277.8,88.5
"20743","61034","2021",4,4,0,405605,3567.5,109.25
"20744","61035","2021",1,1,0,250000,1453,172
"20745","61036","2021",4,4,0,106750,1149.5,101.25
"20746","61037","2021",1,1,0,154000,906,170
"20747","61038","2021",31,30,1,158847,1551.871,97.67742
"20748","61039","2021",2,2,0,177500,1346,107.5
"20749","61040","2021",13,13,0,102388,1229,88.92308
"20750","61041","2021",3,3,0,129600,1330,93.33333
"20751","61043","2021",13,13,0,131580.8,1392.769,94.07692
"20752","61044","2021",6,6,0,79900,1080.167,80.33333
"20753","61046","2021",1,1,0,155000,1962,79
"20754","61048","2021",3,3,0,130333.3,1154.333,109
"20755","61050","2021",22,22,0,260367,2518,102.0909
"20756","61051","2021",5,5,0,90700,1145.6,76
"20757","61052","2021",4,4,0,164372.2,1503,112.75
"20758","61053","2021",7,7,0,137357.1,1657,85.28571
"20759","61054","2021",3,3,0,116000,1095,108
"20760","61055","2021",10,10,0,90590,892.7,94.9
"20761","61056","2021",1,1,0,65600,1640,40
"20762","61060","2021",3,3,0,140500,1318.333,107
"20763","61061","2021",32,32,0,124334.4,1314.531,96.6875
"20764","61062","2021",1,1,0,66000,904,73
"20765","61063","2021",25,25,0,115508.9,1197.36,95.16
"20766","61064","2021",2,2,0,95190,830,122
"20767","61067","2021",3,3,0,105000,918,115
"20768","61068","2021",3,3,0,147333.3,1570,101.3333
"20769","61069","2021",4,4,0,92825,877,101.75
"20770","61070","2021",9,9,0,132822.2,1164.111,113.1111
"20771","61071","2021",6,6,0,152946.5,1716.833,86.83333
"20772","61072","2021",8,8,0,204257,1772.125,110.5
"20773","61074","2021",9,9,0,99388.89,960.6667,104.6667
"20774","61075","2021",27,27,0,95075.3,1028.333,95.7037
"20775","61076","2021",4,4,0,131875,1249.5,103.5
"20776","61077","2021",9,9,0,135207.8,1428.778,96
"20777","61078","2021",5,5,0,91216,1024.4,82.2
"20778","61079","2021",38,38,0,94957.89,1178.921,80.31579
"20779","61081","2021",14,14,0,129453.6,1291.143,102.7143
"20780","61082","2021",2,2,0,158000,1278.5,132
"20781","61084","2021",1,1,0,237730,1351,176
"20782","61086","2021",3,3,0,96333.33,1336,75
"20783","61087","2021",3,3,0,216833.3,1257.333,158.3333
"20784","61088","2021",1,1,0,113000,3324,34
"20785","61089","2021",2,2,0,155283,1757.5,90
"20786","61091","2021",22,21,1,83097.73,899.9091,93.13636
"20787","61092","2021",14,14,0,135082.8,1776.429,85.92857
"20788","61093","2021",15,15,0,129172.7,1139.2,109
"20789","61094","2021",7,7,0,114331.3,1325.143,83.42857
"20790","61095","2021",13,13,0,87936.15,1050.846,88.46154
"20791","61096","2021",48,48,0,85843.33,977.5,93.95833
"20792","61097","2021",10,10,0,139770,1292.7,108.7
"20793","61098","2021",8,8,0,151087.5,1137,141
"20794","61099","2021",5,5,0,231956.6,2285.8,91.8
"20795","61100","2021",2,2,0,168000,1264.5,135.5
"20796","61101","2021",5,5,0,125600,1476.6,81
"20797","61102","2021",3,3,0,103000,1153.667,92.33333
"20798","61103","2021",1,1,0,215000,1706,126
"20799","61104","2021",1,1,0,82000,863,95
"20800","61105","2021",7,7,0,152600,1553,95.28571
"20801","61107","2021",11,11,0,115409.1,1437.818,80.81818
"20802","61108","2021",5,5,0,93400,1063,81.2
"20803","61111","2021",5,5,0,95400,963.2,91.2
"20804","61114","2021",3,3,0,207666.7,1930.333,105
"20805","61116","2021",37,35,2,151689,1540.324,93.45946
"20806","61117","2021",28,28,0,138984.3,1539,94.42857
"20807","61118","2021",2,2,0,132500,1419.5,92
"20808","61120","2021",1,1,0,69524,764,91
"20809","61121","2021",12,12,0,181710,1723.167,100.5
"20810","61122","2021",1,1,0,182000,2068,88
"20811","61123","2021",3,3,0,133000,1219.333,103.3333
"20812","61124","2021",3,3,0,64000,1013.333,66.66667
"20813","61126","2021",9,9,0,172225,1274.444,120.8889
"20814","61129","2021",6,6,0,94166.67,1697.333,72.33333
"20815","61130","2021",13,13,0,191242.3,1971,113.6923
"20816","61133","2021",14,13,1,116287.1,1197.857,99.5
"20817","61137","2021",1,1,0,120000,2927,41
"20818","61138","2021",4,4,0,156250,1131,144.25
"20819","61139","2021",10,10,0,180882.5,1745.6,113.4
"20820","61140","2021",10,10,0,150450,1418.5,106.1
"20821","61141","2021",4,4,0,131625,1583,83.25
"20822","61142","2021",5,5,0,439260,3411,125.2
"20823","61143","2021",40,38,2,143303.8,1574.45,89.1
"20824","61145","2021",67,62,5,103665.6,1132.448,95.83582
"20825","61146","2021",3,3,0,70666.67,1021.667,63.33333
"20826","61149","2021",2,2,0,139500,1247,115.5
"20827","61150","2021",11,11,0,180863.6,1618.545,115.0909
"20828","61151","2021",13,13,0,152755.8,1418,105.7692
"20829","61152","2021",2,2,0,185000,1576.5,119
"20830","61153","2021",28,28,0,124377.5,1254.964,100.8214
"20831","61156","2021",8,8,0,223750,1851.375,121.875
"20832","61158","2021",1,1,0,35000,500,70
"20833","61160","2021",5,4,1,194900,1553.2,119.2
"20834","61162","2021",5,5,0,163504,1828.6,90
"20835","61163","2021",29,29,0,108325.5,1245.31,86.44828
"20836","61164","2021",2,2,0,137500,1675.5,81.5
"20837","61165","2021",7,7,0,161014.3,1537.143,107.1429
"20838","61166","2021",3,3,0,175083.3,1356.333,121.6667
"20839","61167","2021",57,56,1,124764.5,1169.632,102.6316
"20840","61168","2021",60,53,7,88049.85,1032.167,89.76667
"20841","61169","2021",16,16,0,119172.9,1229.125,96.8125
"20842","61171","2021",2,2,0,145750,1153.5,99.5
"20843","61176","2021",2,2,0,96500,973,98
"20844","61178","2021",2,2,0,122475,1092,115.5
"20845","61180","2021",4,4,0,180315,1470.5,121.5
"20846","61181","2021",29,28,1,97717.24,1103.897,88.34483
"20847","61182","2021",5,5,0,131200,1511.4,97
"20848","61183","2021",2,2,0,73500,1263.5,58
"20849","61187","2021",9,9,0,192337.9,2015.444,105.5556
"20850","61188","2021",1,1,0,390000,2932,133
"20851","61189","2021",2,2,0,183500,1610,142
"20852","61192","2021",2,2,0,225000,2765.5,86.5
"20853","61193","2021",3,3,0,149666.7,1148.667,128.6667
"20854","61194","2021",10,10,0,174849,1571.2,114.3
"20855","61195","2021",5,5,0,147048,1185.4,129.6
"20856","61196","2021",39,38,1,170071.8,1523.821,110.1282
"20857","61197","2021",6,6,0,147001.7,1365,108.5
"20858","61198","2021",3,3,0,144586.7,1275.667,111.6667
"20859","61199","2021",3,3,0,424683.3,1725.667,223
"20860","61202","2021",13,13,0,138115.4,1345.231,104.2308
"20861","61203","2021",11,11,0,156295.5,1747.818,89
"20862","61206","2021",4,4,0,75375,1425.75,61.25
"20863","61207","2021",16,16,0,119758.4,1337.188,91.4375
"20864","61208","2021",14,14,0,116057.1,1381.571,87.92857
"20865","61209","2021",1,1,0,30000,395,76
"20866","61210","2021",1,1,0,129000,1290,100
"20867","61211","2021",40,40,0,105724,1083.65,100.85
"20868","61212","2021",1,1,0,159000,1262,126
"20869","61213","2021",4,4,0,149250,1579.75,123.75
"20870","61214","2021",109,81,28,110741.1,1300.294,83.7156
"20871","61215","2021",7,7,0,154357.1,1596.429,105.1429
"20872","61216","2021",1,1,0,330000,1320,250
"20873","61217","2021",1,1,0,55000,556,99
"20874","61218","2021",20,20,0,109180.6,1300.3,84.55
"20875","61219","2021",1,1,0,18000,900,20
"20876","61221","2021",5,5,0,100710,991.6,103
"20877","61222","2021",5,5,0,91150,1243.4,73
"20878","61224","2021",2,2,0,159500,1907,84.5
"20879","61228","2021",10,10,0,138400,1416.2,101.4
"20880","61229","2021",2,2,0,102500,754,136
"20881","61230","2021",83,81,2,127107.3,1417.458,93.68675
"20882","61232","2021",21,21,0,83945.95,934.5714,89.61905
"20883","61233","2021",5,5,0,139392,1478.8,92.2
"20884","61234","2021",12,12,0,174048.3,1632.333,109.6667
"20885","61237","2021",2,2,0,114900,1045,123.5
"20886","61238","2021",2,2,0,219500,1694.5,125
"20887","61240","2021",5,5,0,94587,960,97.2
"20888","61241","2021",14,14,0,159241.7,1083.929,142.7143
"20889","61242","2021",11,11,0,151077.3,1448.455,104.0909
"20890","61243","2021",21,21,0,139733,1333.762,104.0476
"20891","61244","2021",5,5,0,95220,1795,55.2
"20892","61248","2021",16,16,0,85912.5,969.5625,93
"20893","61251","2021",3,3,0,211000,1470,135
"20894","61255","2021",15,15,0,94580,990.3333,93.6
"20895","61256","2021",6,6,0,127166.7,963.3333,133.3333
"20896","61257","2021",3,3,0,56333.33,603.3333,87.33333
"20897","61258","2021",4,3,1,112500,1980,62.25
"20898","61259","2021",1,1,0,45000,375,120
"20899","61260","2021",6,6,0,119106.7,1334.833,87.66667
"20900","61261","2021",5,5,0,86866.2,820.2,102.2
"20901","61263","2021",2,2,0,165000,1447.5,117
"20902","61265","2021",2,2,0,79000,889,90
"20903","61266","2021",3,2,1,136166.7,2194.333,67
"20904","61267","2021",4,4,0,92375,1027.25,89.75
"20905","61268","2021",5,5,0,112350,1066,105.8
"20906","61269","2021",13,13,0,77953.85,897.3846,88.23077
"20907","61271","2021",2,2,0,102500,846,112.5
"20908","61273","2021",1,1,0,176500,1177,150
"20909","61274","2021",5,5,0,187600,1223.6,154
"20910","61275","2021",22,22,0,100491.4,1342.818,71.13636
"20911","61276","2021",1,1,0,86000,1623,53
"20912","61277","2021",6,6,0,120325,1119.167,108.5
"20913","61278","2021",15,15,0,126707.3,1460.333,99.66667
"20914","61279","2021",6,6,0,99133.33,1169.167,85.16667
"20915","61281","2021",3,3,0,161775,1727.333,102
"20916","61283","2021",3,3,0,114750,1306.667,95.66667
"20917","61284","2021",5,5,0,135468.4,1594.4,93
"20918","61286","2021",1,1,0,2e+05,1418,141
"20919","61287","2021",15,15,0,141249.3,1317.2,113
"20920","61288","2021",11,11,0,169327.3,1543.364,115.1818
"20921","61289","2021",1,1,0,125000,1404,89
"20922","61290","2021",3,3,0,64166.67,1015,62
"20923","61291","2021",1,1,0,90000,1059,85
"20924","61292","2021",6,6,0,141750,1387,101.1667
"20925","61293","2021",52,44,8,123550,1502.019,90.13462
"20926","61294","2021",13,13,0,119807.7,1174.846,97.15385
"20927","61295","2021",1,1,0,2e+05,1818,110
"20928","61297","2021",10,9,1,108700,949.5,106.1
"20929","61298","2021",3,3,0,367333.3,1889,193.6667
"20930","61300","2021",11,11,0,163875.9,1623.909,101.0909
"20931","61301","2021",5,5,0,221250,2746.6,96.2
"20932","61302","2021",2,2,0,142500,1442.5,99.5
"20933","61303","2021",6,6,0,127533.3,1242.667,104.5
"20934","61304","2021",6,6,0,187583.3,1533.167,127.6667
"20935","61307","2021",5,5,0,132400,1358.8,97.8
"20936","61308","2021",1,1,0,85000,944,90
"20937","61309","2021",44,44,0,166821.7,1514.318,104.75
"20938","61310","2021",16,16,0,94572.5,1090.875,94.1875
"20939","61314","2021",8,8,0,135580,1457.875,102.75
"20940","61317","2021",4,4,0,115005,1386.75,94.25
"20941","61319","2021",9,9,0,129888.9,1115.778,106
"20942","61321","2021",5,5,0,88060,1272.8,74.4
"20943","61322","2021",2,2,0,226750,3939,96
"20944","61323","2021",2,2,0,189000,1221,163
"20945","61324","2021",28,27,1,102843.6,952.8571,108.7857
"20946","61326","2021",4,4,0,106500,1194,103.5
"20947","61327","2021",12,12,0,174443.8,1977.667,97.5
"20948","61328","2021",2,2,0,130375,1589,88
"20949","61329","2021",7,7,0,132642.9,1755.714,91.14286
"20950","61330","2021",7,7,0,106928.6,1120.857,94.14286
"20951","61331","2021",1,1,0,280000,1167,240
"20952","61332","2021",2,2,0,95785,816,118
"20953","61333","2021",3,2,1,54728,599.3333,92.66667
"20954","61336","2021",4,4,0,170562.5,1529.75,97.5
"20955","61339","2021",35,35,0,114662.1,1303.029,85.62857
"20956","61341","2021",14,14,0,135174.3,1596.714,89.42857
"20957","61342","2021",20,20,0,120274.6,1392.4,92.45
"20958","61344","2021",11,11,0,105490.9,1313.818,81.36364
"20959","61345","2021",47,46,1,201463,1577.277,103.9149
"20960","61346","2021",6,6,0,212833.3,1552.667,133.6667
"20961","61347","2021",6,6,0,106333.3,1394.333,73.5
"20962","61348","2021",5,5,0,115500,1519.4,75.6
"20963","61349","2021",3,3,0,106000,1286,92
"20964","61350","2021",4,4,0,124625,2330.75,77.5
"20965","61351","2021",3,3,0,116600,1473,101
"20966","61352","2021",2,2,0,92500,1054,87
"20967","61357","2021",1,1,0,75000,577,130
"20968","61358","2021",2,2,0,87500,1048.5,84
"20969","61360","2021",3,3,0,140057,1398.667,105.6667
"20970","61361","2021",4,4,0,109518.8,951.5,127
"20971","61362","2021",8,8,0,110773.8,1155.375,94.5
"20972","61363","2021",2,2,0,99000,2562.5,69
"20973","61365","2021",4,3,1,118487.5,1273.5,93.25
"20974","61366","2021",1,1,0,125990,3150,40
"20975","61367","2021",3,3,0,190000,2701.333,75.33333
"20976","61369","2021",16,16,0,114925.9,1211.562,97.5625
"20977","61370","2021",3,3,0,184933.3,1076.667,204.6667
"20978","61371","2021",4,4,0,134325,1817.25,68.5
"20979","61372","2021",5,5,0,156900,1761.8,88.2
"20980","61373","2021",4,4,0,150000,1403.5,92.5
"20981","61375","2021",18,18,0,163241.7,1747.778,94.27778
"20982","61376","2021",20,20,0,82710,1024,81.1
"20983","61379","2021",10,10,0,117721,1534.7,91.7
"20984","61381","2021",2,2,0,155000,1404,112.5
"20985","61382","2021",15,15,0,122083.3,1294.533,90.86667
"20986","61384","2021",3,3,0,128000,1381,98.33333
"20987","61385","2021",13,13,0,95269.23,1226.846,77.92308
"20988","61386","2021",10,10,0,157764,1293.5,110.5
"20989","61387","2021",11,11,0,95545.45,1041.273,90.27273
"20990","61388","2021",5,5,0,118560,1055.2,118.6
"20991","61389","2021",22,21,1,90303.64,1296,73.81818
"20992","61390","2021",2,2,0,102000,830.5,129.5
"20993","61391","2021",52,41,11,115973.4,1265.654,88.5
"20994","61392","2021",5,5,0,76200,1174.2,70.8
"20995","61393","2021",3,3,0,169166.7,1966.667,94
"20996","61394","2021",16,16,0,164254.7,1590.875,103.9375
"20997","61395","2021",1,1,0,740000,1922,385
"20998","61396","2021",1,1,0,287000,2540,113
"20999","61397","2021",37,34,3,137756.8,1503.541,89.86486
"21000","61398","2021",1,1,0,43333,563,77
"21001","61399","2021",2,2,0,255700,2136,118
"21002","61400","2021",7,7,0,124854.1,1254.714,96.28571
"21003","61401","2021",1,1,0,222000,888,250
"21004","61402","2021",1,1,0,55500,804,69
"21005","61404","2021",18,18,0,172440,1452.611,118.4444
"21006","61405","2021",9,9,0,111237.8,1278.556,89.44444
"21007","61406","2021",11,11,0,134409.1,2174.182,85.90909
"21008","61407","2021",8,8,0,90127.5,1005.625,88.625
"21009","61408","2021",9,9,0,100186.2,1080.778,91.33333
"21010","61411","2021",5,5,0,124669.8,977,116.2
"21011","61412","2021",10,10,0,151087.5,1890.5,84.9
"21012","61413","2021",2,2,0,191000,1343.5,128.5
"21013","61414","2021",15,15,0,130499,1460,91
"21014","61415","2021",5,5,0,142536.6,1713.2,90.8
"21015","61416","2021",2,2,0,490000,3666,119
"21016","61418","2021",9,8,1,142611.1,1740.556,81.66667
"21017","61419","2021",5,5,0,110700,1323,92.4
"21018","61421","2021",7,7,0,86628.57,1215.714,72.57143
"21019","61422","2021",13,13,0,118390,1369.462,85.38462
"21020","61423","2021",9,9,0,148855.6,1472.333,102.3333
"21021","61424","2021",1,1,0,115500,962,120
"21022","61425","2021",5,5,0,101600,1828.2,59.8
"21023","61426","2021",16,16,0,125596.9,1716.438,74.125
"21024","61427","2021",1,1,0,45000,750,60
"21025","61429","2021",13,13,0,150461.5,1333.923,108.6154
"21026","61432","2021",7,7,0,153106.6,1390.571,112.2857
"21027","61433","2021",3,3,0,210666.7,1349.333,154.6667
"21028","61435","2021",4,4,0,97750,1037.25,100
"21029","61436","2021",4,4,0,80000,1162.75,69.5
"21030","61438","2021",3,3,0,84166.67,1424.333,58.66667
"21031","61439","2021",1,1,0,85000,1049,81
"21032","61440","2021",13,13,0,144807.7,1537.692,94.38462
"21033","61442","2021",1,1,0,105000,913,115
"21034","61443","2021",13,13,0,145605.4,1337.538,108.8462
"21035","61444","2021",2,2,0,52750,737.5,80
"21036","61445","2021",7,7,0,115086,861.5714,125.5714
"21037","61446","2021",1,1,0,48000,1021,47
"21038","61447","2021",25,23,2,109348,1181.64,94.92
"21039","61448","2021",7,7,0,143300,1356.857,113.1429
"21040","61450","2021",4,4,0,174125,1839.5,105.75
"21041","61451","2021",3,3,0,107200,1054.667,105
"21042","61452","2021",2,2,0,77450,733,119.5
"21043","61453","2021",5,5,0,112780,1217.8,98
"21044","61454","2021",12,12,0,154574.4,1779.667,85.58333
"21045","61456","2021",35,35,0,136387.7,1581.371,93.48571
"21046","61457","2021",5,5,0,137500,1372,110.2
"21047","61459","2021",2,2,0,69605.5,521,142.5
"21048","61460","2021",17,17,0,114232.4,1074.706,99.35294
"21049","61461","2021",5,5,0,259600,1897,137.2
"21050","61462","2021",12,12,0,159908.3,1649.333,99.5
"21051","61463","2021",14,14,0,138510.7,1174.643,120.7143
"21052","61464","2021",60,52,8,96261.67,1113.317,85.53333
"21053","61466","2021",22,22,0,116704.3,1246.273,92.36364
"21054","61467","2021",7,7,0,152047.9,1187.571,132.4286
"21055","61472","2021",4,4,0,189000,1494.25,124.75
"21056","61473","2021",3,3,0,167666.7,1668.667,116.3333
"21057","61474","2021",58,58,0,138656.7,1480.017,96.53448
"21058","61475","2021",18,18,0,106421.6,1378.611,78.61111
"21059","61476","2021",5,5,0,195930,2611.2,73
"21060","61479","2021",1,1,0,152000,1310,116
"21061","61480","2021",2,2,0,122000,1516,80.5
"21062","61481","2021",3,3,0,111000,1205.333,98
"21063","61482","2021",6,6,0,83916.67,1127.5,70
"21064","61483","2021",105,33,72,95438.38,1708.324,60.14286
"21065","61484","2021",59,57,2,129590.4,1333.458,94.0678
"21066","61485","2021",8,8,0,108625,1221.25,88.75
"21067","61486","2021",75,73,2,121756.5,1141.333,96.09333
"21068","61487","2021",8,8,0,106138.1,1424.75,81.5
"21069","61488","2021",1,1,0,72000,783,92
"21070","61490","2021",4,4,0,104250,1080,101.25
"21071","61491","2021",65,65,0,165403.7,1559.185,108.9538
"21072","61492","2021",4,4,0,91125,1581.25,88.25
"21073","61494","2021",14,14,0,102171.4,1150.429,89.57143
"21074","61497","2021",13,13,0,183168.5,1676.923,109.8462
"21075","61498","2021",2,2,0,152300,1657,97
"21076","61499","2021",2,2,0,130000,1098.5,116
"21077","61500","2021",2,2,0,65650,715.5,96
"21078","61501","2021",5,5,0,110300,1247,90.8
"21079","61502","2021",4,4,0,103350,1146.75,91.75
"21080","61503","2021",4,4,0,121250,1128,106.75
"21081","61505","2021",6,6,0,146083.3,1097.333,130.6667
"21082","61507","2021",7,7,0,166857.1,1747.286,96.57143
"21083","61508","2021",54,49,5,119717.1,1234.481,96.72222
"21084","61510","2021",1,1,0,415000,1976,210
"21085","61512","2021",3,3,0,126700,758,161.6667
"21086","62001","2021",23,23,0,190569.8,1779.609,108.6522
"21087","62002","2021",2,2,0,74500,1521,57.5
"21088","62003","2021",10,8,2,215957,1913.8,113.4
"21089","62004","2021",102,72,30,158727.4,1999.098,81.7549
"21090","62005","2021",15,15,0,131484,1399.533,91
"21091","62006","2021",5,5,0,183200,1446,131.2
"21092","62007","2021",14,14,0,331615.3,2381.286,134.2143
"21093","62008","2021",4,4,0,110460,1308.25,84
"21094","62009","2021",3,3,0,203266.7,1954,106.6667
"21095","62010","2021",4,4,0,142737.5,1568.75,93.75
"21096","62011","2021",10,10,0,304816.9,2410.6,137.2
"21097","62012","2021",3,3,0,162266.7,1966.667,83
"21098","62013","2021",26,26,0,161406.5,1836.692,88.26923
"21099","62014","2021",124,108,16,139843.9,1486.613,98.29839
"21100","62015","2021",6,6,0,212333.3,2269.667,100.3333
"21101","62016","2021",3,3,0,173550,1758,94
"21102","62017","2021",2,2,0,102450,1236.5,86
"21103","62018","2021",7,7,0,111914.3,1346.143,82.57143
"21104","62019","2021",44,40,4,170289.8,1825.977,95.61364
"21105","62020","2021",11,11,0,207681.8,2102,105.1818
"21106","62021","2021",4,4,0,191802.5,1623.25,118.25
"21107","62022","2021",3,3,0,169966.7,2054.667,89
"21108","62023","2021",42,41,1,146011.8,1498.357,99.33333
"21109","62024","2021",9,9,0,190255.6,1677.667,111
"21110","62025","2021",43,35,8,283039.7,3084.488,97.88372
"21111","62026","2021",1,1,0,138750,1542,90
"21112","62027","2021",2,2,0,116000,1390,85
"21113","62028","2021",5,5,0,85916,1174.8,81
"21114","62029","2021",8,8,0,149230,1562.5,96.75
"21115","62030","2021",6,6,0,131795,1476.667,86.33333
"21116","62031","2021",22,22,0,197255.5,1873.773,108.8182
"21117","62032","2021",34,34,0,156412.2,1644.882,95.05882
"21118","62033","2021",44,44,0,180091.9,1924.75,96.97727
"21119","62034","2021",25,25,0,154519.8,1460.52,103.76
"21120","62035","2021",104,103,1,151195.8,1666.596,91.19231
"21121","62036","2021",7,7,0,131414.3,1072.286,125.5714
"21122","62037","2021",41,36,5,241359.4,2353.317,105.4878
"21123","62038","2021",43,43,0,200404.3,1844,107.2093
"21124","62039","2021",10,10,0,173763,1789,98.8
"21125","62040","2021",118,112,6,148654.8,1641.11,92.36441
"21126","62041","2021",699,320,379,153174.8,2110.897,76.07153
"21127","62042","2021",11,11,0,200771.8,2083.545,99.54545
"21128","62043","2021",21,21,0,174976.9,1909.714,96.7619
"21129","62044","2021",12,12,0,203291.7,1850.083,110.3333
"21130","62045","2021",20,20,0,165958.5,1579.85,111.2
"21131","62046","2021",11,11,0,127966.4,1291.545,101.2727
"21132","62048","2021",133,122,11,101446,1175.511,88.60902
"21133","62049","2021",4,4,0,150000,1737,90.5
"21134","62050","2021",19,19,0,111397.4,1145.368,100.5789
"21135","62051","2021",41,41,0,153729.5,1751.976,91.36585
"21136","62052","2021",5,5,0,421740,2550.8,168.4
"21137","62053","2021",12,12,0,102050,980.8333,100.25
"21138","62054","2021",18,18,0,250085.6,3054.222,86
"21139","62055","2021",6,6,0,183333.3,1568.667,123.3333
"21140","62056","2021",22,21,1,301043.2,3451.318,93.72727
"21141","62057","2021",62,50,12,165759.6,1832.435,93.04839
"21142","62059","2021",4,4,0,260750,1845.25,130.75
"21143","62060","2021",57,56,1,92572.11,1002.456,92.87719
"21144","62061","2021",3,3,0,128700,1395.667,92.66667
"21145","62063","2021",18,18,0,144923.3,1363.722,106
"21146","62064","2021",6,6,0,111098.5,1214.833,87.83333
"21147","62065","2021",226,186,40,122699.6,1523.628,82.21681
"21148","62066","2021",1,1,0,92000,613,150
"21149","62067","2021",8,8,0,172675,1521.5,131.125
"21150","62068","2021",4,4,0,129000,1270,115.75
"21151","62069","2021",2,2,0,176000,1691,103.5
"21152","62070","2021",5,5,0,164350,1424,113.2
"21153","62071","2021",3,3,0,79000,742,97
"21154","62072","2021",5,5,0,131382,1207.8,100.4
"21155","62073","2021",18,18,0,171381.1,1772.667,96.61111
"21156","62074","2021",3,3,0,160666.7,1349.333,118.6667
"21157","62075","2021",13,13,0,248560.8,2198.538,114.1538
"21158","62077","2021",4,4,0,182862.5,1721.5,110.75
"21159","62078","2021",16,16,0,168365.9,1489.062,111.9375
"21160","62080","2021",37,33,4,123494.1,1405.378,91.7027
"21161","62081","2021",5,5,0,191200,1612.4,121.8
"21162","62082","2021",9,9,0,152994.4,1434.556,107.7778
"21163","62083","2021",51,51,0,129917,1418.451,90.98039
"21164","62085","2021",3,3,0,2e+05,2238.667,98.66667
"21165","62087","2021",10,10,0,198147,1907.6,107.1
"21166","62088","2021",3,3,0,98000,1069.333,90
"21167","62089","2021",8,8,0,319110.2,2285.625,139.75
"21168","62090","2021",4,4,0,120411.2,912.5,134.5
"21169","62091","2021",1,1,0,97100,1022,95
"21170","62092","2021",4,4,0,169665,1507,115.5
"21171","62093","2021",3,3,0,188500,1515.333,121.3333
"21172","62094","2021",3,3,0,224856.7,1766.667,126
"21173","62095","2021",4,4,0,217350,1555,139.75
"21174","62096","2021",5,5,0,92600,702.2,140.2
"21175","62097","2021",15,15,0,204718.9,1761.733,116.0667
"21176","62099","2021",64,51,13,177089,1948.953,89.10938
"21177","62100","2021",27,27,0,144662.6,1552.185,93.18519
"21178","62101","2021",2,2,0,59000,777,81
"21179","62103","2021",5,5,0,149992.4,1483,110.8
"21180","62104","2021",2,2,0,237400,1462,160
"21181","62105","2021",10,10,0,185293.4,2014.1,119.9
"21182","62106","2021",2,2,0,237300,2405.5,99
"21183","62107","2021",5,5,0,206340,2216.8,99.4
"21184","62108","2021",557,240,317,147931.9,2555.438,61.47576
"21185","62111","2021",5,5,0,156620,1762.6,95.8
"21186","62112","2021",10,10,0,155775,1139.3,137
"21187","62113","2021",4,4,0,167225,1435.5,120.25
"21188","62115","2021",5,5,0,163400,1437.8,114.6
"21189","62116","2021",2,2,0,171674.5,1471.5,117
"21190","62117","2021",25,24,1,125975.2,1325.4,95.12
"21191","62118","2021",4,4,0,173550,1298.25,130.25
"21192","62119","2021",390,254,136,129167.1,1599.267,82.57949
"21193","62120","2021",2,2,0,132250,1561.5,82.5
"21194","62122","2021",4,4,0,141822.5,1339.25,114.25
"21195","62123","2021",13,13,0,171107.7,1575.231,114.1538
"21196","62124","2021",7,7,0,228072.9,2150.429,109.7143
"21197","62125","2021",5,5,0,250193.2,1692.6,142
"21198","62126","2021",114,100,14,135760.4,1581.009,88.35088
"21199","62127","2021",3,3,0,127666.7,1288,98
"21200","62128","2021",59,59,0,158760.1,1798.61,92.77966
"21201","62129","2021",1,1,0,89700,997,90
"21202","62130","2021",7,7,0,160010,1325,115.2857
"21203","62131","2021",6,6,0,109670,1216.167,90.66667
"21204","62132","2021",54,54,0,173187.6,1888.722,96.53704
"21205","62133","2021",87,83,4,131853,1333.816,100.5172
"21206","62134","2021",3,3,0,206666.7,1355.333,161
"21207","62135","2021",2,2,0,120750,1167,102
"21208","62137","2021",2,2,0,120547.5,1030.5,117
"21209","62138","2021",8,8,0,103087.5,1034.125,98.5
"21210","62139","2021",72,72,0,128083.3,1449.361,88.20833
"21211","62140","2021",9,9,0,168566.7,1553.667,114.6667
"21212","62141","2021",6,6,0,187233.3,1709.333,109.6667
"21213","62142","2021",1,1,0,170000,1589,107
"21214","62143","2021",1,1,0,157000,1365,115
"21215","62144","2021",6,6,0,194431.7,2043.667,97.83333
"21216","62145","2021",6,6,0,150875,1258.5,124
"21217","62146","2021",3,3,0,156666.7,1787,90
"21218","62147","2021",5,5,0,204830,1682,123.6
"21219","62148","2021",15,15,0,145797.1,1609.533,88.93333
"21220","62149","2021",4,4,0,151475,1431.25,107
"21221","62150","2021",6,6,0,231594.2,2293.167,115.6667
"21222","62151","2021",11,11,0,193595,1498.455,135.1818
"21223","62153","2021",12,12,0,107604.2,1098.083,99
"21224","62154","2021",5,5,0,101400,1398.6,76.4
"21225","62155","2021",5,5,0,171680,1881.6,96.4
"21226","62156","2021",5,5,0,228700,2024.4,114.8
"21227","62157","2021",5,5,0,87800,1026.2,102.6
"21228","62158","2021",13,13,0,99384.62,1129.769,86.46154
"21229","62160","2021",552,276,276,129865.7,1653.799,83.25362
"21230","62161","2021",3,3,0,184000,1857,113
"21231","62162","2021",10,10,0,101217.5,1110.6,98.3
"21232","62163","2021",6,6,0,136988.8,1264.667,116.8333
"21233","62164","2021",17,17,0,119732.4,1310.941,94.64706
"21234","62165","2021",1,1,0,228500,1799,127
"21235","62166","2021",7,7,0,154171.4,1540.286,95
"21236","62167","2021",3,3,0,258500,2086.333,135.6667
"21237","62168","2021",5,5,0,177600,1556.8,123.2
"21238","62169","2021",5,5,0,187190,1810.6,105
"21239","62170","2021",30,30,0,184548.3,1599.5,114.7667
"21240","62171","2021",2,2,0,173000,1326,127.5
"21241","62172","2021",5,5,0,157720,1758.6,89.6
"21242","62173","2021",61,61,0,171300.4,1805.59,93.77049
"21243","62174","2021",12,12,0,182511.2,1701.583,109.9167
"21244","62176","2021",10,10,0,272850.7,2117.7,131.5
"21245","62177","2021",11,11,0,131918.2,1540.727,86.18182
"21246","62178","2021",199,175,24,112277,1332.206,85.69347
"21247","62179","2021",9,9,0,207894.4,1819.667,118
"21248","62180","2021",1,1,0,144000,1636,88
"21249","62181","2021",24,24,0,141971.7,1361.917,110.75
"21250","62182","2021",8,8,0,186706.2,1476.75,120.125
"21251","62183","2021",6,6,0,188750,1958.5,97
"21252","62184","2021",4,4,0,191725,1945.75,102.75
"21253","62185","2021",1,1,0,85000,1269,67
"21254","62186","2021",94,88,6,146367.4,1561.532,95.54255
"21255","62187","2021",2,2,0,242500,1626,147
"21256","62188","2021",33,33,0,121338.6,1283.848,93.27273
"21257","62189","2021",3,3,0,159333.3,1110,139.3333
"21258","62190","2021",13,13,0,181515.4,1635.308,106.6923
"21259","62191","2021",8,8,0,149375,1423.5,108.875
"21260","62192","2021",4,4,0,161150,1155.5,152
"21261","62193","2021",1036,788,248,126949.4,1591.285,83.69015
"21262","62194","2021",51,51,0,114152.7,1217.196,93.31373
"21263","62195","2021",12,12,0,194812.5,1800.833,116.3333
"21264","62196","2021",7,7,0,202542.9,1860.143,110.8571
"21265","62197","2021",15,15,0,156159.3,1545.133,103.8
"21266","62198","2021",6,6,0,188391.7,1559.167,119.5
"21267","62199","2021",4,4,0,197427.5,1800.5,109.25
"21268","62200","2021",16,16,0,172707.4,1680.938,102.6875
"21269","62201","2021",164,81,83,152231.8,2914.64,56.15244
"21270","62202","2021",7,7,0,147471.4,1357.429,107.5714
"21271","62203","2021",5,5,0,163500,1614.8,102.4
"21272","62204","2021",1,1,0,170000,1000,170
"21273","62205","2021",13,13,0,222915.4,1975.538,113.6154
"21274","62206","2021",2,2,0,190750,1417,128.5
"21275","62207","2021",5,5,0,354225,2173.4,169.4
"21276","62211","2021",2,2,0,195500,1551,119
"21277","62212","2021",9,9,0,165286.1,1493.333,108
"21278","62213","2021",7,7,0,295329.6,2523.857,117.2857
"21279","62214","2021",7,7,0,236242.9,1744.571,138.7143
"21280","62215","2021",201,196,5,157081.4,1676.577,95.58209
"21281","62216","2021",3,3,0,117433.3,1187.333,100
"21282","62217","2021",36,36,0,111056,1160.806,96.72222
"21283","62218","2021",4,4,0,220000,1947.75,114
"21284","62219","2021",3,3,0,95666.67,976.6667,116.3333
"21285","62220","2021",11,11,0,119318.2,1174.909,92.81818
"21286","62221","2021",4,4,0,127413.2,1320.75,125.5
"21287","62222","2021",4,4,0,71000,729.25,96
"21288","62223","2021",3,3,0,191600,1599.667,116.3333
"21289","62224","2021",33,33,0,116414,1397.333,84.81818
"21290","62225","2021",7,7,0,201742.9,1911.429,116.7143
"21291","62227","2021",1,1,0,396500,3224,123
"21292","62229","2021",4,4,0,181850,1373,130.25
"21293","62230","2021",7,7,0,210207.1,1601.143,140
"21294","62231","2021",6,6,0,208428.8,1566.667,139.6667
"21295","62232","2021",11,11,0,143916.8,1424.727,100.7273
"21296","62233","2021",18,18,0,241025,2173,113.9444
"21297","62234","2021",2,2,0,130000,873,148.5
"21298","62235","2021",44,44,0,328104.5,2668.114,128.3864
"21299","62236","2021",4,4,0,130867.5,1140.5,115
"21300","62237","2021",3,3,0,267610,2462.333,112.6667
"21301","62239","2021",25,23,2,242032.4,2384.04,101.04
"21302","62240","2021",32,32,0,145606.2,1530.844,97.59375
"21303","62241","2021",7,7,0,186571.4,2049.571,90
"21304","62242","2021",3,3,0,70333.33,1106,68.66667
"21305","62243","2021",1,1,0,132800,1581,84
"21306","62244","2021",88,83,5,157266.8,1785.091,88.125
"21307","62245","2021",7,7,0,154742.9,1605.857,95.71429
"21308","62246","2021",1,1,0,252500,1598,158
"21309","62247","2021",4,4,0,100125,1051.25,94.75
"21310","62248","2021",9,9,0,134100,1402.333,95.55556
"21311","62249","2021",74,74,0,157317,1771.851,90.28378
"21312","62250","2021",134,126,8,157585,1725.112,93.29104
"21313","62251","2021",3,3,0,180133.3,2496,80.66667
"21314","62252","2021",37,37,0,209880.1,2028.486,106.5135
"21315","62253","2021",1,1,0,134700,1122,120
"21316","62254","2021",8,8,0,120970.8,1349.125,90.375
"21317","62255","2021",7,7,0,184800,1849.714,96.14286
"21318","62257","2021",8,8,0,91882.5,960,91
"21319","62258","2021",4,4,0,164935.8,1541,104.75
"21320","62259","2021",19,14,5,134750,1437.579,97.57895
"21321","62260","2021",5,5,0,155604,1585.6,100.8
"21322","62261","2021",261,128,133,235077.5,3638.119,67.14943
"21323","62262","2021",18,18,0,151854.7,1712.389,88.55556
"21324","62263","2021",71,68,3,195033.7,1977.014,99.08451
"21325","62264","2021",15,15,0,168089.3,1604.733,108.9333
"21326","62265","2021",18,18,0,141910.3,1380.667,107.3333
"21327","62266","2021",1,1,0,120000,828,145
"21328","62267","2021",4,4,0,99125,1074,89.25
"21329","62268","2021",75,75,0,114062.3,1257.813,93.94667
"21330","62269","2021",10,10,0,138430,1105.7,126.9
"21331","62270","2021",62,56,6,114779.5,1335.371,86.58065
"21332","62271","2021",7,7,0,146685.7,1581.571,94.85714
"21333","62272","2021",6,6,0,117083.3,1351.333,88.66667
"21334","62273","2021",9,9,0,200946.3,2121.556,103
"21335","62274","2021",79,79,0,172230.9,1700.519,103.0759
"21336","62275","2021",7,7,0,113964.3,1261.286,92.14286
"21337","62276","2021",94,93,1,170402.4,1710.723,100.5319
"21338","62277","2021",35,35,0,149015.3,1593.029,94.05714
"21339","62278","2021",8,8,0,167938.8,1463.375,109.5
"21340","62279","2021",23,23,0,280987,2085.304,131.6087
"21341","62280","2021",5,5,0,176600,1988.8,88
"21342","62281","2021",6,6,0,311936.7,2309.667,148.3333
"21343","62282","2021",4,4,0,153125,1137.75,134.75
"21344","62283","2021",4,4,0,129375,1022.5,130.75
"21345","62284","2021",34,34,0,138835.3,1405.147,104.1176
"21346","62285","2021",11,11,0,186157.3,1409.182,134.1818
"21347","62286","2021",1,1,0,30000,462,65
"21348","62288","2021",24,24,0,192205,1798.167,110.25
"21349","62289","2021",13,13,0,190773.1,2257,87.53846
"21350","62290","2021",3,3,0,207100,2069,95.66667
"21351","62291","2021",44,36,8,117421.1,1432.114,83.15909
"21352","62292","2021",9,9,0,129477.8,1585.889,80.44444
"21353","62293","2021",4,4,0,104500,1322.25,77
"21354","62295","2021",32,32,0,132101.6,1364.25,98.375
"21355","62296","2021",4,4,0,210893.8,1894.25,122
"21356","62297","2021",36,36,0,164866.6,1616.306,102.4167
"21357","62298","2021",6,6,0,151575,1333.667,112.5
"21358","62299","2021",1,1,0,390000,2786,140
"21359","62300","2021",48,44,4,200726.3,2499.333,85.64583
"21360","62301","2021",2,2,0,79250,1095.5,75
"21361","62302","2021",6,6,0,147750,1295,117.5
"21362","62303","2021",5,5,0,93350,1116,85.4
"21363","62304","2021",6,6,0,126957.8,1275.5,106.6667
"21364","62306","2021",6,6,0,169270,1445.333,118.6667
"21365","62307","2021",2,2,0,384300,2547,152
"21366","62308","2021",5,5,0,227800,1947,116.2
"21367","62309","2021",21,21,0,152684.3,1543.667,101
"21368","62310","2021",12,12,0,195675,1764.5,103.25
"21369","62311","2021",19,19,0,158592.4,1792.842,86.31579
"21370","62312","2021",1,1,0,251000,2282,110
"21371","62313","2021",17,17,0,119160.6,1189.647,97.35294
"21372","62314","2021",2,2,0,190000,1633.5,116.5
"21373","62315","2021",2,2,0,162500,1460.5,121
"21374","62316","2021",4,4,0,135680,1353.25,104.25
"21375","62317","2021",6,6,0,185445,1628.333,115.6667
"21376","62318","2021",161,143,18,169230.2,2098.366,83.07453
"21377","62319","2021",2,2,0,337900,1972.5,179.5
"21378","62320","2021",6,6,0,162633.3,1489.667,96.5
"21379","62321","2021",59,59,0,174974.9,1741.237,103.4237
"21380","62322","2021",1,1,0,125000,1420,88
"21381","62323","2021",17,17,0,207810.3,1881.706,113.1176
"21382","62324","2021",5,5,0,170480,1649.8,103.2
"21383","62325","2021",17,16,1,139112.6,1301.471,110.4118
"21384","62326","2021",2,2,0,127500,1397,85.5
"21385","62327","2021",6,6,0,136216.7,1233.833,112.6667
"21386","62328","2021",14,14,0,99635.71,976.2857,104.2143
"21387","62329","2021",27,27,0,159296.9,1572.074,106.7407
"21388","62330","2021",14,14,0,199526.5,1895.357,109.5714
"21389","62331","2021",18,18,0,140342.5,1556.111,90.61111
"21390","62332","2021",4,4,0,178820,1498.75,119.75
"21391","62333","2021",8,8,0,125437.5,949.75,138.375
"21392","62334","2021",10,10,0,193150,1830,103.7
"21393","62335","2021",14,14,0,130692.1,1536.071,105.1429
"21394","62336","2021",8,8,0,113125,1024.125,121.875
"21395","62337","2021",3,3,0,130950,1317.667,95
"21396","62338","2021",28,27,1,337150.4,2759.286,119.4643
"21397","62340","2021",10,10,0,125780,1364.4,92.8
"21398","62341","2021",3,3,0,125000,1283.333,97
"21399","62343","2021",6,6,0,162333.3,1454.833,125
"21400","62344","2021",4,4,0,90250,1111.25,77.25
"21401","62345","2021",2,2,0,102500,977,105.5
"21402","62347","2021",2,2,0,82500,1233.5,69.5
"21403","62348","2021",1,1,0,157000,1129,139
"21404","62349","2021",16,16,0,134010.3,1683.688,80.375
"21405","62350","2021",13,13,0,180592.3,1629,108.1538
"21406","62351","2021",55,54,1,116112.9,1320.618,90.09091
"21407","62353","2021",2,2,0,148500,1674,93.5
"21408","62354","2021",17,17,0,171436.5,1667.647,104.2353
"21409","62355","2021",7,7,0,198031.4,2035.571,102.1429
"21410","62356","2021",16,16,0,154894.4,1484.312,99.1875
"21411","62357","2021",2,2,0,105000,1080,85.5
"21412","62359","2021",11,11,0,125036.4,1412.273,89.27273
"21413","62360","2021",14,14,0,209959.9,2080.643,106.7143
"21414","62361","2021",49,49,0,81844.53,903.0612,97.77551
"21415","62362","2021",1,1,0,254600,2767,92
"21416","62363","2021",1,1,0,130000,1529,85
"21417","62364","2021",34,33,1,105652.6,1025.324,105.0588
"21418","62365","2021",1,1,0,110900,821,135
"21419","62367","2021",12,12,0,130025,917.0833,137.3333
"21420","62368","2021",4,4,0,149545,1373.75,113.25
"21421","62369","2021",11,11,0,210972,1883.273,116.4545
"21422","62370","2021",2,2,0,123750,1334,91.5
"21423","62371","2021",33,33,0,200092.9,1813.333,110.2121
"21424","62372","2021",1,1,0,152000,1520,100
"21425","62373","2021",13,13,0,192884.6,1788,106.5385
"21426","62374","2021",1,1,0,90000,1216,74
"21427","62375","2021",2,2,0,168500,1054,160
"21428","62376","2021",26,26,0,198232.4,1757.692,109.5
"21429","62377","2021",5,5,0,147600,1478.2,93.4
"21430","62378","2021",3,3,0,198800,1459.667,141.6667
"21431","62379","2021",9,9,0,190861.1,1623.778,116.2222
"21432","62380","2021",6,6,0,235391.7,2368.667,114.5
"21433","62381","2021",5,5,0,126200,1166.4,130
"21434","62382","2021",3,3,0,139166.7,1104,114
"21435","62383","2021",17,17,0,175205.1,1761.294,102.7059
"21436","62384","2021",9,9,0,119738.9,1061.333,122.1111
"21437","62385","2021",2,2,0,144000,1208.5,91
"21438","62386","2021",45,45,0,141235.5,1453.8,94.31111
"21439","62387","2021",7,7,0,159795.7,1230,131.2857
"21440","62388","2021",3,3,0,184333.3,1584,119.6667
"21441","62389","2021",1,1,0,150000,1667,90
"21442","62390","2021",14,14,0,278948.6,2761.143,101.8571
"21443","62391","2021",10,10,0,115074,1208.6,94.5
"21444","62392","2021",3,3,0,234200,1957.667,137.3333
"21445","62393","2021",11,11,0,207168.2,2057.182,102.0909
"21446","62395","2021",3,3,0,126000,1481.667,85.66667
"21447","62397","2021",61,61,0,144621.7,1587.787,90.72131
"21448","62398","2021",7,7,0,182724.3,1464.857,120
"21449","62399","2021",8,8,0,237607.5,1777.75,139.125
"21450","62400","2021",39,39,0,126687,1387.359,92.17949
"21451","62401","2021",49,49,0,183534.4,1834.755,101.551
"21452","62402","2021",9,9,0,162777.8,1913.444,95.33333
"21453","62403","2021",9,9,0,136205.6,1566.333,89.33333
"21454","62405","2021",1,1,0,167000,2169,77
"21455","62406","2021",5,5,0,182550,1477.2,126.8
"21456","62407","2021",12,12,0,161125,1366.25,116.3333
"21457","62408","2021",19,19,0,180647.4,1989.895,91.31579
"21458","62409","2021",2,2,0,93500,818,117
"21459","62410","2021",4,4,0,199694.2,1564.5,132.25
"21460","62411","2021",1,1,0,83000,790,105
"21461","62412","2021",16,16,0,197700.1,2015.938,101.875
"21462","62413","2021",133,131,2,137713.6,1584.12,89.25564
"21463","62414","2021",5,5,0,149664,1467.6,100.2
"21464","62415","2021",4,4,0,296975,1815.75,173.25
"21465","62416","2021",3,3,0,184333.3,1596,111.6667
"21466","62418","2021",1,1,0,152800,1777,86
"21467","62419","2021",2,2,0,166500,1205,139.5
"21468","62421","2021",7,7,0,135400,1083.714,133.7143
"21469","62422","2021",6,6,0,158866.7,1228,137.3333
"21470","62423","2021",24,24,0,161129.2,1701.458,97
"21471","62424","2021",6,6,0,85000,1106.333,85.33333
"21472","62426","2021",2,2,0,266500,1632,163
"21473","62427","2021",349,308,41,126807.1,1419.693,91.27794
"21474","62428","2021",1,1,0,105000,1438,73
"21475","62429","2021",4,4,0,202535,1791,113.5
"21476","62430","2021",2,2,0,132000,1481,88.5
"21477","62432","2021",4,4,0,221250,2251.5,93
"21478","62433","2021",1,1,0,60000,583,103
"21479","62434","2021",1,1,0,132000,1970,67
"21480","62435","2021",1,1,0,85000,904,94
"21481","62436","2021",3,3,0,144333.3,1492,97
"21482","62437","2021",5,5,0,127860,1916.8,87.6
"21483","62438","2021",7,7,0,244235.7,1852.286,131.7143
"21484","62439","2021",2,2,0,157000,1574,104.5
"21485","62440","2021",18,18,0,115338.9,1229.667,95.11111
"21486","62442","2021",1,1,0,110000,738,149
"21487","62443","2021",59,57,2,140548.6,1506.78,94.47458
"21488","62444","2021",2,2,0,265000,2054,133.5
"21489","62445","2021",11,11,0,162045.5,1600.727,97.81818
"21490","62446","2021",18,17,1,206213.9,2119.944,100.3333
"21491","62447","2021",40,36,4,96985.62,1137.275,92.125
"21492","62448","2021",24,24,0,211972.3,1935.292,106.2917
"21493","62450","2021",4,4,0,153825,1561.5,100.5
"21494","62451","2021",7,7,0,97300,825.5714,134
"21495","62452","2021",18,18,0,228869.2,1995.222,116
"21496","62453","2021",2,2,0,186000,1963,96
"21497","62454","2021",30,30,0,199186.7,1905,107.6667
"21498","62456","2021",7,7,0,189120.7,1772.571,101.7143
"21499","62457","2021",69,69,0,140317.1,1392.565,102.7101
"21500","62458","2021",13,13,0,202343.5,1712.077,131.3077
"21501","62459","2021",3,3,0,90333.33,852.3333,105
"21502","62460","2021",6,6,0,177666.7,2261.167,80.33333
"21503","62461","2021",19,19,0,114840.8,1214.421,90.84211
"21504","62462","2021",2,2,0,132500,892.5,153.5
"21505","62463","2021",2,2,0,67500,2142,35.5
"21506","62464","2021",26,26,0,182122.2,1848.5,101.8846
"21507","62465","2021",2,2,0,265800,2548.5,113
"21508","62466","2021",4,4,0,1e+05,1122,93
"21509","62467","2021",3,3,0,123666.7,1629.333,86.33333
"21510","62468","2021",3,3,0,112333.3,923.3333,122
"21511","62469","2021",4,4,0,153075,1952,73.5
"21512","62470","2021",2,2,0,140250,785.5,172.5
"21513","62471","2021",6,6,0,163661.7,1402.167,116.1667
"21514","62472","2021",3,3,0,354666.7,2162.667,155
"21515","62473","2021",121,116,5,115184.3,1296.372,88.89256
"21516","62474","2021",18,17,1,241284.2,1852.111,116.6111
"21517","62475","2021",5,5,0,112510,1165.2,105.2
"21518","62476","2021",14,14,0,163117.9,1737.286,93.28571
"21519","62477","2021",3,3,0,137666.7,1492,94.66667
"21520","62478","2021",6,6,0,154760,1382.167,110.8333
"21521","62479","2021",22,22,0,142709.1,1406.409,101.8182
"21522","62480","2021",32,31,1,182994.3,1583.469,114.6875
"21523","62481","2021",1,1,0,76000,724,105
"21524","62483","2021",3,3,0,295540,2089.333,127
"21525","62484","2021",8,8,0,180368.8,1498.875,117.875
"21526","62485","2021",8,8,0,134393.8,1293.125,99.5
"21527","62486","2021",7,7,0,147394.3,1492,101
"21528","62487","2021",11,11,0,167463.6,1628.909,106.6364
"21529","62488","2021",4,4,0,129750,1181.5,107.5
"21530","62489","2021",47,47,0,129228.5,1504.085,88.59574
"21531","62490","2021",4,4,0,252425,1849,146.25
"21532","62491","2021",75,69,6,243835.7,2179.187,112.76
"21533","62492","2021",4,4,0,124900,1655.75,113.75
"21534","62493","2021",4,4,0,156750,1111.25,141.25
"21535","62495","2021",2,2,0,90000,1178,77
"21536","62496","2021",3,3,0,206241.7,1882.333,108
"21537","62497","2021",61,61,0,176181.2,1840.508,96.78689
"21538","62498","2021",341,236,105,122604.5,1554.991,83.77713
"21539","62499","2021",4,4,0,94250,1014,89.25
"21540","62501","2021",5,5,0,115460,1007.6,121.4
"21541","62502","2021",54,54,0,220391.4,2188.981,103.7222
"21542","62503","2021",4,4,0,263887.5,2211.75,123.25
"21543","62504","2021",2,2,0,171000,1221.5,140
"21544","62505","2021",6,6,0,198189.7,2231.167,90
"21545","62506","2021",21,21,0,159095.2,1398.048,112.0476
"21546","62507","2021",1,1,0,450000,3214,140
"21547","62508","2021",2,2,0,66500,1040.5,63
"21548","62509","2021",5,5,0,196540,1768,117.8
"21549","62510","2021",282,253,29,124825.3,1438.468,87.71631
"21550","62511","2021",2,2,0,82500,1189,74
"21551","62512","2021",8,8,0,127196.2,1186.125,111.875
"21552","62513","2021",3,3,0,139333.3,1089.667,129.6667
"21553","62514","2021",1,1,0,225000,2027,111
"21554","62515","2021",4,4,0,145422.5,1579.5,92.75
"21555","62516","2021",143,143,0,104819.5,1141.643,89.86014
"21556","62517","2021",1,1,0,220000,1679,131
"21557","62518","2021",2,2,0,177395,1267,161.5
"21558","62519","2021",5,5,0,133300,1093.2,131.6
"21559","62520","2021",30,30,0,241149.9,1932.467,122.9
"21560","62521","2021",3,3,0,124143.3,1292,93
"21561","62522","2021",5,5,0,201380,1601.4,137.6
"21562","62523","2021",66,64,2,126307.8,1497.379,85.27273
"21563","62524","2021",17,17,0,135535.3,1545.471,86.58824
"21564","62525","2021",94,86,8,160227.3,1712.255,94.41489
"21565","62526","2021",3,3,0,201666.7,1837.667,114.3333
"21566","62527","2021",4,4,0,156750,1666.75,97
"21567","62528","2021",66,62,4,159114.5,1558.545,104.7576
"21568","62529","2021",13,13,0,378287.4,2693,141.6154
"21569","62530","2021",7,7,0,127000,1295.429,110.8571
"21570","62531","2021",9,9,0,171444.4,1487.333,111.3333
"21571","62532","2021",12,12,0,155243.8,1377.25,110.6667
"21572","62533","2021",6,6,0,108833.3,1132.5,98.83333
"21573","62534","2021",66,66,0,159767.1,1492.455,107
"21574","62535","2021",4,4,0,103250,1626,66.25
"21575","62536","2021",5,5,0,125485,1165.4,107
"21576","62537","2021",1,1,0,124000,1216,102
"21577","62538","2021",3,3,0,330333.3,1830.333,164.6667
"21578","62539","2021",1,1,0,210000,2625,80
"21579","62540","2021",14,14,0,196738.1,2215.286,98.42857
"21580","62542","2021",1,1,0,2e+05,2222,90
"21581","62543","2021",18,18,0,154056.7,1954.667,99.94444
"21582","62544","2021",1,1,0,82673,1021,81
"21583","62545","2021",1,1,0,139000,713,195
"21584","62546","2021",4,4,0,260875,1798.75,143
"21585","62547","2021",5,5,0,164300,1505.2,112.8
"21586","62548","2021",113,109,4,185325.6,1814.451,103.4867
"21587","62549","2021",26,26,0,125134.6,1278.923,99.26923
"21588","62550","2021",17,17,0,99463.29,1021.353,96.58824
"21589","62551","2021",4,4,0,139875,1315.75,116.25
"21590","62552","2021",16,16,0,123307.2,1323.938,100.9375
"21591","62553","2021",3,3,0,179333.3,2213.333,80.33333
"21592","62555","2021",37,37,0,116369.8,1309,90.27027
"21593","62556","2021",11,11,0,90350,2177.818,51.90909
"21594","62557","2021",19,19,0,247270.8,2112.316,115.7895
"21595","62558","2021",1,1,0,138000,1468,94
"21596","62559","2021",10,10,0,163400,1199.3,144.8
"21597","62560","2021",72,69,3,156636.5,1714.361,94.11111
"21598","62562","2021",4,4,0,100750,1046.5,105.25
"21599","62563","2021",69,63,6,140360.2,1611.217,88.95652
"21600","62564","2021",2,2,0,188550,1911.5,97.5
"21601","62565","2021",1,1,0,70000,854,82
"21602","62566","2021",8,8,0,208325,1807.5,116.25
"21603","62567","2021",6,6,0,166084.3,1519.5,110.6667
"21604","62568","2021",9,9,0,218393.3,1878.778,111.1111
"21605","62569","2021",6,6,0,96500,963.5,96.66667
"21606","62570","2021",124,124,0,137066.1,1572.823,86.87903
"21607","62571","2021",232,117,115,186281,3143.897,64.81897
"21608","62572","2021",13,13,0,99098.46,922.9231,106.7692
"21609","62573","2021",44,44,0,153400.2,1761.364,89.77273
"21610","62574","2021",3,3,0,135333.3,1460.333,93.33333
"21611","62576","2021",3,3,0,110333.3,1232,88.33333
"21612","62577","2021",3,3,0,126333.3,1246.667,102
"21613","62579","2021",8,8,0,163475,1351.375,122.25
"21614","62580","2021",3,3,0,106333.3,817,119
"21615","62581","2021",5,5,0,104240,943.6,123.6
"21616","62582","2021",11,11,0,192880,1725.818,118
"21617","62583","2021",4,4,0,117925,1117,105.5
"21618","62584","2021",15,15,0,150376.7,1596.2,92.26667
"21619","62585","2021",8,8,0,191700,1842.75,102.125
"21620","62586","2021",6,6,0,278618.7,1791.833,152
"21621","62587","2021",106,88,18,127891.1,1451.481,89.12264
"21622","62588","2021",40,33,7,248766,2611.5,97.3
"21623","62589","2021",15,14,1,244572.7,1603.4,148.4667
"21624","62590","2021",1,1,0,190000,657,289
"21625","62591","2021",3,3,0,198500,1877.667,105.6667
"21626","62592","2021",2,2,0,150500,1818,115
"21627","62594","2021",4,4,0,130000,1067.75,116
"21628","62595","2021",13,13,0,168213.4,1527.846,109.8462
"21629","62596","2021",6,6,0,179500,1263.5,159
"21630","62597","2021",6,6,0,147406.7,1400.5,105.3333
"21631","62598","2021",8,8,0,142112.5,1375.625,105
"21632","62599","2021",4,4,0,197750,1921,101
"21633","62600","2021",3,3,0,154166.7,2110.667,67.33333
"21634","62601","2021",3,3,0,174710,1502.333,118
"21635","62602","2021",6,6,0,182063.3,1443.333,121
"21636","62603","2021",14,14,0,159789.3,1923.786,85.35714
"21637","62604","2021",205,91,114,333817.9,4198.615,87.22927
"21638","62606","2021",19,19,0,275008.6,2219.421,128.1053
"21639","62608","2021",5,5,0,103950,1216.4,86.2
"21640","62609","2021",18,17,1,237147.9,2038.944,118.7778
"21641","62610","2021",12,12,0,126166.7,1372.833,90.91667
"21642","62611","2021",6,6,0,168083.3,1660.167,101.6667
"21643","62612","2021",11,11,0,210581.8,1916.545,121.3636
"21644","62613","2021",12,12,0,145875,1176.917,116.0833
"21645","62614","2021",5,5,0,161770,1272.4,124.4
"21646","62615","2021",2,2,0,204750,2176,96.5
"21647","62616","2021",2,2,0,171637.5,1151,157.5
"21648","62617","2021",124,113,11,119139.4,1443.226,84.45161
"21649","62618","2021",16,16,0,205332.5,1855.375,111.9375
"21650","62620","2021",14,14,0,125130,1216.571,110
"21651","62621","2021",17,17,0,199420.6,1848.529,107.7647
"21652","62622","2021",3,3,0,175766.7,1475,113
"21653","62623","2021",15,15,0,181668.8,1763.4,103.5333
"21654","62624","2021",49,49,0,152841.4,1632.469,93.44898
"21655","62626","2021",24,24,0,186532.1,1778.708,110.5417
"21656","62627","2021",9,9,0,137111.1,1569,82.77778
"21657","62628","2021",50,49,1,129237,1430.7,91.28
"21658","62629","2021",3,3,0,145166.7,1557.333,92
"21659","62630","2021",2,2,0,244750,2616,96
"21660","62631","2021",3,3,0,145666.7,1600.333,91
"21661","62632","2021",1,1,0,67000,1117,60
"21662","62633","2021",3,3,0,106666.7,1077.333,96
"21663","62634","2021",14,14,0,257470.2,1888.786,138.1429
"21664","62635","2021",3,3,0,206666.7,1781.667,119.6667
"21665","62636","2021",3,3,0,339600,2739,126
"21666","62637","2021",92,82,10,150436.1,1743.62,88.13043
"21667","62638","2021",12,12,0,140131.2,1179.333,125
"21668","62639","2021",5,5,0,202650,1815.6,111.2
"21669","62640","2021",4,4,0,114000,960.5,115.25
"21670","62641","2021",5,5,0,149120,1502.4,96.6
"21671","62642","2021",10,10,0,104920,947.1,107.7
"21672","62643","2021",163,151,12,136048.4,1528.706,91.52761
"21673","62644","2021",8,8,0,128062.5,1191,113.375
"21674","62645","2021",90,85,5,180367,1829.311,100.4111
"21675","62646","2021",2,2,0,95550,1128,86
"21676","62647","2021",12,12,0,129973.2,1227.917,111.0833
"21677","62648","2021",4,4,0,193000,1911.5,110.5
"21678","62649","2021",7,6,1,143057.1,1568.714,95.85714
"21679","62650","2021",8,8,0,207809.4,1773.375,116
"21680","62651","2021",3,3,0,176140,1561.333,101.6667
"21681","62652","2021",25,25,0,131770,1315.2,97.68
"21682","62653","2021",8,8,0,228525,2211.25,107.625
"21683","62654","2021",6,5,1,208400,1890.833,109
"21684","62655","2021",4,4,0,105708,1155.25,106
"21685","62656","2021",15,15,0,214551.7,1494.133,139.8
"21686","62657","2021",5,5,0,262188.2,2473,120.2
"21687","62659","2021",3,3,0,106666.7,1051.667,105
"21688","62660","2021",6,6,0,166679.8,1576,106.1667
"21689","62661","2021",7,7,0,112807,1136.429,102.8571
"21690","62662","2021",10,10,0,165520,1724.3,89.2
"21691","62663","2021",4,4,0,120550,1278.25,106.25
"21692","62664","2021",2,2,0,249100,1938,127.5
"21693","62665","2021",5,5,0,75400,879.2,86.8
"21694","62666","2021",38,38,0,134857.4,1583.895,86.94737
"21695","62667","2021",146,100,46,124881.3,1647.63,80.08904
"21696","62668","2021",4,4,0,141250,1556,97.25
"21697","62669","2021",2,2,0,150000,1369,106.5
"21698","62670","2021",10,10,0,152800,1698.7,92.1
"21699","62671","2021",5,5,0,102800,1023.4,94.6
"21700","62672","2021",8,8,0,119775,1174.375,101.25
"21701","62673","2021",6,6,0,147521.7,1356.333,100.8333
"21702","62674","2021",7,7,0,232535.7,1760.857,143.1429
"21703","62675","2021",2,2,0,183225,1830.5,100
"21704","62676","2021",4,4,0,117675,1314.25,93
"21705","62677","2021",4,4,0,182750,1295,140.5
"21706","62678","2021",12,12,0,224762.2,1690.083,142.8333
"21707","62679","2021",3,3,0,172000,2172.667,91.66667
"21708","62680","2021",3,3,0,265366.7,2329.667,112.3333
"21709","62681","2021",5,5,0,170860,1657.8,103
"21710","62683","2021",4,4,0,73375,775.75,87.25
"21711","62684","2021",29,29,0,153955.9,1485.103,103.0345
"21712","62685","2021",6,6,0,110678,1236,97.16667
"21713","62686","2021",3,3,0,197333.3,1314.333,151.6667
"21714","62688","2021",90,89,1,203251.7,2219.211,89.63333
"21715","62689","2021",6,6,0,169454.2,1612.833,112.8333
"21716","62690","2021",5,5,0,131000,1483.4,85.8
"21717","62691","2021",10,10,0,209137,1497.2,146.8
"21718","62692","2021",2,2,0,132500,1134,112.5
"21719","62693","2021",3,3,0,104666.7,887.6667,132.3333
"21720","62694","2021",3,3,0,289093.3,2285.667,125.6667
"21721","62695","2021",3,3,0,125200,1148.333,108.3333
"21722","62696","2021",2,2,0,221250,1827,124
"21723","62697","2021",7,7,0,233504.3,2654,98.85714
"21724","62698","2021",7,7,0,227714.3,1627.714,135.2857
"21725","62699","2021",5,5,0,151284.6,1626.2,93.8
"21726","62700","2021",5,5,0,132960,1213.2,110.2
"21727","62701","2021",7,7,0,116857.1,1177,92.28571
"21728","62702","2021",5,5,0,103100,1101.8,99.6
"21729","62703","2021",1,1,0,217500,2153,101
"21730","62704","2021",11,11,0,163370.9,1215,133.6364
"21731","62705","2021",15,15,0,154986.7,1745.6,89.86667
"21732","62706","2021",16,16,0,257203.8,2101.375,130.875
"21733","62709","2021",3,3,0,179166.7,2237,86.33333
"21734","62711","2021",51,51,0,152304.7,1634.059,95.05882
"21735","62712","2021",13,13,0,224500,1789.769,127.4615
"21736","62713","2021",13,13,0,194356.5,1879.538,106.4615
"21737","62714","2021",9,9,0,231787.8,2086.889,110.5556
"21738","62715","2021",3,3,0,117416.7,1204.333,104.3333
"21739","62716","2021",7,7,0,195714.3,1573.143,126.7143
"21740","62717","2021",7,7,0,169961.4,1368.286,127.4286
"21741","62718","2021",19,19,0,171960.5,1797.263,97.63158
"21742","62719","2021",1,1,0,82000,506,162
"21743","62720","2021",3,3,0,115966.7,1395.333,82.66667
"21744","62721","2021",23,23,0,190436.5,1656.913,115.3043
"21745","62722","2021",3,3,0,128400,1489.333,85
"21746","62723","2021",4,4,0,222621.2,2372.5,96
"21747","62724","2021",72,71,1,148964.4,1621.417,93.26389
"21748","62725","2021",1,1,0,152000,1322,115
"21749","62726","2021",1,1,0,176500,1961,90
"21750","62727","2021",15,15,0,157117.3,1847.667,86.93333
"21751","62728","2021",9,9,0,184916.7,1516.444,123.3333
"21752","62729","2021",4,4,0,114500,1437.75,81
"21753","62730","2021",18,18,0,186061.7,1868,102.0556
"21754","62731","2021",9,9,0,89845.67,920.1111,93.77778
"21755","62732","2021",3,3,0,187000,1329,142.3333
"21756","62733","2021",2,2,0,104800,1001,119
"21757","62734","2021",4,4,0,217532.5,1712,126.25
"21758","62735","2021",27,27,0,169128.9,1793.074,95.88889
"21759","62736","2021",50,47,3,243957.5,2306.56,105.3
"21760","62737","2021",74,67,7,151635.3,1706.662,90
"21761","62738","2021",5,5,0,111163.2,1247,88.2
"21762","62740","2021",4,4,0,190937.5,1436.5,146
"21763","62741","2021",1,1,0,339000,2897,117
"21764","62742","2021",3,3,0,269666.7,2288.667,117
"21765","62743","2021",5,5,0,125000,1360.6,93
"21766","62744","2021",42,36,6,212591.3,1938.238,109.7381
"21767","62745","2021",3,3,0,103666.7,1206,92
"21768","62746","2021",71,71,0,166580.5,1845.915,91.19718
"21769","62747","2021",5,5,0,192450,1561.4,121.4
"21770","62748","2021",18,18,0,184271.7,1679.333,112.4444
"21771","62749","2021",5,5,0,134600,1421.6,99.6
"21772","62750","2021",7,7,0,192634.3,1617,120
"21773","62751","2021",11,11,0,219408.4,2099.909,108.0909
"21774","62752","2021",21,21,0,351871.1,2430.333,152
"21775","62753","2021",88,64,24,181748,2143.705,86.97727
"21776","62754","2021",8,8,0,137262.9,1581,90.5
"21777","62755","2021",46,46,0,178846.4,1874.522,95.69565
"21778","62756","2021",16,16,0,136896.9,1334.188,111.5625
"21779","62757","2021",76,72,4,167988.7,1739.711,98.05263
"21780","62758","2021",186,139,47,174255.1,1917.226,93.58065
"21781","62759","2021",6,6,0,143000,1314.333,110.1667
"21782","62760","2021",7,7,0,151614.3,1205.429,111.4286
"21783","62761","2021",2,2,0,177500,2032.5,87.5
"21784","62762","2021",5,5,0,127600,1208,115.2
"21785","62763","2021",11,11,0,121181.8,1148.091,107.4545
"21786","62764","2021",32,28,4,188081.8,1957.562,102.1562
"21787","62765","2021",239,147,92,139578.8,1630.28,88.8159
"21788","62766","2021",18,18,0,227737.8,1942.389,120.1111
"21789","62767","2021",93,83,10,107750.5,1167.118,96.32258
"21790","62768","2021",5,5,0,99320,983.8,104
"21791","62769","2021",6,6,0,224500,2084.667,109.1667
"21792","62770","2021",34,32,2,162869.8,1568.912,104
"21793","62771","2021",58,56,2,118045.1,1419.759,85.06897
"21794","62772","2021",9,9,0,154933.3,1625,101.7778
"21795","62773","2021",74,74,0,153119.7,1804.149,85.37838
"21796","62774","2021",65,50,15,185887.5,2384.862,82.66154
"21797","62775","2021",5,5,0,127400,1505.8,85.4
"21798","62776","2021",4,4,0,142000,1053.5,151.25
"21799","62777","2021",2,2,0,60000,1191,51.5
"21800","62779","2021",4,4,0,168750,1605.5,106.5
"21801","62780","2021",5,5,0,153720,1253,125.2
"21802","62781","2021",12,12,0,166035,1535.833,117.6667
"21803","62782","2021",2,2,0,71450,916,78
"21804","62783","2021",4,4,0,95550,854.5,108.25
"21805","62784","2021",9,9,0,117328.9,1303.222,89.66667
"21806","62785","2021",11,11,0,172204.3,1559.636,116
"21807","62786","2021",5,5,0,192600,1594,122.8
"21808","62787","2021",7,7,0,174921.4,1421.714,123.8571
"21809","62788","2021",7,7,0,149604.7,1444,104.4286
"21810","62792","2021",17,17,0,155142.8,1495.824,101
"21811","62793","2021",7,7,0,198642.9,1790.571,111.4286
"21812","62794","2021",9,9,0,122975.6,1209.111,100.4444
"21813","62795","2021",2,2,0,139200,1223,115
"21814","62796","2021",12,12,0,210115.2,1957,108.5833
"21815","62797","2021",3,3,0,170000,1696.333,100.6667
"21816","62798","2021",2,2,0,132850,1369,96
"21817","62799","2021",10,10,0,284800,2187,129.3
"21818","62800","2021",2,2,0,191250,1531.5,127
"21819","62801","2021",40,38,2,195251,1888.4,102.5
"21820","62802","2021",4,4,0,152550,1586.25,108
"21821","62803","2021",3,3,0,147333.3,2222.667,79.33333
"21822","62804","2021",1,1,0,101500,1128,90
"21823","62805","2021",2,2,0,312500,1630.5,185
"21824","62806","2021",1,1,0,230000,1917,120
"21825","62808","2021",6,6,0,142333.3,1572.833,90.83333
"21826","62809","2021",1,1,0,120000,1290,93
"21827","62810","2021",11,10,1,207279.5,1776.636,123.2727
"21828","62811","2021",16,16,0,154100,1484.312,106.1875
"21829","62812","2021",12,12,0,175770.8,1444.833,125
"21830","62813","2021",5,5,0,148800,1677.4,92.6
"21831","62815","2021",4,4,0,299540,2769.5,96.25
"21832","62816","2021",2,2,0,184000,1884,105
"21833","62817","2021",13,12,1,173781.5,1826.538,90.38462
"21834","62818","2021",4,4,0,121175,1425,82.5
"21835","62819","2021",12,12,0,161538.5,1702.75,88.91667
"21836","62820","2021",8,8,0,177516.4,1725.875,109.5
"21837","62822","2021",2,2,0,231500,1742.5,138.5
"21838","62823","2021",4,4,0,183250,1088,181.75
"21839","62824","2021",4,4,0,121250,991.25,122.75
"21840","62825","2021",7,7,0,215844.3,1790.286,129.8571
"21841","62826","2021",440,134,306,564839.6,7744.893,74.33636
"21842","62827","2021",8,8,0,173525,1541.25,111.25
"21843","62829","2021",5,5,0,128900,1179,109
"21844","62831","2021",7,7,0,140957.1,1341.857,108.4286
"21845","62832","2021",8,8,0,195131.6,1751.375,121.625
"21846","62833","2021",3,3,0,110191.7,1226.667,94.33333
"21847","62834","2021",3,3,0,109000,1053,102.6667
"21848","62835","2021",8,8,0,136687.5,1148.125,119.125
"21849","62836","2021",13,13,0,241438.8,2139.077,114.2308
"21850","62837","2021",7,7,0,171935.7,1432.714,119.2857
"21851","62838","2021",3,3,0,127500,1304.667,107.3333
"21852","62839","2021",15,15,0,160271.3,1108.2,146.2667
"21853","62840","2021",2,2,0,85750,1083,73.5
"21854","62841","2021",25,25,0,140689,1539.6,91.4
"21855","62842","2021",80,75,5,171626.2,1815.037,93.2625
"21856","62843","2021",5,5,0,146398,1354,105
"21857","62844","2021",8,8,0,137293.8,1357,103.125
"21858","62845","2021",3,3,0,246016.7,2171.333,114
"21859","62846","2021",34,34,0,146407.9,1508.794,101
"21860","62847","2021",17,17,0,153608.8,1498.529,101.9412
"21861","62848","2021",38,35,3,145218.1,1593.079,92.97368
"21862","62849","2021",28,28,0,224681.1,2295.321,98.57143
"21863","62850","2021",10,10,0,154084,1206.7,133
"21864","62851","2021",7,7,0,233442.9,2064,122.7143
"21865","62852","2021",18,18,0,203389.7,2003.167,116
"21866","62853","2021",8,8,0,190500,1671.25,122.5
"21867","62854","2021",3,3,0,250000,1776.333,140.6667
"21868","62855","2021",6,6,0,163808.3,1464.833,115.8333
"21869","62856","2021",2,2,0,82500,829.5,97.5
"21870","62857","2021",2,2,0,138000,964.5,154
"21871","62858","2021",2,2,0,124600,1189.5,110.5
"21872","62859","2021",3,3,0,87000,837,102.3333
"21873","62861","2021",54,53,1,195742.4,1991.981,98.25926
"21874","62862","2021",2,2,0,100600,806,128
"21875","62863","2021",1,1,0,175900,2410,73
"21876","62864","2021",15,15,0,175642.2,1542.8,114.3333
"21877","62865","2021",67,66,1,169619.5,1819.478,93.0597
"21878","62866","2021",5,5,0,330900,2271.2,116.4
"21879","62867","2021",2,2,0,325009,2041.5,157
"21880","62868","2021",9,9,0,149585.6,1197.444,126.3333
"21881","62869","2021",9,9,0,194741.7,1761.222,111.2222
"21882","62870","2021",15,15,0,206527.6,2213.933,95.4
"21883","62871","2021",2,2,0,181000,1128,153.5
"21884","62872","2021",2,2,0,105000,1443.5,72.5
"21885","62873","2021",2,2,0,290275,2452.5,119.5
"21886","62874","2021",16,16,0,229779.4,1815.312,131.0625
"21887","62875","2021",13,13,0,192623.1,1765.769,108.4615
"21888","62876","2021",2,2,0,163700,1546,107.5
"21889","62877","2021",3,3,0,142250,918,157.3333
"21890","62878","2021",7,7,0,264855.7,1810.571,154.7143
"21891","62879","2021",5,5,0,146954,1239.4,116.2
"21892","62880","2021",2,2,0,120000,1939.5,62.5
"21893","62881","2021",8,8,0,125348.8,1144.5,131.125
"21894","62882","2021",15,15,0,151432.3,1381.333,106.8667
"21895","62883","2021",2,2,0,321000,5113.5,81.5
"21896","62885","2021",6,6,0,128666.7,1603.833,86.83333
"21897","62886","2021",4,4,0,106400,1315,87.25
"21898","62887","2021",7,7,0,181078.6,1674.714,113.1429
"21899","62888","2021",5,5,0,199500,1848.6,122.6
"21900","62889","2021",7,7,0,210078.6,2254.714,95.14286
"21901","62890","2021",5,5,0,136201.8,1201,118
"21902","62891","2021",1,1,0,85000,966,88
"21903","62892","2021",8,8,0,188471.2,1600.125,115.25
"21904","62893","2021",184,98,86,291068.8,3856.321,80.10326
"21905","62894","2021",63,59,4,233305.3,2448.937,98
"21906","62895","2021",99,96,3,152564.6,1684.394,94.31313
"21907","62896","2021",13,13,0,253574.6,1841.462,140.2308
"21908","62897","2021",4,4,0,172150,1415.75,128.75
"21909","62898","2021",2,2,0,208675,1718.5,116
"21910","62899","2021",37,17,20,293970.3,4269.892,76.86486
"21911","62900","2021",6,6,0,195960,1550.333,123.1667
"21912","62901","2021",12,12,0,203924.2,1990.167,109.3333
"21913","62902","2021",45,45,0,128925.6,1510.556,88.24444
"21914","62903","2021",8,8,0,173988.9,1612.875,112.125
"21915","62904","2021",11,11,0,161600,1658.273,96.09091
"21916","62905","2021",11,11,0,192079.5,1616.818,124.4545
"21917","62906","2021",23,23,0,189767.4,1880.435,106.5652
"21918","62907","2021",63,62,1,167692.4,1844.778,91.66667
"21919","62908","2021",23,23,0,322432.6,2408.043,135.1739
"21920","62909","2021",7,7,0,84740,955.2857,80.85714
"21921","63001","2021",22,21,1,154986.2,1468.455,106.9091
"21922","63002","2021",3,3,0,124100,812.6667,153
"21923","63003","2021",50,46,4,114303.6,1232.22,90.52
"21924","63004","2021",10,10,0,132120,1234.4,110.2
"21925","63005","2021",1,1,0,37500,1103,34
"21926","63006","2021",2,2,0,52150,565.5,103.5
"21927","63007","2021",3,3,0,97996.67,907.6667,108.6667
"21928","63008","2021",3,3,0,54263.33,616,88.66667
"21929","63009","2021",5,5,0,52900,603.6,85
"21930","63010","2021",17,17,0,83504.47,1053.529,77.29412
"21931","63011","2021",4,4,0,83375,889.25,86.25
"21932","63012","2021",4,4,0,251862.5,2241.5,114.5
"21933","63013","2021",7,7,0,183692.9,1746.857,107.1429
"21934","63014","2021",58,42,16,188880.7,2244.707,84.84483
"21935","63015","2021",2,2,0,126000,601.5,194.5
"21936","63016","2021",8,8,0,109021.2,943.875,109.375
"21937","63017","2021",2,2,0,51370,803.5,63.5
"21938","63019","2021",24,20,4,176255,2106.917,86.25
"21939","63020","2021",2,2,0,172115,1565.5,99
"21940","63021","2021",4,4,0,153125,1938.75,101.25
"21941","63022","2021",14,14,0,95140,1286.5,69.78571
"21942","63023","2021",7,7,0,93447.14,986.4286,116
"21943","63024","2021",4,3,1,103237.5,2099.25,67
"21944","63026","2021",18,18,0,178013.9,1928.222,89.33333
"21945","63027","2021",4,4,0,115450,1003,135.5
"21946","63028","2021",3,3,0,86366.67,1306.333,61
"21947","63030","2021",3,3,0,152966.7,1501.333,93
"21948","63031","2021",4,4,0,61125,960.5,74.75
"21949","63032","2021",81,34,47,175539.1,2202.58,77.71605
"21950","63033","2021",1,1,0,209300,2032,103
"21951","63034","2021",7,7,0,186035.7,2007,86.57143
"21952","63035","2021",4,4,0,188957.5,2050,92.5
"21953","63036","2021",1,1,0,160000,1839,87
"21954","63037","2021",6,6,0,118000,1070,115.5
"21955","63038","2021",58,8,50,101691.9,2552.103,39.05172
"21956","63039","2021",3,3,0,48453,500.6667,91.66667
"21957","63040","2021",33,31,2,170379.1,1620.303,107.5758
"21958","63041","2021",3,3,0,160666.7,1678.667,92
"21959","63042","2021",18,18,0,210858.2,2213.056,99.77778
"21960","63043","2021",6,6,0,154375,838.6667,176.5
"21961","63044","2021",6,6,0,104271.7,1131.167,87.33333
"21962","63045","2021",4,4,0,225037.5,1974,107
"21963","63046","2021",5,5,0,94880,1024.4,76.6
"21964","63047","2021",54,13,41,65530.41,1404.963,49.38889
"21965","63048","2021",8,8,0,81031.25,1279.5,83.25
"21966","63049","2021",5,5,0,146983,1748.4,80.6
"21967","63050","2021",21,21,0,103135.5,1242.286,84
"21968","63051","2021",5,5,0,130352,1413.8,91
"21969","63052","2021",4,3,1,64210,1057.5,57.75
"21970","63053","2021",1,1,0,67020,479,140
"21971","63054","2021",6,6,0,146683.3,1780.5,79
"21972","63055","2021",10,10,0,92746.5,1101.5,86.9
"21973","63056","2021",4,4,0,109332.5,1153,87.25
"21974","63057","2021",3,3,0,91166.67,724.6667,115.3333
"21975","63058","2021",1,1,0,298000,2055,145
"21976","63059","2021",1,1,0,84000,1151,73
"21977","63061","2021",4,4,0,182062.5,1579.5,115.75
"21978","63063","2021",43,35,8,192355,2180.674,89.69767
"21979","63064","2021",2,2,0,85500,840,98.5
"21980","63065","2021",6,6,0,88603.33,1060.167,88.16667
"21981","63066","2021",14,14,0,113065.6,934.7857,109.5
"21982","63067","2021",1,1,0,90000,882,102
"21983","63069","2021",31,23,8,185383.9,2029.774,94
"21984","63070","2021",39,36,3,333692.3,2647.795,126.1026
"21985","63071","2021",2,2,0,239220,2011.5,119
"21986","63072","2021",4,4,0,84875,1092.5,92
"21987","63073","2021",1,1,0,184385,1707,108
"21988","63074","2021",2,2,0,252789.5,1980.5,126.5
"21989","63075","2021",247,28,219,197075.2,2501.065,74.37247
"21990","63076","2021",1,1,0,31500,700,45
"21991","63077","2021",8,7,1,123816.2,1940.625,67.375
"21992","63080","2021",11,11,0,154245.5,1538.455,95.72727
"21993","63081","2021",2,2,0,104050,1330,95
"21994","63082","2021",6,6,0,159878,1537.333,109.1667
"21995","63083","2021",8,8,0,264780,1988.875,126.625
"21996","63084","2021",6,6,0,135207.5,1465.5,92.16667
"21997","63085","2021",11,11,0,135045.5,1240,112.4545
"21998","63086","2021",9,9,0,88031.11,1066.556,86.33333
"21999","63087","2021",1,1,0,43000,467,92
"22000","63089","2021",7,7,0,199314.3,2377.857,85.85714
"22001","63090","2021",5,5,0,184014,1510.8,122.6
"22002","63091","2021",3,3,0,80485.67,1004.333,69.33333
"22003","63092","2021",7,7,0,208852.9,2175.143,106.7143
"22004","63093","2021",8,8,0,109688.8,1247.25,96.625
"22005","63094","2021",5,5,0,92638,853,98.6
"22006","63095","2021",1,1,0,170000,1619,105
"22007","63096","2021",3,3,0,160166.7,2084,75.66667
"22008","63098","2021",4,3,1,103217.5,1730,59.75
"22009","63099","2021",26,25,1,209469.2,2010.462,102.3462
"22010","63100","2021",4,4,0,112225,1186,80.5
"22011","63101","2021",1,1,0,30000,429,70
"22012","63102","2021",7,7,0,88678.57,1028,82.57143
"22013","63103","2021",63,45,18,167363,2146.968,86.07937
"22014","63104","2021",1,1,0,138000,1211,114
"22015","63105","2021",1,1,0,33000,388,85
"22016","63106","2021",12,11,1,153810,1486,106.5
"22017","63107","2021",3,3,0,174477.3,1869.667,82.33333
"22018","63108","2021",2,2,0,429700,3173,131.5
"22019","63109","2021",5,5,0,131120,1301.4,106
"22020","63110","2021",3,3,0,82833.33,885.3333,82.66667
"22021","63111","2021",1,1,0,34900,1058,33
"22022","63112","2021",1,1,0,236150,2653,89
"22023","63113","2021",1315,212,1103,140114.5,2198.992,65.59163
"22024","63116","2021",18,17,1,149531.7,1567.722,94.38889
"22025","63117","2021",4,4,0,122367.5,1863.5,70.75
"22026","63118","2021",6,6,0,81725,793,107.6667
"22027","63119","2021",2,2,0,59250,1187.5,61.5
"22028","63120","2021",6,6,0,156474.2,1860.833,83.5
"22029","63121","2021",7,7,0,139021.4,1637.857,83.14286
"22030","63123","2021",1,1,0,189250,1720,110
"22031","63124","2021",150,97,53,192537.5,2192.627,87.78
"22032","63125","2021",24,23,1,118954.6,1393.083,88.20833
"22033","63126","2021",8,8,0,208999.2,2063.375,91.75
"22034","63128","2021",5,5,0,112250,1193.2,103.4
"22035","63129","2021",2,2,0,139675,1748.5,82
"22036","63130","2021",3,3,0,100633.3,927,92
"22037","63131","2021",10,10,0,166170,1736.7,97.1
"22038","63132","2021",10,10,0,92785.1,1490.9,65.7
"22039","63135","2021",3,3,0,192600,1906.333,101.6667
"22040","63136","2021",6,6,0,75916.67,822.6667,90.66667
"22041","63137","2021",4,4,0,59925,777.5,78
"22042","63138","2021",4,4,0,65500,952.75,68
"22043","63139","2021",6,6,0,45060,555,81.5
"22044","63140","2021",3,3,0,39333.33,700,59.33333
"22045","63141","2021",6,5,1,318590.8,3088.333,104.8333
"22046","63142","2021",2,2,0,89320,821.5,107
"22047","63143","2021",6,6,0,156836.7,1334.333,115.6667
"22048","63144","2021",5,5,0,44190,714.4,61.6
"22049","63145","2021",3,3,0,126333.3,1127.667,128
"22050","63146","2021",6,6,0,203175,1658.5,130
"22051","63147","2021",3,3,0,82633.33,748,109.6667
"22052","63148","2021",12,10,2,181514.2,1950.333,91.75
"22053","63149","2021",3,3,0,168335,1656,101.6667
"22054","63150","2021",9,9,0,237508.4,1922.889,121.4444
"22055","63151","2021",7,7,0,133759.9,1631.571,84.14286
"22056","63152","2021",4,4,0,56500,633.75,89
"22057","63153","2021",2,2,0,24240,727.5,33
"22058","63155","2021",5,5,0,130980,1402.6,91.2
"22059","63156","2021",1,1,0,128000,711,180
"22060","63157","2021",6,6,0,105341.7,1092.333,108.8333
"22061","63158","2021",4,4,0,54312.5,676,76.25
"22062","63159","2021",1,1,0,35000,467,75
"22063","63160","2021",8,8,0,226710.5,2054.25,111
"22064","63161","2021",3,3,0,44666.67,598,76
"22065","63162","2021",2,2,0,109500,1000,107.5
"22066","63163","2021",6,6,0,134583.3,1333.833,109.6667
"22067","63164","2021",79,51,28,167916.9,2057.241,81
"22068","63165","2021",9,9,0,107350,882.6667,118.8889
"22069","63166","2021",1,1,0,38000,731,52
"22070","63167","2021",1,1,0,258320,2171,119
"22071","63168","2021",8,8,0,109850,1359.625,77.875
"22072","63170","2021",5,5,0,145627.8,1300.2,111.8
"22073","63171","2021",4,4,0,49650,592.5,91.25
"22074","63172","2021",1,1,0,221600,1266,175
"22075","63173","2021",5,5,0,105440,1125,84.8
"22076","63174","2021",3,3,0,104549.3,853.3333,112
"22077","63175","2021",1,1,0,80000,714,112
"22078","63177","2021",1,1,0,233840,2657,88
"22079","63178","2021",110,50,60,139413,1868.464,76.82727
"22080","63179","2021",5,4,1,62900,796.8,84
"22081","63180","2021",7,7,0,171350,1955.857,83.42857
"22082","63181","2021",2,2,0,187250,1846.5,100.5
"22083","63182","2021",7,7,0,69935.71,828.7143,77.28571
"22084","63184","2021",6,6,0,134300,1414.333,97
"22085","63185","2021",6,6,0,128683.3,1163.333,117.5
"22086","63186","2021",3,3,0,117500,785.6667,152.3333
"22087","63187","2021",4,4,0,79250,924.75,83.75
"22088","63188","2021",6,6,0,141615.2,1452.167,99.83333
"22089","63189","2021",3,3,0,53583.33,669.6667,94.66667
"22090","63190","2021",3,3,0,42416.67,554.3333,71.33333
"22091","63191","2021",1,1,0,15000,714,21
"22092","63192","2021",9,9,0,89277.78,934.3333,90
"22093","63193","2021",51,41,10,199129.5,2250.294,87.15686
"22094","63194","2021",1,1,0,237500,3299,72
"22095","63195","2021",41,41,0,154033,1801.707,91.09756
"22096","63196","2021",5,5,0,163990,1652.8,96.4
"22097","63197","2021",2,2,0,121800,1290,97.5
"22098","63198","2021",6,6,0,212575,1785.167,125
"22099","63199","2021",5,5,0,165682,2018,82.8
"22100","63200","2021",5,5,0,206080,2302.2,91.8
"22101","63201","2021",7,7,0,138028.6,1376.286,104.7143
"22102","63202","2021",1,1,0,133200,697,191
"22103","63203","2021",5,5,0,264710.6,2486,110
"22104","63204","2021",5,5,0,144856,1283.6,120.2
"22105","63205","2021",2,2,0,101600,944,105.5
"22106","63206","2021",13,13,0,154997.7,1434.538,106.5385
"22107","63207","2021",3,3,0,165593.3,1809,105.6667
"22108","63208","2021",1,1,0,289500,2210,131
"22109","63209","2021",1,1,0,96000,1655,58
"22110","63210","2021",20,20,0,149402.5,1645,97.2
"22111","63211","2021",11,10,1,102887.3,1001,106.1818
"22112","63212","2021",10,9,1,186675.8,1921.2,92.8
"22113","63213","2021",10,10,0,244102.1,2442.5,99.4
"22114","63214","2021",25,24,1,198301.2,2029.64,95.84
"22115","63215","2021",6,6,0,169383.3,1596,105
"22116","63216","2021",2,2,0,182450,2870.5,63.5
"22117","63218","2021",1,1,0,45000,523,86
"22118","63219","2021",5,5,0,175510,1386.8,114
"22119","63220","2021",2,2,0,46000,563,76
"22120","63221","2021",3,3,0,116583.3,1148,117.6667
"22121","63222","2021",4,4,0,150062.5,1464.75,103.75
"22122","63223","2021",2,1,1,31172.5,557.5,54.5
"22123","63224","2021",7,7,0,212885,2183.143,105.8571
"22124","63225","2021",7,7,0,56982.86,894,60.28571
"22125","63226","2021",23,23,0,227391.3,1914.043,118.1739
"22126","63227","2021",9,9,0,133370.8,1478.333,93.77778
"22127","63228","2021",6,6,0,102083.3,1253.667,82.66667
"22128","63229","2021",7,7,0,140284.3,1737,72.85714
"22129","63230","2021",3,3,0,188583.3,1537.667,122.6667
"22130","63231","2021",7,7,0,49657.14,837.4286,62.85714
"22131","63232","2021",4,4,0,189687.5,1705.5,119
"22132","63233","2021",2,2,0,66000,1057,55.5
"22133","63234","2021",8,8,0,162595,1847,92.75
"22134","63235","2021",4,4,0,127400,1400.25,114.25
"22135","63236","2021",71,14,57,104751.8,2337.93,48
"22136","63237","2021",5,5,0,88550,676.8,133.6
"22137","63239","2021",5,5,0,164370,1489.8,113.6
"22138","63240","2021",5,5,0,179250,2000,89
"22139","63242","2021",4,4,0,92740,1139.5,68.25
"22140","63243","2021",4,4,0,135605,1513.5,85.75
"22141","63244","2021",11,11,0,234777.3,1949.818,124.5455
"22142","63245","2021",27,25,2,238376.9,2432.481,98.51852
"22143","63246","2021",19,6,13,60967.53,984.3158,61.78947
"22144","63247","2021",7,5,2,130748.6,2520,62
"22145","63248","2021",2,1,1,208225,2585,73.5
"22146","63249","2021",6,6,0,169692.3,1513.5,111
"22147","63250","2021",4,4,0,133842.5,1092.25,116.5
"22148","63251","2021",4,4,0,57640,677.75,79.5
"22149","63252","2021",3,3,0,130866.7,1615.333,85.33333
"22150","63253","2021",1,1,0,139100,1405,99
"22151","63254","2021",10,9,1,264291.5,2705,93.7
"22152","63255","2021",3,3,0,101916.7,995.3333,108.6667
"22153","63256","2021",1,1,0,60000,857,70
"22154","63257","2021",7,7,0,184915.6,1703.286,108.5714
"22155","63258","2021",1,1,0,68700,1041,66
"22156","63259","2021",3,3,0,65000,1247.333,50.33333
"22157","63260","2021",6,6,0,63166.67,807,73.66667
"22158","63261","2021",4,4,0,252175,2691.75,92
"22159","63262","2021",29,29,0,202440.8,1934.897,107.069
"22160","63263","2021",14,14,0,213348.7,2110.143,96.64286
"22161","63264","2021",1,1,0,58827,1730,34
"22162","63265","2021",9,9,0,198522.2,1647.111,119.1111
"22163","63267","2021",4,4,0,113712.5,1090,117.5
"22164","63268","2021",2,2,0,193350,6758.5,61
"22165","63269","2021",9,8,1,159332.2,1622.778,103.8889
"22166","63271","2021",6,6,0,154100,1367.833,126.8333
"22167","63272","2021",19,15,4,257184.5,2452.947,111.5789
"22168","63273","2021",8,8,0,228123.8,2589,89.125
"22169","63274","2021",1,1,0,47505,669,71
"22170","63275","2021",6,6,0,182991.7,1712.833,109.6667
"22171","63276","2021",19,15,4,111606.1,1343.421,91.36842
"22172","63277","2021",1,1,0,60500,637,95
"22173","63278","2021",6,6,0,156091.5,1578.167,97
"22174","63279","2021",7,7,0,174274.3,1387.857,127
"22175","63280","2021",2,2,0,150750,1162.5,134
"22176","63281","2021",3,3,0,73333.33,630.3333,112.6667
"22177","63282","2021",8,8,0,177840,1746.75,110.5
"22178","63283","2021",13,12,1,97735.77,1016.846,99
"22179","63284","2021",68,60,8,218796.5,2444.544,88.66176
"22180","63285","2021",4,4,0,91550,1106,87.25
"22181","63286","2021",1,1,0,23500,336,70
"22182","63287","2021",3,3,0,102833.3,1113.333,89.66667
"22183","63288","2021",4,4,0,203050,1539.75,130
"22184","63289","2021",2,2,0,113905,1217,88.5
"22185","63291","2021",14,13,1,128310.7,1064.5,115.2857
"22186","63293","2021",2,2,0,70375,900,77.5
"22187","63294","2021",1,1,0,165700,1466,113
"22188","63295","2021",13,13,0,133000,1362.308,97.07692
"22189","63296","2021",9,9,0,140185.6,1403.111,96.44444
"22190","63297","2021",3,3,0,125700,1372.333,91.33333
"22191","63298","2021",2,2,0,189750,1948.5,100.5
"22192","63300","2021",139,87,52,167077.1,2039.899,82.1295
"22193","63301","2021",6,6,0,95000,1037.5,83.33333
"22194","63302","2021",20,19,1,238776.9,2534.5,93.25
"22195","63305","2021",6,6,0,97240,1027.333,93
"22196","63306","2021",2,2,0,203750,2413,84.5
"22197","63307","2021",42,34,8,202286.7,2008.738,97.16667
"22198","63308","2021",72,18,54,136203.4,2164.181,61.05556
"22199","63309","2021",3,3,0,80025,1076.667,77
"22200","63310","2021",1,1,0,90000,1154,78
"22201","63311","2021",4,4,0,148125,1335.25,111.75
"22202","63312","2021",1,1,0,37055,788,47
"22203","63314","2021",4,4,0,52375,657.25,81.5
"22204","63315","2021",11,11,0,287133.2,2245.636,123.9091
"22205","63317","2021",7,7,0,176021.4,2047.857,89.57143
"22206","63318","2021",4,4,0,98200,847.5,116.25
"22207","63319","2021",12,10,2,83726.67,1201.75,68.75
"22208","63320","2021",2,2,0,70500,786.5,94
"22209","63321","2021",5,5,0,141869,1117,123.8
"22210","63322","2021",18,17,1,213211.7,2036,107.7778
"22211","63323","2021",1,1,0,28000,560,50
"22212","63324","2021",5,5,0,83429,1133.4,83.6
"22213","63326","2021",3,3,0,115916.7,1239.667,101.3333
"22214","63327","2021",19,19,0,159920.9,1751.053,94.36842
"22215","63329","2021",2,2,0,202000,1423,142
"22216","63330","2021",2,2,0,142800,1315,92
"22217","63331","2021",2,2,0,67000,957,70
"22218","63332","2021",2,2,0,176330,1655,108
"22219","63333","2021",1,1,0,397600,1371,290
"22220","63334","2021",4,3,1,108912.5,1124.5,109
"22221","63335","2021",7,7,0,96842.86,984.5714,99.57143
"22222","63336","2021",1,1,0,80000,1905,42
"22223","63338","2021",27,25,2,63952.41,870.1111,77.88889
"22224","63339","2021",1,1,0,60000,545,110
"22225","63340","2021",6,6,0,103558.3,1125.5,89.5
"22226","63341","2021",1,1,0,125000,1506,83
"22227","63342","2021",3,3,0,117171.7,2260.667,62
"22228","63343","2021",6,6,0,89158.33,838.8333,103
"22229","63344","2021",1,1,0,180000,1286,140
"22230","63345","2021",23,23,0,181526.7,1869.478,96.08696
"22231","63346","2021",2,2,0,148850,1326,106.5
"22232","63347","2021",5,5,0,172180,1676.4,105.6
"22233","63349","2021",11,11,0,108498.2,1199,93.81818
"22234","63350","2021",10,10,0,211791.4,1872,111.3
"22235","63351","2021",1,1,0,162000,1246,130
"22236","63352","2021",9,9,0,77944.44,865.4444,97.77778
"22237","63353","2021",3,3,0,49306.67,684.3333,72
"22238","63354","2021",14,14,0,82053.57,944.9286,83.71429
"22239","63355","2021",6,6,0,126548.3,1140.667,114.8333
"22240","63356","2021",8,8,0,153767.4,1423.5,98.125
"22241","63357","2021",1,1,0,77000,906,85
"22242","63358","2021",2,2,0,153850,1299,121
"22243","63360","2021",2,2,0,150000,1154,168
"22244","63362","2021",5,5,0,125320.2,1520.8,81
"22245","63363","2021",3,3,0,63404,908.6667,66
"22246","63364","2021",1,1,0,399000,2361,169
"22247","63365","2021",7,7,0,150428.6,1198.429,126.4286
"22248","63366","2021",3,3,0,1e+05,1106.667,87
"22249","63367","2021",2,2,0,30500,408.5,75
"22250","63368","2021",8,8,0,151568.8,1679.375,87.25
"22251","63369","2021",1,1,0,51300,466,110
"22252","63370","2021",1,1,0,28600,596,48
"22253","63371","2021",2,2,0,161805,831,195
"22254","63372","2021",6,6,0,122362.7,1788.167,69
"22255","63374","2021",6,5,1,70850,995.3333,74
"22256","63376","2021",3,3,0,50000,584.3333,83.66667
"22257","63377","2021",5,5,0,75644.8,1040.4,72
"22258","63378","2021",8,8,0,165698.8,1785.625,84.375
"22259","63379","2021",4,4,0,76000,1009,84
"22260","63380","2021",13,8,5,79313.08,1015.385,85.61538
"22261","63381","2021",8,6,2,121309.9,1681.5,71.625
"22262","63382","2021",4,4,0,113922.5,1460.25,85.25
"22263","63383","2021",2,2,0,107500,1528,75
"22264","63385","2021",1,1,0,60000,496,121
"22265","63386","2021",3,3,0,144266.7,1569,93
"22266","63387","2021",4,4,0,136125,1780.5,82.75
"22267","63388","2021",4,4,0,56875,692.25,82.5
"22268","63390","2021",3,3,0,119278.3,1159.667,105
"22269","63391","2021",2,2,0,91975,1118.5,94
"22270","63392","2021",3,3,0,111666.7,1147,93.33333
"22271","63393","2021",15,14,1,116884.7,1218.933,97.4
"22272","63395","2021",8,8,0,163390.6,1928.75,80.625
"22273","63396","2021",4,4,0,190750,2139.25,87.75
"22274","63397","2021",8,8,0,100513.8,1221.125,82
"22275","63398","2021",1,1,0,52000,400,130
"22276","63399","2021",1,1,0,35000,1000,35
"22277","63400","2021",7,7,0,173080.7,1722.857,99.28571
"22278","63401","2021",3,3,0,166545,1442.333,100
"22279","63402","2021",5,5,0,112100,1469.2,82.6
"22280","63404","2021",3,3,0,165216.7,2152.333,71
"22281","63405","2021",4,4,0,109688.8,1514.5,76.5
"22282","63406","2021",1,1,0,130000,1585,82
"22283","63407","2021",2,2,0,157700,2421.5,74.5
"22284","63408","2021",3,2,1,119500,1417.333,83.33333
"22285","63409","2021",2,2,0,37408,963,39
"22286","63410","2021",1,1,0,38813,1213,32
"22287","63412","2021",4,4,0,122500,1281.25,99
"22288","63413","2021",3,3,0,162376.7,1994.333,92
"22289","63414","2021",8,8,0,141130,1326.125,108.625
"22290","63415","2021",12,12,0,141208.3,1362.75,95
"22291","63417","2021",9,9,0,226883.3,2008.556,107.7778
"22292","63418","2021",2,2,0,148650,1292,106
"22293","63419","2021",6,6,0,85299.5,1094.167,72.66667
"22294","63420","2021",5,5,0,104050,1597.4,69
"22295","63421","2021",1,1,0,114155,1038,110
"22296","63422","2021",6,6,0,114658.3,994.6667,120
"22297","63423","2021",8,8,0,107735,1179.125,112
"22298","63424","2021",3,3,0,242236.7,2171,114.3333
"22299","63425","2021",5,5,0,178450,2188,88.2
"22300","63426","2021",8,8,0,92656.25,999.125,101.875
"22301","63427","2021",1,1,0,115000,767,150
"22302","63428","2021",3,3,0,97441.67,1508.667,61.66667
"22303","63430","2021",58,44,14,96730.97,1159.586,78.39655
"22304","63432","2021",6,6,0,210583.3,2157.5,99.16667
"22305","63434","2021",2,2,0,96500,676,127.5
"22306","63435","2021",4,4,0,138020,1418.75,96.5
"22307","63436","2021",2,2,0,240549,2344,131.5
"22308","63438","2021",4,4,0,135520,1451,96.75
"22309","63439","2021",3,3,0,218133.3,1558,130.6667
"22310","63440","2021",2,2,0,122350,913,130.5
"22311","63441","2021",6,6,0,87791.67,1092,79
"22312","63442","2021",1,1,0,33000,550,60
"22313","63443","2021",2,2,0,184450,1881,95
"22314","63444","2021",1,1,0,149415,718,208
"22315","63445","2021",3,3,0,213566.7,2190.667,95
"22316","63446","2021",4,4,0,180582.5,1540,128.25
"22317","63447","2021",1,1,0,58000,674,86
"22318","63448","2021",6,6,0,44308.33,841.1667,52.83333
"22319","63449","2021",2,2,0,117500,1845,75.5
"22320","63450","2021",1,1,0,21000,500,42
"22321","63451","2021",2,2,0,51000,818.5,61
"22322","63452","2021",2,2,0,152000,1548,95
"22323","63453","2021",25,24,1,170443.9,1916.72,89.56
"22324","63454","2021",5,5,0,76410,621.6,121.6
"22325","63455","2021",13,11,2,196913.1,1879.308,102.3846
"22326","63456","2021",1,1,0,105000,1141,92
"22327","63457","2021",21,21,0,180179.8,1959.905,91.90476
"22328","63459","2021",2,2,0,232760,1658.5,156.5
"22329","63460","2021",2,2,0,147750,1590,115.5
"22330","63461","2021",1,1,0,155000,1314,118
"22331","63462","2021",1,1,0,79000,718,110
"22332","63464","2021",1,1,0,144175,994,145
"22333","63465","2021",1,0,1,30000,429,70
"22334","63466","2021",1,1,0,342000,1257,272
"22335","63467","2021",1,1,0,150000,1071,140
"22336","63468","2021",3,3,0,38000,984.6667,41.66667
"22337","63469","2021",4,4,0,126500,1375.5,92
"22338","63470","2021",33,33,0,179896.8,1985.848,99.27273
"22339","63471","2021",7,7,0,57214.29,683,89.71429
"22340","63472","2021",4,4,0,197960,1893,99.75
"22341","63473","2021",3,3,0,86833.33,1284.333,70.33333
"22342","64001","2021",1,1,0,226000,1699,133
"22343","64002","2021",1,1,0,194770,1910,102
"22344","64003","2021",2,2,0,131250,1247,117
"22345","64004","2021",1,1,0,125000,1126,111
"22346","64005","2021",4,4,0,207287.5,1700,149.25
"22347","64006","2021",8,8,0,114305,1168.875,94.25
"22348","64007","2021",9,9,0,195333.3,1905.444,101.1111
"22349","64008","2021",4,4,0,116191.2,1052.75,119.75
"22350","64009","2021",35,24,11,618561.9,4933.457,121.8286
"22351","64010","2021",2,2,0,142750,1210.5,118.5
"22352","64012","2021",1,1,0,359000,3294,109
"22353","64013","2021",2,2,0,168350,1512.5,121.5
"22354","64014","2021",6,5,1,368239.2,2404.833,152.6667
"22355","64015","2021",3,3,0,119731.3,1145,105.3333
"22356","64016","2021",3,3,0,250000,1745.667,163
"22357","64017","2021",6,6,0,88808.33,1244,80.33333
"22358","64018","2021",7,6,1,286785.7,1923.143,164.1429
"22359","64021","2021",7,7,0,240341.4,2220.857,126
"22360","64023","2021",6,6,0,253483.3,1957.333,130.1667
"22361","64024","2021",933,275,658,428742.9,5268.234,78.23151
"22362","64025","2021",3,3,0,311666.7,1195.667,215.6667
"22363","64026","2021",1,1,0,230000,2706,85
"22364","64027","2021",1,1,0,213000,2696,79
"22365","64028","2021",1,1,0,260000,2708,96
"22366","64029","2021",15,15,0,179204.5,1628.867,116
"22367","64031","2021",5,5,0,247572,2268.4,107.6
"22368","64032","2021",1,1,0,355180,2220,160
"22369","64033","2021",2,2,0,237140,1431,158
"22370","64035","2021",35,29,6,775654.4,5906.514,130.0571
"22371","64036","2021",3,3,0,331175,3206.667,119.6667
"22372","64037","2021",6,6,0,224221.7,2153.167,107.1667
"22373","64038","2021",90,53,37,661021.4,5044.522,129.7556
"22374","64039","2021",2,2,0,290000,1477,202.5
"22375","64040","2021",38,10,28,91565.18,2009.553,53.84211
"22376","64041","2021",12,11,1,229923.2,2218.75,106.9167
"22377","64042","2021",12,12,0,199690.8,1891.417,107
"22378","64043","2021",1,1,0,233000,2118,110
"22379","64046","2021",1,1,0,127500,1181,108
"22380","64047","2021",5,5,0,209980,2731.2,84.4
"22381","64048","2021",2,2,0,204000,1966.5,104.5
"22382","64049","2021",1,1,0,346648,1554,223
"22383","64050","2021",2,2,0,113370.5,775.5,142.5
"22384","64051","2021",6,2,4,172959.8,1586.333,110.3333
"22385","64052","2021",1,1,0,41500,500,83
"22386","64054","2021",10,9,1,159027.7,1517.9,93.7
"22387","64056","2021",3,3,0,105746.7,1153.667,96.66667
"22388","64057","2021",26,24,2,170460,1605.038,107.8846
"22389","64058","2021",3,3,0,139000,1346.333,101
"22390","64059","2021",11,10,1,249376.3,2049.818,122.2727
"22391","64060","2021",21,20,1,289612.2,2443.286,119.5238
"22392","64061","2021",52,42,10,158639.6,1640.462,98.88462
"22393","64062","2021",15,12,3,145087.3,1309,117.3333
"22394","64063","2021",13,13,0,180446.2,1592.846,116.8462
"22395","64064","2021",3,3,0,97798.33,1252.667,80.66667
"22396","64065","2021",75,47,28,541216.2,4537.08,117.84
"22397","64066","2021",3,3,0,299845,2460,149.6667
"22398","64067","2021",17,16,1,242929.4,2102.588,115.0588
"22399","64068","2021",18,18,0,204793.2,2033.444,124.1667
"22400","64069","2021",9,7,2,96370,1834.222,54.66667
"22401","64070","2021",3,3,0,236666.7,1537.333,155.6667
"22402","64071","2021",2,2,0,165000,1249,134
"22403","64072","2021",9,9,0,362094.4,2442.889,150.3333
"22404","64073","2021",2,2,0,142900,1922,68.5
"22405","64074","2021",2,2,0,196075,1941,97.5
"22406","64075","2021",2,2,0,176500,1089,158
"22407","64077","2021",3,3,0,179900,1558.667,122.6667
"22408","64078","2021",1,1,0,127000,605,210
"22409","64079","2021",1,1,0,155000,1165,133
"22410","64080","2021",7,7,0,237521.6,2204.571,109.5714
"22411","64081","2021",1,1,0,85410,1400,61
"22412","64083","2021",4,4,0,327315,2193,149.25
"22413","64084","2021",1,1,0,235000,1291,182
"22414","64085","2021",4,4,0,140750,2030.25,67.25
"22415","64086","2021",6,6,0,287816.7,2819.5,105.5
"22416","64087","2021",5,5,0,281102,2705.8,131.2
"22417","64088","2021",2,2,0,290877,1575,187.5
"22418","64090","2021",4,4,0,389437.5,2267,151.75
"22419","64091","2021",9,8,1,198875.7,1905.556,106.5556
"22420","64092","2021",2,2,0,112500,667.5,153
"22421","64093","2021",7,6,1,91357.14,957.4286,99.71429
"22422","64094","2021",15,12,3,339266.5,2905.467,126.1333
"22423","64095","2021",5,4,1,207728,1632,135
"22424","64096","2021",2,2,0,179602.5,1695.5,107.5
"22425","64097","2021",5,5,0,233440,1891.6,136
"22426","64098","2021",1,1,0,217750,1281,170
"22427","64100","2021",68,38,30,481558.4,4388.529,105.7059
"22428","64101","2021",8,6,2,178993.8,1851.75,101.375
"22429","64102","2021",1173,104,1069,262282.5,3895.28,66.99147
"22430","64103","2021",5,5,0,125800,1065.2,126.2
"22431","64104","2021",12,8,4,101125,1295.833,81.58333
"22432","64105","2021",3,3,0,344000,1758,191
"22433","64106","2021",3,2,1,224000,3024.667,68
"22434","64108","2021",10,10,0,137492,1265.5,114.5
"22435","64109","2021",23,23,0,187123,1705.261,117.8696
"22436","64110","2021",3,3,0,272633.3,2028,143.6667
"22437","64111","2021",1,0,1,137490,1165,118
"22438","64112","2021",6,6,0,125281.3,1308.833,94.83333
"22439","64113","2021",1,1,0,174000,1450,120
"22440","64114","2021",4,4,0,251975,2025,124.75
"22441","64115","2021",1,1,0,246000,1519,162
"22442","64116","2021",2,2,0,222395,1609,137.5
"22443","64119","2021",3,3,0,200050,1797.667,112.3333
"22444","64120","2021",4,4,0,303303.8,2421.75,151.5
"22445","64121","2021",2,2,0,263965,2247.5,118
"22446","64122","2021",894,173,721,524556.3,7145.469,74.15548
"22447","64123","2021",30,20,10,242580.3,2249.4,117.2
"22448","64124","2021",7,7,0,445747,3714.286,124.5714
"22449","64125","2021",163,52,111,502359.5,6156.656,77.59509
"22450","64126","2021",6,4,2,140616.7,1425.5,99.5
"22451","64127","2021",4,4,0,113600,1148,104
"22452","64128","2021",1,1,0,110000,1222,90
"22453","64129","2021",340,80,260,142553.5,1986.926,71.93824
"22454","64130","2021",16,9,7,341382.1,4035.625,92.6875
"22455","64131","2021",9,9,0,188838.9,1683.222,126.2222
"22456","64132","2021",59,43,16,259406.9,2293.271,117.7627
"22457","64133","2021",10,7,3,208719,1880.1,119.2
"22458","64134","2021",1,1,0,255000,5204,49
"22459","64135","2021",14,14,0,170356.8,1474,128.0714
"22460","64136","2021",5,5,0,138346,1569.2,88.2
"22461","64137","2021",5,5,0,246676,1747.8,140
"22462","64138","2021",28,27,1,204770.9,1993.5,110.9286
"22463","64139","2021",3,3,0,281583.3,1758.333,156.6667
"22464","64140","2021",140,65,75,293694.6,3533.564,82.80714
"22465","64141","2021",1,1,0,223000,2186,102
"22466","64142","2021",8,8,0,243927.5,2286.625,115.25
"22467","64143","2021",2,2,0,127500,1118.5,114
"22468","64144","2021",2,2,0,158625,1874,84
"22469","64145","2021",2,2,0,118375,1362.5,92.5
"22470","64147","2021",29,17,12,345703.7,3379.862,104.5517
"22471","64148","2021",9,9,0,158128,1133.111,134
"22472","64149","2021",2,2,0,206250,1787,120
"22473","64151","2021",4,4,0,224250,2135,107.25
"22474","64152","2021",23,22,1,348864.7,2482.913,152.5652
"22475","64154","2021",1,0,1,30000,938,32
"22476","64155","2021",1,1,0,116000,1547,75
"22477","64156","2021",3,3,0,177093.3,2104,90
"22478","64157","2021",10,9,1,171254.2,1566,111.6
"22479","64158","2021",1,1,0,139900,1999,70
"22480","64159","2021",1,1,0,321982,2421,133
"22481","64160","2021",124,40,84,238862.3,3610.718,70.00806
"22482","64161","2021",12,11,1,318252.7,3083.083,109.25
"22483","64165","2021",6,6,0,157745,1242,138.6667
"22484","64166","2021",2,2,0,222730,1397,170
"22485","64167","2021",1,1,0,95000,864,110
"22486","64168","2021",11,10,1,183472.7,1417.545,138.4545
"22487","64170","2021",2,2,0,220000,1349.5,157.5
"22488","64171","2021",1,1,0,265000,1840,144
"22489","64172","2021",6,6,0,211425,1645.167,121.8333
"22490","64173","2021",3,3,0,222000,1687,132
"22491","64174","2021",1,1,0,102900,1470,70
"22492","64175","2021",3,3,0,248098.3,2424.333,109
"22493","64176","2021",1,1,0,344800,1815,190
"22494","64177","2021",8,8,0,179737.5,1525.625,120.875
"22495","64178","2021",5,5,0,166790,1366.6,129
"22496","64179","2021",1,1,0,339000,2146,158
"22497","64180","2021",1,1,0,228150,1607,142
"22498","64181","2021",3,3,0,189133.3,1482,129
"22499","64183","2021",6,6,0,279749.2,2205.833,129.6667
"22500","64184","2021",2,2,0,228000,2639,101.5
"22501","64185","2021",6,6,0,118735,1140.333,109.5
"22502","64186","2021",2,2,0,157500,1240,130.5
"22503","64187","2021",5,4,1,163000,1438.2,130.2
"22504","64188","2021",11,11,0,150454.5,1224.636,125.1818
"22505","64189","2021",190,24,166,385662.2,5611.211,69.29474
"22506","64190","2021",5,5,0,176588,1795.8,102.6
"22507","64191","2021",26,22,4,251056.7,2398.808,112.8846
"22508","64192","2021",1,1,0,168500,1832,92
"22509","64193","2021",2,2,0,96943,1229,86.5
"22510","64194","2021",3,3,0,188516.7,1792.667,105.3333
"22511","64195","2021",1,1,0,171000,877,195
"22512","64196","2021",1,1,0,124000,420,295
"22513","64197","2021",2,2,0,293850,1593.5,185
"22514","64198","2021",10,10,0,261715.8,1988.6,136.7
"22515","64199","2021",1,1,0,245000,942,260
"22516","64200","2021",2,2,0,96000,1030,97.5
"22517","64201","2021",2,2,0,289450,1510.5,189.5
"22518","64202","2021",4,3,1,135250,1159,123.25
"22519","64203","2021",3,3,0,231000,2413.333,99.33333
"22520","64204","2021",76,8,68,65303.88,1746.684,39.72368
"22521","64205","2021",9,6,3,139699,1507.444,94.44444
"22522","64206","2021",2,2,0,171150,1576,115
"22523","64207","2021",3,3,0,127830,1032.333,138.3333
"22524","64208","2021",3,3,0,209530,2015,105
"22525","64209","2021",6,6,0,183133.3,1603.5,113.8333
"22526","64211","2021",6,6,0,182647.7,1443.333,125.8333
"22527","64212","2021",1,1,0,276370,2303,120
"22528","64213","2021",17,14,3,499800.9,4116.529,143.2941
"22529","64214","2021",3,3,0,94267.33,972.3333,109.6667
"22530","64215","2021",2,2,0,196139,1883,105.5
"22531","64216","2021",14,10,4,214812.9,1881.571,115.7857
"22532","64217","2021",3,3,0,188733.3,1601,129.6667
"22533","64218","2021",5,4,1,155120,3212.6,61.4
"22534","64219","2021",1,1,0,175000,1167,150
"22535","64220","2021",2,2,0,208000,2010,102
"22536","64221","2021",3,3,0,295150,1737.333,163.6667
"22537","64223","2021",4,4,0,92887.5,1834.25,45.5
"22538","64224","2021",10,10,0,173482,1796.4,98.4
"22539","64225","2021",7,7,0,213622.9,1794.857,121.8571
"22540","64226","2021",1,1,0,272000,1744,156
"22541","64227","2021",8,8,0,215211.2,1669.875,134.375
"22542","64228","2021",1,1,0,399000,2217,180
"22543","64230","2021",55,51,4,212033.1,1922.273,111.2909
"22544","64231","2021",3,2,1,151866.7,1508.667,100.3333
"22545","64232","2021",3,3,0,201923.3,1707.667,120.6667
"22546","64233","2021",10,9,1,174080,1343.4,128.9
"22547","64234","2021",3,3,0,69403.33,919.3333,77.66667
"22548","64235","2021",2,2,0,151500,877,174
"22549","64236","2021",1,1,0,177000,952,186
"22550","64237","2021",49,30,19,200712.5,2095.551,94.91837
"22551","64238","2021",11,11,0,225774.5,1806.545,137.2727
"22552","64239","2021",2,2,0,133750,1285,108.5
"22553","64240","2021",5,5,0,194032,1757.8,122.6
"22554","64241","2021",7,7,0,201347.1,1442.571,150.4286
"22555","64242","2021",2,2,0,212500,2025,116
"22556","64243","2021",1,1,0,2e+05,1613,124
"22557","64245","2021",11,11,0,193093.6,1603.455,123
"22558","64246","2021",1,1,0,210200,2021,104
"22559","64247","2021",4,4,0,175362.5,1407.75,121.75
"22560","64249","2021",30,11,19,533368.4,6913.067,78.1
"22561","64250","2021",9,8,1,308011.3,2174.667,143.7778
"22562","64251","2021",5,5,0,224200,1809.6,133.4
"22563","64252","2021",8,8,0,176262.5,1653.75,109
"22564","64253","2021",6,6,0,213250,1304.167,175.1667
"22565","64254","2021",10,10,0,170826,1414.3,121.6
"22566","64255","2021",4,4,0,391021.2,3533.75,111.75
"22567","64256","2021",100,40,60,249394.1,2943.14,88.66
"22568","64257","2021",2,2,0,161250,1548.5,107
"22569","64259","2021",7,7,0,295671.4,3120.857,89.42857
"22570","64260","2021",593,71,522,242259.5,4308.735,58.48061
"22571","64261","2021",1,1,0,173000,1966,88
"22572","64262","2021",3,3,0,200913.3,2066,89
"22573","64263","2021",1,1,0,183780,1081,170
"22574","64265","2021",2,2,0,291500,2068,141.5
"22575","64266","2021",2,2,0,197000,1656.5,119
"22576","64267","2021",1,1,0,196000,1633,120
"22577","64269","2021",64,51,13,300886.2,2468.109,119.3125
"22578","64270","2021",14,13,1,160523.6,1663.214,102.5
"22579","64271","2021",2,2,0,209675,1769.5,118.5
"22580","64273","2021",5,5,0,229100,1735.4,151.2
"22581","64274","2021",3,3,0,184580,1566.333,118
"22582","64275","2021",4,4,0,272600,1826.75,140.25
"22583","64276","2021",3,3,0,167800,1706.333,127
"22584","64277","2021",4,4,0,198640,1792,112.5
"22585","64279","2021",28,20,8,312955.1,3156.357,110.6786
"22586","64280","2021",8,7,1,140456.2,1258,117.75
"22587","64281","2021",1,1,0,109000,1069,102
"22588","64282","2021",23,11,12,242004.7,2776.783,83.73913
"22589","64283","2021",1,1,0,275000,1786,154
"22590","64284","2021",96,53,43,184968.9,2026.219,91.65625
"22591","64285","2021",1,1,0,75000,682,110
"22592","64286","2021",6,6,0,218500,1524.167,147.6667
"22593","64287","2021",1,1,0,366250,2220,165
"22594","64288","2021",2,2,0,192500,1843.5,104.5
"22595","64289","2021",7,7,0,369503.4,2389,195.1429
"22596","64290","2021",3,3,0,168384.3,1587.333,104
"22597","64291","2021",4,3,1,138125,2011.5,71
"22598","64292","2021",7,7,0,201871.4,1552.571,129.7143
"22599","64293","2021",2,2,0,215500,1546.5,139.5
"22600","64294","2021",2,2,0,94870,1701.5,59
"22601","64295","2021",1,1,0,158300,1330,119
"22602","64297","2021",1,1,0,85000,708,120
"22603","64299","2021",2,2,0,183950,2003,94
"22604","64300","2021",7,7,0,194876.7,1791.429,116.5714
"22605","64301","2021",13,13,0,152493.8,1595.923,105
"22606","64302","2021",4,4,0,201324.2,1395,159.75
"22607","64303","2021",2,2,0,131500,1143.5,115
"22608","64304","2021",40,22,18,309205.1,3349.4,93.625
"22609","64305","2021",13,13,0,151561.2,1421.462,111.2308
"22610","64306","2021",4,4,0,194650,1754.75,109.75
"22611","64307","2021",4,4,0,225750,1531.5,158
"22612","64308","2021",3,3,0,164120,1050.333,165.3333
"22613","64309","2021",2,2,0,106850,1293,81.5
"22614","64310","2021",4,4,0,175383.2,1413.75,132.25
"22615","64311","2021",3,3,0,211333.3,2327,89.33333
"22616","64312","2021",3,3,0,190333.3,1672.667,120.6667
"22617","64314","2021",3,3,0,242673.3,2153.333,112
"22618","64315","2021",6,5,1,209000,2147.333,96.5
"22619","64317","2021",23,11,12,297821.7,3293.783,93.73913
"22620","64320","2021",25,7,18,104461.1,1904.6,51.28
"22621","64322","2021",3,3,0,176000,1752.333,92.66667
"22622","64324","2021",17,17,0,271840.9,1995.765,139.5882
"22623","64325","2021",1,1,0,89000,1780,50
"22624","64327","2021",1,1,0,252500,1180,214
"22625","64328","2021",12,12,0,211456.2,1884.667,116.8333
"22626","64329","2021",8,8,0,293363.8,2133.125,139
"22627","64330","2021",2,2,0,117875,1281.5,86.5
"22628","64331","2021",12,12,0,123850,1171.583,110.8333
"22629","64332","2021",1,1,0,223000,2973,75
"22630","64334","2021",1,1,0,360900,2455,147
"22631","64335","2021",133,88,45,235877.9,2431.083,99.48872
"22632","64336","2021",6,6,0,178133.3,1484,121.6667
"22633","64337","2021",3,3,0,109666.7,1115.667,101.6667
"22634","64339","2021",11,10,1,139275.8,1320.364,112.4545
"22635","64341","2021",2,2,0,205000,1868.5,111
"22636","64342","2021",5,4,1,80440.4,843.2,85.4
"22637","64343","2021",3,3,0,320787.7,2254,142
"22638","64344","2021",1,1,0,258300,1987,130
"22639","64345","2021",1,1,0,75720,781,97
"22640","64347","2021",2,2,0,262905,2198,116
"22641","64348","2021",164,82,82,212256.4,2312.311,91.98171
"22642","64349","2021",5,5,0,266400,1838.8,151
"22643","64350","2021",13,12,1,338457.3,3234.231,119.6154
"22644","64351","2021",3,3,0,125833.3,2075,71
"22645","64352","2021",5,5,0,160858,1797.4,96
"22646","64353","2021",13,11,2,138308.5,1450.231,99.53846
"22647","64354","2021",2,2,0,164000,1402.5,115
"22648","64358","2021",3,3,0,204316.7,1759.333,118
"22649","64359","2021",7,7,0,194600.7,1673.857,115.5714
"22650","64360","2021",6,6,0,129250,1294.667,95.5
"22651","64361","2021",3,3,0,155000,1391.667,110.3333
"22652","64362","2021",2,2,0,228600,1997,114.5
"22653","64363","2021",2,2,0,190000,1738.5,110
"22654","64364","2021",3,3,0,243062.7,1699.333,143.6667
"22655","64365","2021",5,5,0,156860,1350.8,124.8
"22656","64366","2021",2,2,0,177490,1613.5,112
"22657","64367","2021",8,8,0,190362.5,1778.125,112
"22658","64368","2021",3,3,0,339300,1834,182
"22659","64369","2021",3,3,0,212650,1667.667,124
"22660","64370","2021",7,7,0,265487.1,2301.714,112
"22661","64371","2021",23,18,5,115375.7,1245.609,104.4783
"22662","64373","2021",19,16,3,260018.9,2354.158,113.8947
"22663","64374","2021",6,6,0,260978.3,1716.667,144
"22664","64376","2021",5,5,0,252850,1974.2,134.2
"22665","64377","2021",2,1,1,322575,2561,120
"22666","64378","2021",2,2,0,125750,1389.5,90.5
"22667","64380","2021",4,4,0,205325,2128,95.75
"22668","64381","2021",5,5,0,243370,1717.6,146.2
"22669","64382","2021",3,3,0,246933.3,1411.667,180.3333
"22670","64383","2021",3,3,0,148983.3,1325.333,102.3333
"22671","64385","2021",2,2,0,190525,1565.5,123
"22672","64386","2021",9,7,2,190560,1726.556,116.4444
"22673","64387","2021",2,2,0,154367.5,1325,99.5
"22674","64388","2021",1,1,0,261590,1308,200
"22675","64389","2021",1,1,0,40000,1053,38
"22676","64390","2021",4,4,0,126382.8,2033.5,71
"22677","64391","2021",2,2,0,248813,1760.5,130
"22678","64392","2021",1,1,0,147400,1117,132
"22679","64393","2021",57,51,6,194780.4,1858.772,109.8421
"22680","64395","2021",5,5,0,150240.4,1105.2,154.2
"22681","64396","2021",8,8,0,191824.9,1568.125,127.25
"22682","64397","2021",4,4,0,159485,1261.75,127.25
"22683","64398","2021",1,1,0,86000,717,120
"22684","64399","2021",27,26,1,290561.4,2424.407,120.8519
"22685","64400","2021",13,13,0,193635.4,1873.077,108.9231
"22686","64403","2021",1,1,0,245000,1815,135
"22687","64404","2021",3,3,0,161833.3,2068.667,74.33333
"22688","64405","2021",50,39,11,242465.8,2147.08,114.68
"22689","64406","2021",5,5,0,212728.8,2198.2,103.4
"22690","64407","2021",62,49,13,401928.3,3833.258,106.1774
"22691","64408","2021",1,1,0,29200,352,83
"22692","64409","2021",3,3,0,180710,1819.667,99
"22693","64410","2021",54,25,29,106059.8,1275.333,80.75926
"22694","64412","2021",1,1,0,119550,604,198
"22695","64413","2021",5,5,0,179409.4,1810.8,103.8
"22696","64414","2021",1,1,0,309524,2814,110
"22697","64415","2021",14,14,0,258585.3,2397,108.0714
"22698","64416","2021",18,13,5,124203.8,1048.611,115.6111
"22699","64417","2021",51,33,18,190939.7,1645.078,115.7059
"22700","64418","2021",1,1,0,170000,1635,104
"22701","64419","2021",29,27,2,221806.9,1956.414,111.069
"22702","64420","2021",4,4,0,200160.2,1381.75,149.5
"22703","64421","2021",13,13,0,177344.3,1670.385,109.8462
"22704","64422","2021",189,89,100,114677.5,1357.942,86.24339
"22705","64424","2021",2,2,0,107500,1023.5,104
"22706","64425","2021",5,4,1,241000,1768.6,123.8
"22707","64426","2021",2,2,0,127500,1722.5,63
"22708","64427","2021",1,1,0,310000,2520,123
"22709","64430","2021",192,113,79,142572.6,1558.901,94.35938
"22710","64431","2021",3,3,0,236166.7,1730.333,142
"22711","64432","2021",1,1,0,49490,550,90
"22712","64433","2021",9,9,0,153888.3,1244.556,127.5556
"22713","64435","2021",4,4,0,197491.8,1339.75,171
"22714","64436","2021",7,6,1,164021.4,1492.429,119.5714
"22715","64437","2021",1,1,0,366850,2602,141
"22716","64438","2021",3,3,0,225748.3,1865,124
"22717","64439","2021",19,19,0,247586.9,2075.211,121.9474
"22718","64440","2021",7,7,0,206285.7,1562.429,133.5714
"22719","64443","2021",11,9,2,176504.5,1564.182,117.8182
"22720","64444","2021",3,3,0,182466.7,1416,133
"22721","64445","2021",1965,274,1691,140632.8,2007.42,69.34097
"22722","64446","2021",3,3,0,107000,828.3333,130.3333
"22723","64447","2021",2,2,0,150500,1172,125
"22724","64448","2021",28,25,3,245555.6,2308.857,109.0357
"22725","64449","2021",2,2,0,119750,1237.5,95
"22726","64450","2021",1,1,0,233559,2780,84
"22727","64451","2021",2,2,0,175000,1347,129
"22728","64453","2021",25,21,4,167328,1595.32,111.96
"22729","64454","2021",1,1,0,252200,1576,160
"22730","64455","2021",5,5,0,161121.8,1300.2,123.4
"22731","64458","2021",6,6,0,155608.3,1250,137.6667
"22732","64460","2021",5,5,0,163400,1329.6,124.2
"22733","64461","2021",28,28,0,166441,1599.893,105.2143
"22734","64462","2021",7,7,0,186279.4,1481,128.1429
"22735","64463","2021",8,8,0,211286.2,1918.125,121.5
"22736","64464","2021",1,1,0,55000,733,75
"22737","64466","2021",3,3,0,159500,1220,139
"22738","64467","2021",11,10,1,320148.6,2419,135.5455
"22739","64468","2021",1,1,0,188000,1649,114
"22740","64469","2021",3,3,0,259846.7,1600.667,170.3333
"22741","64470","2021",4,4,0,170562.5,1477.75,109.75
"22742","64471","2021",7,7,0,152662.1,1336.857,112.4286
"22743","64472","2021",7,7,0,315779.3,2171.714,152.1429
"22744","64473","2021",5,5,0,259780,2148.4,121
"22745","64474","2021",3,3,0,168666.7,1893.333,95.33333
"22746","64475","2021",5,5,0,110040,1183,97.2
"22747","64476","2021",3,3,0,149333.3,1333,120.3333
"22748","64477","2021",15,12,3,204580,2231.933,97.2
"22749","64478","2021",7,7,0,267493.3,1973.571,138.1429
"22750","64479","2021",3,3,0,217733.3,1654.667,132
"22751","64480","2021",7,7,0,131511.4,1167.714,105.7143
"22752","64481","2021",7,7,0,229259.3,2028.571,114.7143
"22753","64482","2021",4,4,0,228225,2049.75,112.25
"22754","64483","2021",384,57,327,455796.1,6398.758,71.51302
"22755","64484","2021",5,5,0,264093.2,1764.6,153.6
"22756","64485","2021",14,8,6,250975,2737.5,97.35714
"22757","64486","2021",2,2,0,275500,1336.5,241
"22758","64487","2021",1,1,0,156801,933,168
"22759","64488","2021",3,3,0,196045,1595,124.3333
"22760","64490","2021",5,5,0,302200,1993,149.6
"22761","64491","2021",2,2,0,242500,1582,153
"22762","64492","2021",2,2,0,349250,2574,124.5
"22763","64493","2021",17,7,10,180961,1948.706,98.17647
"22764","64494","2021",2,2,0,203500,1789,113
"22765","64495","2021",57,25,32,338029.1,3675.825,87.49123
"22766","64496","2021",69,33,36,340473.7,3649.623,94.21739
"22767","64498","2021",1,1,0,274900,2695,102
"22768","64499","2021",107,72,35,162720.3,1655.71,101.4206
"22769","64500","2021",3,3,0,244709,2138.333,115
"22770","64501","2021",5,4,1,102422.2,1321,83.4
"22771","64502","2021",9,9,0,141340,1431.111,94.33333
"22772","64503","2021",2,2,0,135465,1769.5,86.5
"22773","64504","2021",14,13,1,441641.6,3136.071,146.4286
"22774","64505","2021",6,6,0,246056,1792.667,140.5
"22775","64506","2021",2,2,0,80000,880.5,79
"22776","64507","2021",2,2,0,220000,1718,133.5
"22777","64508","2021",1,1,0,120000,764,157
"22778","64509","2021",3,3,0,192326.7,1472.333,129.3333
"22779","64510","2021",17,16,1,137253.5,1713.412,95.70588
"22780","64511","2021",37,37,0,264986.1,2241.351,118.2973
"22781","64512","2021",1,1,0,237000,1693,140
"22782","64513","2021",32,27,5,174356.4,1590.531,120.0625
"22783","64514","2021",2,2,0,172620,1085.5,162.5
"22784","64515","2021",3,3,0,178666.7,1873.667,109
"22785","64516","2021",4,4,0,197100,1521.75,131
"22786","64517","2021",4,4,0,165750,1793,112.25
"22787","64518","2021",8,8,0,385144.8,2305.75,168.125
"22788","64519","2021",50,49,1,286378.3,2295.84,124.1
"22789","64520","2021",13,13,0,375736.9,2316.538,175.8462
"22790","64521","2021",4,3,1,142475,1584.5,89.25
"22791","64522","2021",8,7,1,167251.2,1567.25,110.125
"22792","64523","2021",6,6,0,184191.7,1623.833,115.6667
"22793","64524","2021",7,7,0,169721.4,1505.429,114
"22794","64525","2021",12,12,0,215720,2168.75,104.4167
"22795","64526","2021",18,15,3,199345,2034.722,95.88889
"22796","64527","2021",9,6,3,366785.3,3285.222,109.1111
"22797","64528","2021",3,2,1,155470,1765.667,90.33333
"22798","64529","2021",3,3,0,133033.3,1089.333,116.6667
"22799","64530","2021",2,2,0,182620,1987.5,92
"22800","64532","2021",2,2,0,196150,1786,108
"22801","64533","2021",9,8,1,99000,899.8889,126
"22802","64534","2021",2,2,0,208681,1521.5,135
"22803","64535","2021",9,9,0,246970,1784.222,139.1111
"22804","64536","2021",11,11,0,223096.4,2017.818,107.6364
"22805","64537","2021",1,1,0,136779,3799,36
"22806","64538","2021",18,9,9,159998.6,2110.056,88.22222
"22807","64539","2021",2,2,0,284750,2588,113.5
"22808","64540","2021",41,33,8,361338,3327.61,108.1463
"22809","64541","2021",1,1,0,57870,463,125
"22810","64542","2021",5,5,0,101100,1861.4,76.4
"22811","64543","2021",3,3,0,112333.3,1183,98
"22812","64545","2021",192,65,127,336156.6,4105.729,81.44271
"22813","64546","2021",39,33,6,318502.2,3138.615,105
"22814","64547","2021",116,52,64,305776.8,3569.224,87.87069
"22815","64549","2021",7,7,0,233624.3,2266.714,112.7143
"22816","64550","2021",6,6,0,295234.2,2037.333,156.1667
"22817","64551","2021",2,2,0,133250,1194.5,113.5
"22818","64552","2021",3,3,0,115333.3,851.6667,135.3333
"22819","64555","2021",2,2,0,245065,1887,140.5
"22820","64556","2021",5,5,0,182311,1834.2,99.4
"22821","64557","2021",2,2,0,166100,1865,89
"22822","64558","2021",34,25,9,411361,3565.676,122.0588
"22823","64559","2021",5,5,0,157160,1531.4,105.4
"22824","64560","2021",1,1,0,218000,1677,130
"22825","65001","2021",7,5,2,184814.3,2116.571,92
"22826","65002","2021",7,6,1,162614.3,2749.714,79.57143
"22827","65003","2021",5,1,4,119300.4,2512.8,51
"22828","65004","2021",1,1,0,262000,1807,145
"22829","65005","2021",5,5,0,215880,1811,118.4
"22830","65006","2021",8,8,0,210207.8,1883.125,101.5
"22831","65007","2021",15,15,0,165274,1296.867,131.0667
"22832","65009","2021",3,3,0,152616.7,1544.333,97.33333
"22833","65010","2021",5,5,0,211840,1756.2,130
"22834","65011","2021",2,2,0,93250,1519.5,64.5
"22835","65012","2021",2,1,1,101000,1542,67.5
"22836","65014","2021",1,1,0,216350,1442,150
"22837","65016","2021",1,1,0,351500,1278,275
"22838","65017","2021",37,2,35,76046,2217.027,35.81081
"22839","65018","2021",6,5,1,118481.7,1460,93.66667
"22840","65019","2021",3,3,0,155346.7,1656.333,88.66667
"22841","65020","2021",1,1,0,178000,1471,121
"22842","65021","2021",5,5,0,255538.4,2052,126.2
"22843","65022","2021",3,3,0,247828.3,2262.333,100.6667
"22844","65024","2021",2,2,0,272439,1658,164.5
"22845","65025","2021",86,29,57,143550,2148.221,69.39535
"22846","65026","2021",2,2,0,176500,1054.5,180
"22847","65028","2021",3,3,0,189000,1422,139.3333
"22848","65029","2021",4,4,0,232500,2576.25,95.5
"22849","65031","2021",35,14,21,111435.1,1920.314,60.57143
"22850","65032","2021",11,6,5,147856.4,2288.091,68
"22851","65033","2021",2,2,0,198490,2648.5,101.5
"22852","65035","2021",8,8,0,158727.5,1367,114
"22853","65036","2021",2,2,0,260705,2860,110
"22854","65040","2021",6,6,0,203655,2182.833,106.6667
"22855","65042","2021",8,7,1,179737.5,1719.125,120.875
"22856","65043","2021",2,2,0,172500,1492.5,115
"22857","65044","2021",6,6,0,164416.7,1489.833,117.3333
"22858","65045","2021",12,11,1,198387.5,2168.167,98
"22859","65046","2021",4,4,0,309797.5,2642.25,115
"22860","65047","2021",148,113,35,133167.6,1564.736,85.56757
"22861","65048","2021",7,7,0,186728.6,1332,140.2857
"22862","65049","2021",5,5,0,119292,1484.2,78
"22863","65050","2021",1,1,0,395000,3264,121
"22864","65051","2021",2,2,0,172750,1484.5,112.5
"22865","65054","2021",4,4,0,77250,910.75,81.75
"22866","65055","2021",2,2,0,451600,2680.5,147
"22867","65056","2021",6,6,0,303987.2,2235.167,136.8333
"22868","65057","2021",5,5,0,364592,1897,154.4
"22869","65058","2021",4,4,0,202782.8,2215,100.75
"22870","65059","2021",291,74,217,98755.11,1684.34,60.02405
"22871","65062","2021",50,49,1,170910.8,1719.58,102.08
"22872","65063","2021",3,3,0,226833.3,1674.333,127.6667
"22873","65064","2021",1,1,0,133000,1900,70
"22874","65065","2021",1,1,0,182000,2022,90
"22875","65066","2021",1,1,0,105000,1694,62
"22876","65069","2021",20,20,0,176370.5,1562.35,112.5
"22877","65070","2021",5,5,0,281150,1510.8,189
"22878","65072","2021",41,39,2,152459.6,1793.902,84.68293
"22879","65073","2021",2,2,0,203480,1358,150
"22880","65074","2021",4,4,0,115492.5,1352.75,92
"22881","65075","2021",1,1,0,3e+05,1852,162
"22882","65077","2021",9,9,0,189176.9,2255,88.88889
"22883","65078","2021",9,8,1,148633.7,1669,96
"22884","65080","2021",4,4,0,243325,2057.25,118.25
"22885","65081","2021",5,5,0,182494,1767.4,106.4
"22886","65082","2021",2,2,0,158400,1769.5,148
"22887","65083","2021",6,6,0,265461.7,2148.667,120.8333
"22888","65084","2021",4,4,0,192715,1758.75,111.75
"22889","65085","2021",4,4,0,109250,1030.5,115
"22890","65086","2021",1,1,0,80000,1481,54
"22891","65087","2021",3,3,0,106060.3,1193.333,91
"22892","65088","2021",1,1,0,43000,364,118
"22893","65089","2021",3,3,0,145500,1522,100.6667
"22894","65090","2021",1,1,0,87522,673,130
"22895","65092","2021",5,5,0,115080,2003.6,75.8
"22896","65093","2021",4,4,0,143075,1382.25,103
"22897","65094","2021",2,2,0,91000,773.5,125
"22898","65095","2021",6,6,0,92016.67,916.5,112.5
"22899","65097","2021",1,1,0,135000,1071,126
"22900","65098","2021",2,2,0,122500,2524.5,54
"22901","65099","2021",5,5,0,142970,1678,87.4
"22902","65100","2021",61,56,5,170530.7,1661.721,103.9836
"22903","65101","2021",9,9,0,169294.4,1543.889,107.2222
"22904","65103","2021",2,2,0,174300,1296.5,181
"22905","65104","2021",7,7,0,266195.7,1744.857,153.7143
"22906","65105","2021",2,2,0,141500,2192.5,88.5
"22907","65106","2021",6,3,3,215250,2636.333,82.66667
"22908","65107","2021",1,1,0,350000,3211,109
"22909","65108","2021",10,10,0,182365,1785,104.8
"22910","65110","2021",1,1,0,156760,1170,134
"22911","65111","2021",5,5,0,125829.2,2041.6,58.6
"22912","65112","2021",1,1,0,218500,3213,68
"22913","65113","2021",2,2,0,246000,1028,215
"22914","65114","2021",1,1,0,116200,801,145
"22915","65115","2021",4,4,0,174800,1656.5,109
"22916","65116","2021",7,6,1,146762.3,2032.429,80.14286
"22917","65119","2021",4,4,0,197825,1553,139.75
"22918","65120","2021",3,3,0,234500,2107.667,112
"22919","65121","2021",5,5,0,210782.2,1514.6,139.6
"22920","65123","2021",62,42,20,123699.4,1875.468,75.37097
"22921","65124","2021",1,1,0,353000,2206,160
"22922","65125","2021",2,2,0,176593.5,1500.5,118.5
"22923","65126","2021",1,1,0,196000,1633,120
"22924","65127","2021",23,15,8,98292.61,1234.783,75.95652
"22925","65128","2021",2,2,0,84800,1001,95.5
"22926","65129","2021",17,16,1,108710.9,1044.941,109.6471
"22927","65130","2021",8,7,1,163281.2,1989.125,103.375
"22928","65131","2021",2,2,0,125000,876.5,159
"22929","65133","2021",4,4,0,213850,1778.75,123.5
"22930","65135","2021",1,1,0,73000,811,90
"22931","65136","2021",1,1,0,320000,2119,151
"22932","65138","2021",194,16,178,117478.6,3011.139,41.29381
"22933","65139","2021",1,1,0,160000,1975,81
"22934","65140","2021",2,2,0,166690,1108,136.5
"22935","65141","2021",7,7,0,294980.9,3150.286,113.2857
"22936","65142","2021",2,2,0,150703.5,1293,135
"22937","65143","2021",3,3,0,141023.3,1534.333,93.33333
"22938","65144","2021",1,1,0,80000,889,90
"22939","65145","2021",1,1,0,151500,1683,90
"22940","65146","2021",2,2,0,197150,1546,126.5
"22941","65147","2021",8,8,0,135920,1669.875,83.25
"22942","65149","2021",1,1,0,143120,1883,76
"22943","65150","2021",8,8,0,130445,1071.625,115.875
"22944","65153","2021",2,2,0,174155,1356,133.5
"22945","65154","2021",2,2,0,185200,1413,142.5
"22946","65155","2021",1,1,0,251750,1564,161
"22947","65156","2021",3,3,0,182426.7,1058,184
"22948","65158","2021",2,2,0,30000,457,73.5
"22949","65159","2021",6,6,0,162808.3,1540.667,110.3333
"22950","65161","2021",2,2,0,185000,1931.5,95.5
"22951","65162","2021",2,2,0,161750,1691,122.5
"22952","65163","2021",2,2,0,87500,891,88.5
"22953","65165","2021",7,7,0,95000,835.1429,101
"22954","65166","2021",1,1,0,124000,2000,62
"22955","65168","2021",35,9,26,148949.6,2475.829,69.25714
"22956","65169","2021",2,2,0,158800,2270.5,75.5
"22957","65170","2021",1,1,0,72000,610,118
"22958","65172","2021",1,1,0,305000,3812,80
"22959","65173","2021",1,1,0,125000,2232,56
"22960","65174","2021",1,1,0,143478,1380,104
"22961","65175","2021",1,1,0,54300,639,85
"22962","65176","2021",6,4,2,109265.8,1053.167,107
"22963","65177","2021",1,1,0,89000,795,112
"22964","65178","2021",1,1,0,250000,2451,102
"22965","65179","2021",1,1,0,90000,1500,60
"22966","65180","2021",1,1,0,63000,913,69
"22967","65182","2021",4,4,0,203537.5,1989.5,114.25
"22968","65183","2021",9,8,1,134611.1,1590.667,92.77778
"22969","65184","2021",2,2,0,140000,1480,93.5
"22970","65185","2021",2,2,0,221875,2062,110
"22971","65186","2021",3,3,0,131500,1567,110.6667
"22972","65187","2021",3,3,0,141333.3,1593,87
"22973","65189","2021",4,4,0,216600,1809.25,122
"22974","65190","2021",2,2,0,125277.5,934.5,133
"22975","65191","2021",6,6,0,149800,2008.167,79.83333
"22976","65192","2021",14,7,7,112121.6,2121.571,64.85714
"22977","65193","2021",3,3,0,131000,1135,109
"22978","65194","2021",1,1,0,1e+05,1754,57
"22979","65195","2021",12,1,11,91980.92,2378.667,34.58333
"22980","65196","2021",1,1,0,65500,624,105
"22981","65197","2021",1,1,0,64815,1906,34
"22982","65198","2021",17,16,1,184653.8,1636.294,117.0588
"22983","65199","2021",24,1,23,129636.7,2488.792,52.83333
"22984","65200","2021",5,5,0,164000,1594,125
"22985","65202","2021",5,4,1,143960,1936.2,74
"22986","65205","2021",1,1,0,335600,2414,139
"22987","65206","2021",3,3,0,141000,1594.667,92
"22988","65209","2021",2,2,0,307391.5,2113,141
"22989","65210","2021",1,1,0,65000,650,100
"22990","65211","2021",2,2,0,238100,1994,125.5
"22991","65212","2021",7,4,3,168800,2504.714,69.28571
"22992","65213","2021",1,1,0,87000,696,125
"22993","65214","2021",2,2,0,144100,1504.5,94.5
"22994","65215","2021",1,1,0,160000,1667,96
"22995","65217","2021",2,2,0,119400,2066.5,67
"22996","65218","2021",14,14,0,132580.8,1297.5,102.9286
"22997","65219","2021",4,4,0,198315,1247.25,164.75
"22998","65220","2021",2,2,0,124000,1441.5,87.5
"22999","65221","2021",1,1,0,170000,1441,118
"23000","65223","2021",12,12,0,225062,1812,124.8333
"23001","65224","2021",2,2,0,199500,1732,116
"23002","65226","2021",30,22,8,171998.5,1829.667,96.9
"23003","65228","2021",5,5,0,146103.4,1812.4,92.6
"23004","65229","2021",1,1,0,60000,822,73
"23005","65230","2021",7,7,0,142642.9,1578.571,93.71429
"23006","65231","2021",5,5,0,143400,1495.6,102.2
"23007","65232","2021",1,1,0,80000,1111,72
"23008","65233","2021",1,1,0,260000,1940,134
"23009","65234","2021",2,2,0,187765,2076.5,92
"23010","65235","2021",45,45,0,183076.6,1878.667,98.53333
"23011","65236","2021",2,2,0,284335,1915.5,148
"23012","65237","2021",3,3,0,124000,976.3333,128.6667
"23013","65238","2021",4,4,0,148375,1478,111.25
"23014","65239","2021",5,5,0,105534.2,1173.8,83
"23015","65240","2021",4,4,0,222525.5,1570.75,152.5
"23016","65241","2021",5,5,0,108280,1224.8,89.4
"23017","65242","2021",1,1,0,230000,1691,136
"23018","65243","2021",11,11,0,210874.5,1717.273,124.3636
"23019","65244","2021",4,4,0,199101.5,1917.75,104.25
"23020","65245","2021",3,3,0,110833.3,1220,83.33333
"23021","65247","2021",1,1,0,146000,1141,128
"23022","65248","2021",7,7,0,191112.9,1604.571,136.4286
"23023","65249","2021",1,1,0,86500,692,125
"23024","65250","2021",2,2,0,222375,2039,109
"23025","65251","2021",27,25,2,196741.1,1737.222,120.1111
"23026","65252","2021",8,7,1,137610,1171.75,135.5
"23027","65254","2021",5,5,0,174470,1307.4,147.2
"23028","65256","2021",1,1,0,75000,573,131
"23029","65257","2021",3,3,0,246608.7,1738.333,141
"23030","65258","2021",104,59,45,96883.29,1292.01,81.69231
"23031","65259","2021",6,6,0,200605,1584.667,124.1667
"23032","65262","2021",5,5,0,144674,1400.4,103.6
"23033","65263","2021",2,2,0,153410,1040.5,137
"23034","65264","2021",10,10,0,170651.3,1294.9,135.4
"23035","65265","2021",5,5,0,179580,1721.4,109.6
"23036","65267","2021",7,3,4,126928.6,1719.571,76.85714
"23037","65269","2021",2,2,0,168744,1347,128
"23038","65271","2021",4,4,0,182625,1411,129
"23039","65272","2021",1,1,0,130000,1857,70
"23040","65273","2021",1,1,0,140000,1217,115
"23041","65274","2021",1,1,0,140400,780,180
"23042","65276","2021",2,2,0,261700,1290.5,203.5
"23043","65278","2021",1,1,0,188000,1979,95
"23044","65279","2021",4,4,0,164080,1536.5,123.75
"23045","65280","2021",8,8,0,176393.8,1576.25,120.375
"23046","65281","2021",1,1,0,358000,2864,125
"23047","65282","2021",24,7,17,163884.1,3397.375,52.875
"23048","65283","2021",1,1,0,121000,1635,74
"23049","65284","2021",10,10,0,209067.6,1692.6,130.7
"23050","65285","2021",1,1,0,145000,980,148
"23051","65286","2021",311,104,207,100000.2,1415.489,74.77814
"23052","65287","2021",11,10,1,124566.8,887.6364,145.4545
"23053","65289","2021",3,3,0,169003.3,1558,128.6667
"23054","65290","2021",3,3,0,214545.3,1791.667,140.3333
"23055","65291","2021",3,3,0,174000,1433.667,127.6667
"23056","65292","2021",6,6,0,189635,1444.5,138.6667
"23057","65294","2021",3,3,0,153600,963,168.6667
"23058","65295","2021",80,11,69,106645.2,2428.2,46.725
"23059","65296","2021",7,7,0,130928.6,1326.429,118.7143
"23060","65298","2021",2,2,0,148024,1282.5,109
"23061","65299","2021",3,3,0,197973.3,1417.667,138.3333
"23062","65300","2021",3,3,0,88933.33,1671.667,50
"23063","65301","2021",6,6,0,162833.3,1543,110.3333
"23064","65303","2021",6,6,0,141966.7,1391,103.6667
"23065","65304","2021",39,38,1,127196.9,1273.026,102.6923
"23066","65305","2021",2,2,0,102500,1604.5,69
"23067","65306","2021",2,2,0,241675,1547,164.5
"23068","65307","2021",10,10,0,125986.2,1060.7,125.5
"23069","65308","2021",2,2,0,114200,1189.5,100.5
"23070","65310","2021",2,2,0,105000,1220,93
"23071","65311","2021",1,1,0,417308,3629,115
"23072","65313","2021",9,9,0,196588,1719.222,125.6667
"23073","65314","2021",5,5,0,183008,1487,136.8
"23074","65315","2021",11,11,0,99224.64,983.8182,104.6364
"23075","65316","2021",4,4,0,94750,842,110.5
"23076","65318","2021",2,2,0,203827.5,1386,171.5
"23077","65319","2021",1,1,0,135000,1570,86
"23078","65320","2021",6,6,0,173189.8,1566.833,109.6667
"23079","65321","2021",1,1,0,189000,2100,90
"23080","65322","2021",4,4,0,201662.5,1040.5,201.25
"23081","65324","2021",1,1,0,292655,1126,260
"23082","65326","2021",1,1,0,55000,579,95
"23083","65327","2021",5,5,0,134202.8,1232.8,124.6
"23084","65329","2021",10,10,0,135034,1929.9,96.3
"23085","65330","2021",2,2,0,141300,1518,94.5
"23086","65331","2021",51,51,0,188798.2,1685.294,114.3137
"23087","65332","2021",1,1,0,134000,1165,115
"23088","65335","2021",6,6,0,209082.7,1449.5,146.1667
"23089","65336","2021",2,2,0,316000,1349.5,236
"23090","65337","2021",2,2,0,139500,931,151
"23091","65338","2021",1,1,0,258325,1318,196
"23092","65339","2021",1,1,0,84000,875,96
"23093","65340","2021",30,26,4,188527.2,1769.767,105.8
"23094","65342","2021",3,3,0,184333.3,1668.667,110.3333
"23095","65343","2021",2,2,0,232450,2379.5,94.5
"23096","65344","2021",24,23,1,183476.2,1710.375,111.9167
"23097","65346","2021",1,1,0,125000,1202,104
"23098","65348","2021",3,3,0,201666.7,1384.333,141.3333
"23099","65350","2021",12,12,0,181947.5,1464.167,131.6667
"23100","65351","2021",5,5,0,135634,1817.8,73
"23101","65352","2021",3,3,0,328300,2741.667,137.6667
"23102","65353","2021",4,4,0,97817.5,1046.25,97.75
"23103","65354","2021",1,1,0,350000,3070,114
"23104","65356","2021",1,1,0,157000,1602,98
"23105","65357","2021",2,2,0,110500,2217.5,53
"23106","65358","2021",1,1,0,228000,1781,128
"23107","65360","2021",3,3,0,139000,1308.667,109.6667
"23108","65361","2021",2,2,0,273340,2067.5,127
"23109","65362","2021",22,12,10,158593.9,1665.5,102.6818
"23110","65363","2021",7,7,0,141000,1265.857,119.1429
"23111","65366","2021",10,10,0,188670,1570.1,119.9
"23112","65367","2021",3,3,0,195666.7,2260.333,87.33333
"23113","65369","2021",9,9,0,179542.2,1565,133.3333
"23114","65370","2021",10,6,4,147014.7,2072.1,73.1
"23115","65371","2021",4,4,0,301365,2056,148.5
"23116","65372","2021",13,13,0,154228.5,1296.769,122.1538
"23117","65373","2021",6,6,0,70166.67,699.8333,96.5
"23118","65374","2021",4,4,0,141777.5,1289.5,112.5
"23119","65375","2021",33,32,1,126452.5,1213.818,111.1515
"23120","65377","2021",4,4,0,157320,1350.25,116.75
"23121","65378","2021",1,1,0,250000,1453,172
"23122","65380","2021",3,3,0,153412,1478.667,112.3333
"23123","65382","2021",1,1,0,62000,653,95
"23124","65383","2021",1,1,0,90000,891,101
"23125","65384","2021",1,1,0,190550,2094,91
"23126","65385","2021",1,1,0,222600,1557,143
"23127","65386","2021",1,1,0,1e+05,568,176
"23128","65387","2021",6,6,0,145179.2,1261.5,113.8333
"23129","65388","2021",211,15,196,107966.1,2714.104,39
"23130","65389","2021",16,15,1,163702.4,1740.188,108.1875
"23131","65390","2021",6,6,0,204803.3,1526.5,139.5
"23132","65391","2021",1,1,0,65000,1182,55
"23133","65392","2021",5,5,0,208480,1786.4,125.6
"23134","65393","2021",6,6,0,153866.7,1805.167,93.16667
"23135","65394","2021",2,2,0,214000,1168,183.5
"23136","65395","2021",14,11,3,134328.6,1113.857,130.6429
"23137","65396","2021",2,2,0,260650,2402,110
"23138","65397","2021",3,3,0,177250,1412.333,154
"23139","65398","2021",3,3,0,170333.3,954,166.6667
"23140","65400","2021",7,7,0,127200,1560.143,92.71429
"23141","65401","2021",5,5,0,340627,2510.6,136.4
"23142","65403","2021",3,3,0,223933.3,1764.333,133.3333
"23143","65404","2021",5,5,0,207660,1537.2,130.4
"23144","65405","2021",2,2,0,114741.5,1076.5,95
"23145","65406","2021",3,3,0,145833.3,1498.333,100.6667
"23146","65407","2021",2,2,0,2e+05,1097.5,183.5
"23147","65408","2021",12,11,1,112195.4,1264.417,89.75
"23148","65409","2021",4,4,0,112222.5,935,135.25
"23149","65410","2021",2,2,0,216750,1280.5,170
"23150","65412","2021",5,5,0,185960,1503.8,130.2
"23151","65413","2021",4,3,1,134964.8,2296.25,61.5
"23152","65414","2021",1,1,0,75000,938,80
"23153","65415","2021",5,5,0,238830,1672.6,131.8
"23154","65416","2021",5,5,0,98300,990.8,105.8
"23155","65417","2021",63,55,8,158220,1727.619,98.66667
"23156","65418","2021",7,7,0,165825,1362.571,127.8571
"23157","65420","2021",1,1,0,442000,2456,180
"23158","65422","2021",1,1,0,235565,1636,144
"23159","65424","2021",2,1,1,122167.5,2222,53.5
"23160","65425","2021",2,2,0,115400,1048.5,117
"23161","65427","2021",6,6,0,129284.8,1143,115.1667
"23162","65428","2021",2,2,0,150435,1346,116.5
"23163","65429","2021",1,1,0,120000,857,140
"23164","65431","2021",6,6,0,77451.67,1060.167,83.66667
"23165","65432","2021",5,5,0,123680,1211.4,109
"23166","65433","2021",56,49,7,148268.9,1552.821,95.92857
"23167","65435","2021",4,2,2,119750,2015.75,60
"23168","65436","2021",4,4,0,177238.5,1262,143
"23169","65437","2021",1,1,0,284600,1626,175
"23170","65439","2021",3,3,0,238613.3,1918.333,125
"23171","65440","2021",950,249,701,104114.6,1429.062,73.56105
"23172","65441","2021",3,3,0,112333.3,1878.333,63
"23173","65442","2021",4,4,0,274750,1855.25,147.5
"23174","65443","2021",1,1,0,202150,1476,137
"23175","65444","2021",5,5,0,208940,1491.6,133.2
"23176","65446","2021",7,7,0,155600,1356.857,117.2857
"23177","65447","2021",16,16,0,143691.9,1460.062,109.5625
"23178","65449","2021",3,3,0,124666.7,850.6667,143.3333
"23179","65450","2021",2,2,0,139750,1594.5,92.5
"23180","65451","2021",11,11,0,160781.8,1360.455,125.4545
"23181","65452","2021",20,19,1,120573,960.35,127.95
"23182","65454","2021",1,1,0,80000,615,130
"23183","65455","2021",3,3,0,149600,1495,100.3333
"23184","65456","2021",2,2,0,59293,773,73
"23185","65457","2021",1,1,0,248900,1886,132
"23186","65458","2021",2,2,0,285375,3307,108.5
"23187","65459","2021",1,1,0,70000,1207,58
"23188","65460","2021",101,72,29,119993.2,1300.802,93.13861
"23189","65462","2021",7,7,0,166789,1010.714,160.2857
"23190","65463","2021",1,1,0,90880,811,112
"23191","65464","2021",2,2,0,213075,1760,121
"23192","65465","2021",28,4,24,137041,2730.179,51.03571
"23193","65466","2021",1,1,0,290000,1908,152
"23194","65467","2021",3,3,0,280873.3,2380.667,119.6667
"23195","65468","2021",2,2,0,145000,1480,100
"23196","65469","2021",1,0,1,87163,2421,36
"23197","65470","2021",1,1,0,170000,944,180
"23198","65471","2021",16,1,15,148486.3,3443,45.75
"23199","65472","2021",3,3,0,82200,816.6667,112
"23200","65473","2021",8,7,1,199657.5,1804.625,112.75
"23201","65476","2021",1,1,0,91000,910,100
"23202","65481","2021",35,2,33,66697.14,1942.886,36.02857
"23203","65482","2021",6,6,0,94333.33,1179,94.16667
"23204","66002","2021",26,22,4,216300.7,2377.808,91.88462
"23205","66003","2021",181,27,154,73611.29,1376.818,51.47514
"23206","66004","2021",122,25,97,117017.9,2663.295,42.07377
"23207","66005","2021",4,3,1,204962.5,2183.5,95
"23208","66006","2021",5,5,0,137183,1615.4,81
"23209","66008","2021",250,93,157,156807.8,3128.1,53.352
"23210","66009","2021",40,31,9,156765.7,1800.975,86.9
"23211","66010","2021",1,1,0,65000,1121,58
"23212","66011","2021",60,55,5,188848.2,2181.8,87.78333
"23213","66012","2021",15,12,3,160182.7,2029.467,75.73333
"23214","66014","2021",45,42,3,136418,1633.978,84.33333
"23215","66015","2021",29,28,1,212874.6,2217.828,97.17241
"23216","66016","2021",65,25,40,197346.6,3056.354,64.81538
"23217","66017","2021",354,86,268,103972.1,2829.751,36.15819
"23218","66019","2021",2,2,0,81000,1075,84
"23219","66020","2021",93,29,64,170987.2,2934.505,56.86022
"23220","66021","2021",63,57,6,214537.6,2147.254,99.49206
"23221","66022","2021",4,4,0,114750,1414.25,81.75
"23222","66023","2021",10,9,1,153925.5,1909.1,95.9
"23223","66024","2021",84,67,17,198162.5,2124.952,90.02381
"23224","66025","2021",26,14,12,166982.2,2216.962,80.30769
"23225","66026","2021",29,28,1,243156.1,2428.414,105.4138
"23226","66027","2021",6,6,0,150000,1721.333,91
"23227","66028","2021",70,63,7,273892.7,2394.429,111.8714
"23228","66029","2021",2,2,0,232700,2928,83
"23229","66030","2021",3,3,0,125000,1948,82.66667
"23230","66032","2021",1,1,0,120000,1500,80
"23231","66033","2021",3,3,0,196230,2337.333,89.33333
"23232","66034","2021",3,3,0,56333.33,804.3333,70
"23233","66037","2021",344,100,244,175343.8,3166.529,55.34302
"23234","66038","2021",55,51,4,239217.1,2414.982,99.21818
"23235","66039","2021",1,1,0,1e+05,909,110
"23236","66041","2021",16,16,0,252150.4,2266.812,103.25
"23237","66042","2021",6,6,0,148209.3,1539,95.16667
"23238","66043","2021",2,2,0,90500,1024.5,80
"23239","66044","2021",1,1,0,490261,3453,142
"23240","66045","2021",14,13,1,168038.6,1713.5,97.28571
"23241","66046","2021",17,16,1,105874.7,1061.882,88
"23242","66048","2021",23,7,16,165747.9,2892.913,56.86957
"23243","66049","2021",124,85,39,205897.9,2313.516,87.58065
"23244","66050","2021",42,38,4,221217.6,2318.881,96.42857
"23245","66051","2021",7,7,0,174955,1974.429,88.71429
"23246","66052","2021",8,7,1,167405.8,1676.875,97.625
"23247","66053","2021",68,19,49,253873.6,4324.206,60.79412
"23248","66055","2021",10,10,0,147518.1,1835.5,83.4
"23249","66056","2021",10,10,0,164793.4,1766.8,97.3
"23250","66057","2021",9,9,0,148674.4,1370.333,102.1111
"23251","66058","2021",31,30,1,155241,1622.226,91.29032
"23252","66059","2021",17,13,4,194744.1,2408.706,85.52941
"23253","66060","2021",1,1,0,285000,3276,87
"23254","66061","2021",9,7,2,114806.7,1550,80.66667
"23255","66062","2021",8,4,4,153750,2397.625,67.75
"23256","66063","2021",9,9,0,322668.8,2650.222,125.4444
"23257","66064","2021",8,5,3,152795,2023,81.25
"23258","66065","2021",76,63,13,171740.3,2024.105,88.26316
"23259","66066","2021",11,4,7,132993.6,1954.455,66.27273
"23260","66067","2021",13,8,5,171000,2301.538,74.76923
"23261","66068","2021",2,2,0,103500,1160,108
"23262","66069","2021",46,44,2,179753.1,2093.304,86.95652
"23263","66070","2021",4,3,1,103500,1066,90.5
"23264","66071","2021",38,38,0,121675.7,1585.342,75.28947
"23265","66072","2021",15,11,4,232438,2949.267,87.8
"23266","66073","2021",3,3,0,71800,835.6667,82.33333
"23267","66074","2021",7,6,1,242580,2247.571,119.5714
"23268","66075","2021",25,11,14,115027.8,2520.72,43
"23269","66076","2021",1,1,0,60000,750,80
"23270","66077","2021",3,3,0,188438,1656.667,115
"23271","66078","2021",3,3,0,125000,1582.333,78
"23272","66079","2021",8,8,0,159562.5,2183.125,81.375
"23273","66080","2021",5,5,0,98088,1813.4,64.4
"23274","66081","2021",3,2,1,126000,1760.333,75
"23275","66082","2021",11,3,8,120641.5,2468.818,56.63636
"23276","66083","2021",1,1,0,87000,503,173
"23277","66084","2021",23,23,0,188769.5,1831.565,102
"23278","66085","2021",6,6,0,205956.2,2013.667,105.3333
"23279","66088","2021",80,68,12,153273.8,1726.812,88.7375
"23280","66089","2021",8,8,0,227885.6,2275.25,109
"23281","66090","2021",2,2,0,63385,1173,56
"23282","66091","2021",3,2,1,80673.33,1929.667,48.66667
"23283","66092","2021",1,1,0,187500,1410,133
"23284","66093","2021",28,25,3,332393.9,3382.821,105.3214
"23285","66094","2021",30,28,2,260135.9,2618.6,99.13333
"23286","66095","2021",15,11,4,149699.7,1961.6,90
"23287","66096","2021",6,6,0,129341.7,1179,101.1667
"23288","66097","2021",6,6,0,93516.67,1040.667,89.66667
"23289","66098","2021",3,2,1,156700,2284,66.33333
"23290","66099","2021",9,9,0,283722.2,2615.333,106
"23291","66101","2021",33,33,0,276271.8,2630.061,108.1515
"23292","66103","2021",6,6,0,111583.3,1476,72.83333
"23293","66104","2021",8,8,0,178987.5,1635,102.25
"23294","66105","2021",5,4,1,248588,2806.4,96.6
"23295","66106","2021",57,52,5,184045.5,2100.579,90.77193
"23296","66107","2021",9,9,0,84692.22,1098.333,87.77778
"23297","66108","2021",55,55,0,154764,1712.855,87.67273
"23298","66109","2021",6,6,0,128411.2,1716.667,76.83333
"23299","66111","2021",5,5,0,183400,1216.4,119.8
"23300","66112","2021",3,3,0,177950,1954.667,101.3333
"23301","66113","2021",6,4,2,176908.3,1870.667,91.66667
"23302","66114","2021",12,11,1,271252.5,2511.583,111.0833
"23303","66115","2021",17,17,0,296123.5,2249.353,121.2353
"23304","66116","2021",4,4,0,336525,1768.5,202.25
"23305","66117","2021",3,1,2,113333.3,2074.333,50.33333
"23306","66118","2021",7,7,0,143640,1587.143,85.71429
"23307","66119","2021",9,8,1,100083.3,1464.444,71.44444
"23308","66121","2021",17,16,1,138337.1,2313.471,62.05882
"23309","66122","2021",4,4,0,114143.8,1235.25,93.75
"23310","66123","2021",1,1,0,58000,773,75
"23311","66124","2021",199,24,175,106005.3,2192.296,48.50754
"23312","66125","2021",4,4,0,68300,1412.25,46
"23313","66126","2021",11,11,0,174460.5,1646.182,104.1818
"23314","66127","2021",16,16,0,147377.9,1540.688,90.3125
"23315","66128","2021",1,1,0,51000,927,55
"23316","66129","2021",40,40,0,219322.9,2232.35,101.525
"23317","66130","2021",26,8,18,176117.3,2463.885,77.96154
"23318","66132","2021",10,7,3,210545,2728,81.1
"23319","66133","2021",29,27,2,242109.3,2183.034,107.6207
"23320","66134","2021",17,15,2,240156.1,2000.294,130.4118
"23321","66136","2021",1287,376,911,130662.2,1636.327,77.16628
"23322","66137","2021",8,4,4,116050,1182.75,112.375
"23323","66138","2021",19,14,5,212326.1,2277,97.89474
"23324","66140","2021",43,43,0,179415.3,2217.744,81.46512
"23325","66141","2021",77,74,3,193840.7,2011.065,96.14286
"23326","66142","2021",1,1,0,4e+05,3883,103
"23327","66144","2021",70,66,4,205737.3,2244.086,91.98571
"23328","66145","2021",30,29,1,187957.8,2044.133,92.36667
"23329","66146","2021",3,3,0,79000,1139,65
"23330","66147","2021",5,2,3,133546,2672.8,43.2
"23331","66148","2021",62,15,47,167447.8,2937.226,60.80645
"23332","66149","2021",81,52,29,133180.6,1662.691,83.22222
"23333","66150","2021",19,10,9,75849.21,1054.842,71.26316
"23334","66152","2021",1,1,0,39000,390,100
"23335","66153","2021",1,1,0,475000,1931,246
"23336","66154","2021",19,15,4,91496.74,2540,39.73684
"23337","66155","2021",5,5,0,71000,1247,57.2
"23338","66156","2021",2,2,0,38842.5,730,53
"23339","66157","2021",3,3,0,80000,1098.667,65
"23340","66158","2021",3,3,0,160758.3,1015.667,156.3333
"23341","66159","2021",3,3,0,149791.3,2184,64.66667
"23342","66160","2021",19,17,2,240076.7,2798.789,92.63158
"23343","66161","2021",14,14,0,158403.8,1673.071,90.57143
"23344","66162","2021",9,9,0,135430.4,1968.222,70.33333
"23345","66164","2021",93,80,13,170919.6,1950.914,89.49462
"23346","66165","2021",7,7,0,167889.3,1959.857,85
"23347","66166","2021",6,6,0,104700,1277.333,78.5
"23348","66167","2021",20,13,7,222516.5,2717.85,83.2
"23349","66168","2021",29,28,1,199643.8,2383.517,86.10345
"23350","66169","2021",2,2,0,145000,1019.5,127
"23351","66170","2021",1,1,0,608820,2416,252
"23352","66171","2021",400,192,208,181886.8,3392.4,55.8575
"23353","66172","2021",97,62,35,206202.2,2299.072,87.76289
"23354","66173","2021",13,13,0,200831.5,2172.846,92.07692
"23355","66174","2021",34,32,2,177819,1917.559,93.26471
"23356","66175","2021",40,38,2,214956.4,2247.95,97.45
"23357","66176","2021",29,28,1,207014.4,2079.966,97.27586
"23358","66177","2021",26,24,2,217196.5,2300.808,94.84615
"23359","66178","2021",27,27,0,238610.6,2264.037,102.8519
"23360","66179","2021",16,10,6,85346.88,1118.812,79
"23361","66180","2021",98,84,14,177065.2,2149.735,82.84694
"23362","66181","2021",9,2,7,163163.9,3035.778,50.66667
"23363","66182","2021",70,59,11,179382.9,3047.757,63.67143
"23364","66183","2021",3,3,0,104100,1032.333,97.33333
"23365","66184","2021",3,3,0,70666.67,921.3333,75.66667
"23366","66186","2021",17,16,1,200446.9,2233.059,91.70588
"23367","66187","2021",34,28,6,79341.18,984.2059,82.17647
"23368","66188","2021",20,11,9,140578.5,2165.1,68.4
"23369","66189","2021",41,36,5,255001.9,2527.561,99.53659
"23370","66190","2021",25,25,0,146592,1850.36,80.32
"23371","66192","2021",2,1,1,143460,1660,90
"23372","66193","2021",1,1,0,42000,700,60
"23373","66194","2021",7,7,0,167628.6,1824.714,96.14286
"23374","66195","2021",87,80,7,211993.1,2155.425,98.74713
"23375","66196","2021",48,42,6,214623.8,2447.312,89.95833
"23376","66198","2021",7,6,1,83428.57,1109.286,75.85714
"23377","66199","2021",2,2,0,385750,1955.5,201.5
"23378","66201","2021",1,1,0,44000,846,52
"23379","66202","2021",7,4,3,187550,2352.714,78
"23380","66203","2021",4,4,0,90250,1060,82.25
"23381","66204","2021",2,2,0,95500,2746.5,34
"23382","66205","2021",8,8,0,151269,1655.625,81.125
"23383","66206","2021",3,3,0,121665,1242,116
"23384","66207","2021",13,13,0,194545.5,1865.923,101.5385
"23385","66208","2021",12,12,0,250150.8,2344.667,107.8333
"23386","66210","2021",82,69,13,171218.7,2081.89,85.2439
"23387","66212","2021",51,50,1,177159.2,2655.608,69.62745
"23388","66213","2021",47,45,2,213935,2220.234,95.55319
"23389","66214","2021",16,16,0,232882.2,2695.5,94.625
"23390","66215","2021",1,1,0,32000,427,75
"23391","66216","2021",2,2,0,122250,1073.5,106
"23392","66217","2021",34,34,0,197742.8,2094.118,95.47059
"23393","66218","2021",5,3,2,217400,2646.4,82.4
"23394","66219","2021",2,2,0,85000,1158,73.5
"23395","66220","2021",1,1,0,157000,2617,60
"23396","66222","2021",58,22,36,89602.72,1428.414,58.75862
"23397","66223","2021",5,5,0,72932,710,103.6
"23398","66224","2021",28,25,3,218938,2242.464,100.5357
"23399","66225","2021",21,17,4,278692.9,2885.524,99.33333
"23400","66226","2021",16,16,0,220816.4,2162,102.25
"23401","66227","2021",33,32,1,300688.6,2720.636,109.4848
"23402","66228","2021",12,11,1,143485.8,1870.25,79.5
"23403","66230","2021",47,43,4,170603.1,1803.234,93.19149
"23404","66231","2021",3,3,0,131023.3,1137,99.33333
"23405","66233","2021",1,1,0,80000,1111,72
"23406","66234","2021",3,3,0,87333.33,1108,78.33333
"23407","68065","2021",1,1,0,180000,1500,120
"23408","69001","2021",2,2,0,242925,2245,107.5
"23409","69002","2021",8,8,0,85131.25,1314,69.875
"23410","69003","2021",34,16,18,363323.8,3891.382,97.32353
"23411","69004","2021",8,6,2,304711.2,3977.125,74.5
"23412","69005","2021",10,5,5,265805,3047.8,94.5
"23413","69006","2021",62,41,21,130901.9,1364.855,96.90323
"23414","69007","2021",36,28,8,237952.3,2500.944,99.86111
"23415","69008","2021",10,10,0,297452,2488,118.9
"23416","69009","2021",132,86,46,305244,3253.894,95.75
"23417","69010","2021",94,35,59,228550,2736.277,82.58511
"23418","69012","2021",7,7,0,227508.6,1940.286,126.8571
"23419","69013","2021",58,35,23,292953.6,2802.172,97.77586
"23420","69014","2021",6,6,0,184991.7,1848.833,98.66667
"23421","69016","2021",1,1,0,252070,1939,130
"23422","69017","2021",16,15,1,379635.6,3268,119.5
"23423","69018","2021",36,21,15,149221.7,1616.944,87.66667
"23424","69019","2021",222,118,104,213913.3,2402.338,90.08559
"23425","69020","2021",15,10,5,327620,3070.933,103.4
"23426","69021","2021",25,22,3,241260,2552.44,96.12
"23427","69022","2021",8,8,0,243380,2300.5,106.5
"23428","69023","2021",14,14,0,338576.8,2926,118.5
"23429","69024","2021",59,49,10,331018.1,3114.153,112.2881
"23430","69026","2021",10,9,1,235672.6,2252.6,118.7
"23431","69027","2021",163,81,82,362208.5,4007.061,90.91411
"23432","69028","2021",95,55,40,375406.1,4134.263,90.50526
"23433","69029","2021",518,96,422,259393.6,3480.369,72.73552
"23434","69030","2021",10,9,1,235450.5,2800.5,89.6
"23435","69031","2021",26,25,1,237300.4,2489.346,96.11538
"23436","69032","2021",29,22,7,372762.4,3673.552,101.7586
"23437","69033","2021",33,28,5,551175.2,4748.667,117.4848
"23438","69034","2021",821,81,740,360894.7,4491.486,78.79903
"23439","69035","2021",5,5,0,235580,2057,128.6
"23440","69036","2021",7,7,0,238907.1,2400,99.57143
"23441","69037","2021",17,14,3,184178.8,1762.647,106.4706
"23442","69038","2021",18,18,0,154458.3,1551.167,110.2778
"23443","69039","2021",12,12,0,171199.2,1974.667,87.91667
"23444","69040","2021",97,31,66,442876.1,4455.052,92.06186
"23445","69042","2021",5,5,0,202370,2156.2,94.2
"23446","69043","2021",91,60,31,468946,4650.527,100.3736
"23447","69044","2021",52,29,23,628571.1,5106.635,121.4808
"23448","69045","2021",15,14,1,298641.3,2712.267,108.1333
"23449","69046","2021",60,47,13,537972.3,4574.567,119.5667
"23450","69047","2021",10,9,1,352580.2,3204.8,108.4
"23451","69049","2021",39,30,9,441283.6,4164.282,104.0769
"23452","69050","2021",44,36,8,357305.9,3653.477,101.2273
"23453","69051","2021",9,9,0,356453.3,3966.667,89.66667
"23454","69052","2021",65,48,17,422440.3,4191.969,104.1385
"23455","69053","2021",14,14,0,222988.9,2608.643,110.2143
"23456","69054","2021",10,10,0,196987,1731.1,126.8
"23457","69055","2021",14,11,3,414732.1,3846.357,108.4286
"23458","69056","2021",30,22,8,296161.3,3108.433,92.73333
"23459","69057","2021",5,5,0,354850,2966.2,121
"23460","69058","2021",10,10,0,219746,1941.9,125.9
"23461","69059","2021",23,20,3,428509.9,4131,110.7826
"23462","69060","2021",9,9,0,135305,1144.778,109.6667
"23463","69061","2021",12,12,0,373890.6,3524.083,117.4167
"23464","69062","2021",4,3,1,176767.5,1906.75,90.75
"23465","69063","2021",81,36,45,543460.3,4931.79,104.5556
"23466","69064","2021",67,34,33,207474.9,2616.791,80.43284
"23467","69065","2021",20,16,4,270823.1,2479.15,110
"23468","69066","2021",56,47,9,98250.46,1127.643,85.03571
"23469","69067","2021",18,17,1,193534.4,2123.611,93.22222
"23470","69068","2021",37,21,16,366830.4,4112.486,92.59459
"23471","69069","2021",169,66,103,371183.2,4383.917,85.89349
"23472","69070","2021",26,26,0,172425.8,1621,106.5
"23473","69071","2021",14,9,5,534133.2,4284.214,124.6429
"23474","69072","2021",108,63,45,505561,4674.454,103.4444
"23475","69074","2021",19,11,8,282493.4,2712.158,105.4211
"23476","69075","2021",3,3,0,174000,1576.667,97
"23477","69076","2021",38,25,13,524946.3,4608.342,112.0526
"23478","69077","2021",13,12,1,242202.5,2416.846,98.61538
"23479","69078","2021",14,12,2,218144.3,2463.714,89.5
"23480","69080","2021",22,18,4,261263,2679.5,98.72727
"23481","69081","2021",261,63,198,481550,4765.307,96.43678
"23482","69082","2021",4,4,0,284593.8,3322.25,89.75
"23483","69083","2021",9,8,1,486335.6,3634.333,133.3333
"23484","69084","2021",19,18,1,222365.8,2833.211,85.15789
"23485","69085","2021",14,12,2,560400.7,5084.357,116.0714
"23486","69086","2021",31,25,6,398360.2,3839.387,104.7742
"23487","69087","2021",42,30,12,481773.6,4301.929,108.3571
"23488","69088","2021",144,21,123,287607.5,3656.569,77.53472
"23489","69089","2021",219,79,140,380653.6,4251.306,87.07763
"23490","69090","2021",17,11,6,318406.5,2812.294,115.7059
"23491","69091","2021",212,86,126,184316.5,2222.986,85.37264
"23492","69092","2021",95,58,37,264046,2681.421,97.32632
"23493","69093","2021",27,25,2,121269.6,1536.704,82.85185
"23494","69094","2021",79,41,38,403283.3,4254.608,93.8481
"23495","69095","2021",13,11,2,211541.5,2010.923,105.3846
"23496","69096","2021",155,63,92,198396,2569.781,77.66452
"23497","69097","2021",6,6,0,295116.7,3036.833,100.3333
"23498","69098","2021",7,7,0,162657.1,1699,92.85714
"23499","69099","2021",20,19,1,167378,1855.45,88.9
"23500","69100","2021",99,48,51,354506.5,3906.596,89.52525
"23501","69102","2021",8,6,2,238006.9,2118.125,122.25
"23502","69103","2021",20,19,1,230133.5,1815.6,125.35
"23503","69104","2021",11,11,0,169213.6,1570.364,106.4545
"23504","69105","2021",19,17,2,355657.6,2968.684,117.3158
"23505","69106","2021",25,21,4,426517.6,3426.2,124.48
"23506","69107","2021",20,19,1,167542.5,1801.6,93.3
"23507","69108","2021",11,9,2,200044.1,2155.273,96.72727
"23508","69109","2021",6,6,0,241958.3,1947.667,125.6667
"23509","69110","2021",26,25,1,239183,2386.923,106.7692
"23510","69111","2021",13,7,6,356706.2,3047.692,116.9231
"23511","69112","2021",89,62,27,428511.6,4083.146,107.809
"23512","69113","2021",10,10,0,288939.8,2636.8,126.5
"23513","69115","2021",82,43,39,265349.8,2803.183,90.84146
"23514","69116","2021",52,32,20,666105.2,5194.462,131.7692
"23515","69117","2021",53,42,11,465711.2,4197.075,114.1509
"23516","69118","2021",36,26,10,244584.9,2730.75,93.38889
"23517","69119","2021",12,11,1,231277.5,2255.75,100.8333
"23518","69120","2021",12,12,0,175161.7,1891.167,101.6667
"23519","69121","2021",46,31,15,381250.8,3880.457,98.52174
"23520","69122","2021",35,21,14,313926.9,3446.8,97.85714
"23521","69123","2021",8104,234,7870,334716.4,5128.611,66.27061
"23522","69124","2021",7,7,0,230034.3,2169.429,98.71429
"23523","69125","2021",15,12,3,340915.3,3741.4,91.53333
"23524","69126","2021",15,12,3,364032.7,3669.333,97.33333
"23525","69127","2021",38,27,11,453846.1,4958.053,95.81579
"23526","69130","2021",3,3,0,143513.3,1697,93.33333
"23527","69131","2021",34,24,10,372977.4,4110.588,93.58824
"23528","69132","2021",11,11,0,219595.5,1569.455,143.6364
"23529","69133","2021",49,35,14,458664.9,4225,106.8163
"23530","69134","2021",4,4,0,410037.8,3188,130.5
"23531","69135","2021",45,40,5,142526.4,1306.467,108.0444
"23532","69136","2021",36,32,4,428595.7,3845.306,111.3333
"23533","69137","2021",2,2,0,385300,2622,147.5
"23534","69138","2021",1,1,0,235000,2080,113
"23535","69139","2021",20,14,6,157121.5,2020.3,76.3
"23536","69140","2021",34,24,10,383216.3,3644.941,106.6176
"23537","69141","2021",88,60,28,336005.5,3671.261,92.21591
"23538","69142","2021",111,9,102,248831.8,3258.171,74.81982
"23539","69143","2021",129,41,88,295762.4,3659.442,79.27132
"23540","69145","2021",8,7,1,242923.8,2550.5,93.625
"23541","69148","2021",40,26,14,364839,3592.3,100.25
"23542","69149","2021",454,79,375,259320.2,3583.11,72.05947
"23543","69151","2021",18,17,1,224379.6,2540.111,89.38889
"23544","69152","2021",149,50,99,235090.9,3215.329,72.34228
"23545","69153","2021",17,14,3,560286.5,5333.471,110
"23546","69154","2021",54,38,16,398072.5,3854.63,104.0556
"23547","69155","2021",10,10,0,252294,2024.6,121.4
"23548","69156","2021",30,25,5,469708.5,3526.667,131.0333
"23549","69157","2021",74,48,26,230043.7,2382.203,95.05405
"23550","69159","2021",48,40,8,318838.2,2978.229,107.1667
"23551","69160","2021",22,20,2,133363.2,1272.273,107.1364
"23552","69161","2021",14,14,0,160457.1,1668.571,101.0714
"23553","69162","2021",17,17,0,289444.6,2271.824,129.6471
"23554","69163","2021",54,45,9,349349.5,3424.185,105.4074
"23555","69164","2021",7,7,0,78854.29,856.7143,86.14286
"23556","69165","2021",22,22,0,209618.2,1982.273,115.5909
"23557","69166","2021",5,2,3,194806,1555.4,123.8
"23558","69167","2021",4,4,0,206100,2313.25,86
"23559","69168","2021",23,17,6,579898.8,4996.261,119.3043
"23560","69169","2021",5,5,0,146000,1798.8,85
"23561","69170","2021",13,12,1,348004.6,2891.462,122.0769
"23562","69171","2021",34,19,15,273418.8,3013.941,90.91176
"23563","69172","2021",16,13,3,340844.4,2436.688,136.8125
"23564","69173","2021",6,4,2,233264.3,2412.5,95.66667
"23565","69174","2021",8,8,0,200556.2,2221,89.5
"23566","69175","2021",14,13,1,287005.7,2853.643,98.92857
"23567","69176","2021",47,33,14,380726.7,3654.83,105.7447
"23568","69177","2021",24,21,3,345905,3314,100.5833
"23569","69178","2021",6,6,0,222686.7,2207.5,98.83333
"23570","69179","2021",58,45,13,320389.4,3211.569,102.1379
"23571","69180","2021",4,4,0,309012.5,2717.75,110.25
"23572","69181","2021",6,6,0,260590,2034.667,127.8333
"23573","69182","2021",9,9,0,127077.8,1206.111,106
"23574","69183","2021",9,9,0,92215.56,835.4444,108.6667
"23575","69184","2021",15,15,0,220393.3,2294.267,95.86667
"23576","69186","2021",8,8,0,82187.5,1086.5,74.125
"23577","69187","2021",12,12,0,258084.2,1910.417,140.6667
"23578","69188","2021",16,14,2,202300.6,2136.312,91.75
"23579","69189","2021",32,8,24,232090.1,2838.156,78.46875
"23580","69190","2021",32,25,7,462299.1,4222.781,109.7812
"23581","69191","2021",81,53,28,787748.1,5425.951,141.9259
"23582","69192","2021",2,2,0,253197.5,2984,87
"23583","69193","2021",18,18,0,472276.9,3424.111,138.5556
"23584","69194","2021",91,66,25,923771.2,6380.044,147.5385
"23585","69196","2021",9,8,1,166422.2,1555.556,100.8889
"23586","69197","2021",26,24,2,262538.5,2760.692,109.1154
"23587","69198","2021",14,14,0,290400.7,2761.929,109.9286
"23588","69199","2021",178,29,149,160372,2436.551,67.23034
"23589","69200","2021",17,15,2,226887.1,2281.824,98.94118
"23590","69201","2021",22,13,9,143530.9,1874.5,75.5
"23591","69202","2021",356,81,275,381703.1,4261.365,85.52528
"23592","69203","2021",21,18,3,195745,2043.238,98.04762
"23593","69204","2021",266,93,173,355453,4154.417,85.96617
"23594","69205","2021",54,42,12,482491.6,4782.611,100.8519
"23595","69206","2021",54,41,13,280093.5,2535.074,110.1852
"23596","69207","2021",36,26,10,435714.9,4455.722,96.83333
"23597","69208","2021",16,15,1,336830,2949.812,109.3125
"23598","69209","2021",4,4,0,123875,1501.5,90.25
"23599","69212","2021",3,3,0,475390,3047,153.3333
"23600","69214","2021",11,9,2,160872.7,1485.091,108.0909
"23601","69215","2021",16,15,1,310442.2,2988.188,106.8125
"23602","69216","2021",8,7,1,205453.1,2153.75,102.875
"23603","69217","2021",14,14,0,170075.7,1439.214,120.3571
"23604","69218","2021",14,11,3,210181.4,2048.857,111.2143
"23605","69219","2021",43,35,8,351882.6,3514.977,103.4419
"23606","69220","2021",33,25,8,189373.6,2009.455,93.93939
"23607","69225","2021",4,4,0,284982.5,2817.5,111
"23608","69227","2021",29,23,6,331510.9,3082.069,115.1379
"23609","69228","2021",44,39,5,314022.5,2937,109.5455
"23610","69229","2021",21,21,0,131665,1470.619,88.90476
"23611","69230","2021",5,5,0,228770,2277.4,100.4
"23612","69231","2021",30,22,8,352921,3089.033,122.0667
"23613","69233","2021",22,20,2,667044.3,5288.773,129.7727
"23614","69234","2021",20,20,0,308171.5,2841.3,114.2
"23615","69235","2021",24,12,12,216723.1,2298.25,99.75
"23616","69236","2021",11,11,0,233111.8,2613.727,94.18182
"23617","69238","2021",43,24,19,173127.9,2168.628,80.67442
"23618","69239","2021",16,16,0,349158.8,2867.75,126.0625
"23619","69240","2021",25,23,2,117728.4,1179.16,102
"23620","69241","2021",45,26,19,333698,3498.511,99.73333
"23621","69242","2021",17,16,1,283489.1,2571.882,115.1176
"23622","69243","2021",146,56,90,178372.3,1903.856,96.03425
"23623","69244","2021",442,72,370,381915,4589.507,80.0181
"23624","69245","2021",12,11,1,249870.8,3228.417,79.75
"23625","69246","2021",26,25,1,436627.1,3590.615,123.0385
"23626","69248","2021",82,67,15,124487.6,1402.402,92.64634
"23627","69249","2021",32,27,5,339930.1,3445.406,99.09375
"23628","69250","2021",57,39,18,511438.3,4817.649,108.4035
"23629","69252","2021",4,4,0,295662.5,2423.5,129.25
"23630","69253","2021",4,4,0,507575,3363.25,140.75
"23631","69254","2021",11,11,0,188398.6,1996,94.90909
"23632","69255","2021",74,51,23,388695.1,3754.973,102.1351
"23633","69256","2021",486,88,398,183999,2810.568,66.3251
"23634","69257","2021",25,21,4,217526.4,2066.68,104.88
"23635","69258","2021",7,7,0,216511.4,1575.429,137.2857
"23636","69259","2021",620,108,512,200839.2,2881.766,70.35323
"23637","69260","2021",72,32,40,361071.1,3703.458,94.38889
"23638","69261","2021",2,2,0,97500,1394.5,77.5
"23639","69263","2021",20,17,3,153590.9,1746.15,91.6
"23640","69264","2021",761,125,636,175873.4,2386.608,74.34428
"23641","69265","2021",7,7,0,461847.1,3933.857,119.4286
"23642","69266","2021",2725,164,2561,245340.7,4016.481,62.64073
"23643","69267","2021",28,26,2,232407.8,2557.857,104.5714
"23644","69268","2021",55,29,26,473233.8,4328.891,110.4182
"23645","69269","2021",8,7,1,303300,3125.875,96.625
"23646","69270","2021",39,31,8,430047.3,3908.103,110.7692
"23647","69271","2021",131,79,52,408606.2,4487.443,90.93893
"23648","69272","2021",35,33,2,401281.9,3909.514,105.0571
"23649","69273","2021",124,74,50,298854.8,3521.403,84.15323
"23650","69275","2021",395,112,283,262412.2,3520.904,73.59494
"23651","69276","2021",122,58,64,240436.1,2913.279,82.94262
"23652","69277","2021",137,109,28,467531.1,4693.161,102.4307
"23653","69278","2021",67,36,31,345107.6,3630.761,97.0597
"23654","69279","2021",52,44,8,411729.4,4290.231,100.0962
"23655","69280","2021",19,17,2,349176.5,3210.895,118.4737
"23656","69281","2021",21,20,1,516716.2,4127.952,128.4762
"23657","69282","2021",451,238,213,302582,3778.024,80.40576
"23658","69283","2021",177,121,56,337055.6,3848.452,89.39548
"23659","69284","2021",29,24,5,411252.8,4183.207,100.3793
"23660","69285","2021",44,41,3,358272.3,3496.545,104.25
"23661","69286","2021",270,102,168,301519.7,3346.022,88.44444
"23662","69287","2021",80,63,17,400517.3,3729.65,108.925
"23663","69288","2021",67,52,15,364079,3904.343,97.08955
"23664","69289","2021",49,39,10,383630.7,3826.551,101
"23665","69290","2021",639,140,499,243509,3187.039,76.71518
"23666","69291","2021",77,50,27,298723.5,3443.87,87.42857
"23667","69292","2021",67,14,53,305661.5,3936.313,78.92537
"23668","69293","2021",35,19,16,441191.9,4652.514,95.65714
"23669","69294","2021",47,22,25,326437.6,3645.085,93.78723
"23670","69295","2021",22,14,8,384905.7,3964.545,97.95455
"23671","69296","2021",26,23,3,391969.3,3787.962,106.9615
"23672","69297","2021",74,62,12,375222.1,3790.257,102.2297
"23673","69298","2021",39,29,10,380394.1,3969.026,97.10256
"23674","69299","2021",19,18,1,343819.6,3384.789,110.0526
"23675","70001","2021",5,5,0,115610,1174,106.2
"23676","70002","2021",4,4,0,95250,861.75,110
"23677","70003","2021",1,1,0,53000,424,125
"23678","70004","2021",2,1,1,140950,1424.5,99
"23679","70005","2021",2,2,0,75500,706.5,97.5
"23680","70006","2021",18,17,1,112846.6,1187.333,104.2778
"23681","70007","2021",4,4,0,114250,1058.5,104.25
"23682","70010","2021",1,1,0,37000,1947,19
"23683","70011","2021",4,4,0,117725,1571.75,71.75
"23684","70012","2021",6,6,0,108675,967.8333,109.6667
"23685","70013","2021",3,3,0,107166.7,651,157
"23686","70014","2021",2,2,0,116000,1032,112.5
"23687","70016","2021",2,2,0,248500,1553,160
"23688","70017","2021",4,4,0,53500,751.25,77.75
"23689","70018","2021",6,6,0,133716.7,1318.833,103.8333
"23690","70020","2021",1,1,0,109900,1427,77
"23691","70021","2021",4,4,0,165850,1478,117.25
"23692","70022","2021",3,3,0,93000,846.6667,108.6667
"23693","70023","2021",3,3,0,59666.67,722,74.33333
"23694","70024","2021",3,3,0,111333.3,916,122
"23695","70025","2021",5,5,0,91000,740.6,118.6
"23696","70026","2021",23,21,2,91900,1072.174,86.91304
"23697","70027","2021",1,1,0,1e+05,741,135
"23698","70028","2021",1,1,0,63800,638,100
"23699","70029","2021",4,4,0,82650,761.5,114.75
"23700","70031","2021",9,9,0,121611.1,1145.778,113.2222
"23701","70035","2021",3,3,0,108238,1050,99
"23702","70036","2021",3,3,0,250300,1449,155
"23703","70037","2021",5,5,0,85640,1023.4,89.4
"23704","70038","2021",7,5,2,127824.3,1313,98.14286
"23705","70039","2021",8,8,0,150714.2,1625.875,99.25
"23706","70040","2021",2,2,0,123500,1280.5,96.5
"23707","70041","2021",2,2,0,88250,787.5,121
"23708","70042","2021",2,2,0,184150,1350,127.5
"23709","70043","2021",1,1,0,95000,597,159
"23710","70044","2021",4,4,0,164637.5,1149,137.25
"23711","70045","2021",5,4,1,192189.2,1399.4,140
"23712","70046","2021",4,4,0,103000,1086.75,90.5
"23713","70047","2021",7,7,0,126957.1,1613.286,79.42857
"23714","70048","2021",1,1,0,21000,700,30
"23715","70049","2021",1,1,0,32000,444,72
"23716","70051","2021",2,2,0,64050,503,127
"23717","70052","2021",2,2,0,99790,663.5,150
"23718","70053","2021",3,3,0,96633.33,1000.333,109.3333
"23719","70054","2021",1,1,0,257000,1224,210
"23720","70055","2021",9,9,0,106866.7,1126.333,99.33333
"23721","70056","2021",9,9,0,83372.22,797.5556,107.8889
"23722","70058","2021",12,11,1,101866.7,965.25,109.6667
"23723","70059","2021",1,1,0,157000,1725,91
"23724","70060","2021",4,4,0,215475,1460.75,147
"23725","70061","2021",2,2,0,105750,1233,86
"23726","70062","2021",2,2,0,130000,1069,121.5
"23727","70063","2021",3,3,0,141500,803.6667,194.6667
"23728","70066","2021",3,3,0,52666.67,675,79.33333
"23729","70069","2021",1,1,0,155100,1686,92
"23730","70070","2021",1,1,0,65000,474,137
"23731","70071","2021",3,3,0,237800,4825.333,61.33333
"23732","70074","2021",2,2,0,32500,761.5,51
"23733","70075","2021",2,2,0,203500,1567,127.5
"23734","70076","2021",3,3,0,194530,1404.333,140
"23735","70077","2021",3,3,0,126166.7,1133.333,112.6667
"23736","70078","2021",2,2,0,83500,860.5,101
"23737","70079","2021",3,3,0,85966.67,899.6667,104.6667
"23738","70080","2021",4,4,0,230875,2097.25,96.25
"23739","70081","2021",5,5,0,142740,1426.4,112
"23740","70083","2021",5,5,0,139560,1121.8,122.8
"23741","70084","2021",2,2,0,116266,948.5,126
"23742","70085","2021",8,7,1,119687.5,1442.875,89.25
"23743","70086","2021",3,3,0,84300,1055.667,75.33333
"23744","70087","2021",1,1,0,166500,1810,92
"23745","70088","2021",2,2,0,228700,1817.5,139
"23746","70090","2021",3,0,3,108123.3,1012.333,108.3333
"23747","70091","2021",1,1,0,76000,776,98
"23748","70092","2021",1,1,0,142800,1020,140
"23749","70093","2021",12,12,0,91933.33,904,100.6667
"23750","70094","2021",4,4,0,61625,556.5,106.75
"23751","70095","2021",3,3,0,147850,1678,91
"23752","70096","2021",4,4,0,161050,1664,99
"23753","70097","2021",3,3,0,175333.3,1346.333,130.3333
"23754","70098","2021",2,2,0,104810,964.5,113.5
"23755","70099","2021",1,1,0,38000,362,105
"23756","70100","2021",2,2,0,181350,1610,113.5
"23757","70101","2021",13,13,0,161196.2,1281.154,132.2308
"23758","70102","2021",1,1,0,241400,1857,130
"23759","70104","2021",5,5,0,94200,759.4,121.4
"23760","70105","2021",1,1,0,43000,3583,12
"23761","70106","2021",3,3,0,72086.67,736.6667,102
"23762","70107","2021",6,6,0,185000,1937.5,90.5
"23763","70109","2021",3,3,0,235860,2013.667,117
"23764","70111","2021",5,5,0,107130,846.2,130
"23765","70112","2021",2,2,0,53500,588.5,96
"23766","70113","2021",1,1,0,133150,1332,100
"23767","70114","2021",3,3,0,54000,829.6667,72.33333
"23768","70115","2021",1,1,0,95000,1000,95
"23769","70116","2021",5,3,2,149704,1309.4,102.6
"23770","70117","2021",16,15,1,223256.2,1812.812,127.4375
"23771","70118","2021",3,3,0,143516.7,1477,109.3333
"23772","70119","2021",6,6,0,174096.7,1244.5,143.5
"23773","70120","2021",38,38,0,142052.2,1482.184,101.9737
"23774","70121","2021",9,9,0,141688.9,1567.111,88.44444
"23775","70122","2021",28,28,0,86492.79,835.75,104.9286
"23776","70125","2021",1,1,0,54000,701,77
"23777","70126","2021",1,1,0,80000,444,180
"23778","70127","2021",2,2,0,55025,504,110
"23779","70128","2021",3,3,0,114250,997.3333,113.6667
"23780","70130","2021",4,4,0,165072.5,1409.25,117
"23781","70132","2021",12,12,0,138925,1234.917,114.6667
"23782","70133","2021",4,4,0,103225,1056.75,91.25
"23783","70134","2021",2,2,0,166300,949,180
"23784","70135","2021",1,1,0,235000,1516,155
"23785","70136","2021",8,7,1,176175,1529.75,116.75
"23786","70137","2021",5,5,0,102770,910.2,121.4
"23787","70138","2021",1,1,0,52500,367,143
"23788","70141","2021",1,1,0,152500,1220,125
"23789","70142","2021",4,4,0,175450,1393.25,124.25
"23790","70144","2021",1,1,0,275000,1273,216
"23791","70145","2021",2,2,0,287250,2586,121.5
"23792","70146","2021",6,6,0,91108.33,1020.833,88.33333
"23793","70147","2021",3,3,0,200433.3,1562.667,131
"23794","70148","2021",4,4,0,120500,1817.5,77
"23795","70149","2021",7,7,0,198100,1885.857,110
"23796","70150","2021",1,1,0,130000,650,200
"23797","70152","2021",4,4,0,125147.5,1228.75,109.75
"23798","70154","2021",3,3,0,205933.3,1837.333,111.3333
"23799","70155","2021",10,10,0,158687.5,1442.6,114.7
"23800","70156","2021",1,1,0,201232,1333,151
"23801","70157","2021",3,2,1,97966.67,940,101.6667
"23802","70158","2021",3,3,0,136500,1005,135
"23803","70159","2021",1,1,0,153000,1719,89
"23804","70160","2021",1,1,0,186000,2214,84
"23805","70162","2021",3,3,0,167273.3,1784.667,94
"23806","70163","2021",6,6,0,177081.7,1326.667,140.6667
"23807","70165","2021",5,5,0,111677.6,961,124
"23808","70166","2021",2,2,0,142000,1264.5,124.5
"23809","70167","2021",7,7,0,78750,946.4286,87.57143
"23810","70168","2021",9,9,0,106627.8,1149.444,91.22222
"23811","70169","2021",3,3,0,77333.33,739.3333,104
"23812","70170","2021",2,2,0,99000,743,135
"23813","70171","2021",6,6,0,101408.3,1151.833,100
"23814","70172","2021",1,1,0,78000,963,81
"23815","70176","2021",1,1,0,67000,376,178
"23816","70177","2021",7,7,0,123542.9,1254.429,94.42857
"23817","70178","2021",5,5,0,145210,1463.2,96.2
"23818","70179","2021",3,3,0,111066.7,1420,81
"23819","70180","2021",8,8,0,121068.8,1036,118.875
"23820","70183","2021",2,2,0,128250,1049,123
"23821","70184","2021",9,5,4,180573,1873.222,83.55556
"23822","70185","2021",2,2,0,166050,976.5,169
"23823","70186","2021",2,2,0,200250,1768,111
"23824","70187","2021",1,1,0,187000,1748,107
"23825","70189","2021",4,4,0,167575,1078,162.25
"23826","70190","2021",2,2,0,226000,1393,163.5
"23827","70193","2021",3,3,0,102600,785,114
"23828","70194","2021",2,2,0,98375,960.5,102
"23829","70196","2021",1,1,0,75000,556,135
"23830","70197","2021",9,9,0,113444.4,1170.222,100.7778
"23831","70198","2021",8,8,0,124206.2,1094.25,115
"23832","70199","2021",3,3,0,216133.3,1549,137
"23833","70200","2021",1,1,0,110600,1349,82
"23834","70201","2021",3,3,0,41166.67,610.6667,67
"23835","70202","2021",6,5,1,110225,886.6667,121.5
"23836","70203","2021",1,1,0,235000,3133,75
"23837","70204","2021",1,0,1,59477,772,77
"23838","70205","2021",3,3,0,170333.3,1288,128
"23839","70206","2021",6,6,0,127926.8,1573.5,78.5
"23840","70207","2021",38,31,7,145334.2,1472.526,96.42105
"23841","70208","2021",3,3,0,320933.3,1900,151.3333
"23842","70210","2021",2,2,0,245000,3267,75
"23843","70211","2021",2,1,1,64960,579,111.5
"23844","70213","2021",3,3,0,111666.7,1050.667,98.33333
"23845","70214","2021",1,1,0,193400,1248,155
"23846","70215","2021",1,1,0,168900,2111,80
"23847","70216","2021",4,4,0,193500,2579.5,152.75
"23848","70217","2021",4,4,0,110650,2136.75,61.25
"23849","70218","2021",3,3,0,234933.3,1383.333,174.6667
"23850","70219","2021",5,5,0,121140,1342.6,96
"23851","70220","2021",12,11,1,100279.2,922.4167,106.6667
"23852","70221","2021",6,6,0,128560,1220.333,106.6667
"23853","70222","2021",3,3,0,177175,1005,166.6667
"23854","70224","2021",4,3,1,156862.5,1467.5,121
"23855","70225","2021",2,2,0,110750,1059,104.5
"23856","70227","2021",8,8,0,130925,1346.25,99.375
"23857","70228","2021",14,10,4,86110.71,812.0714,107.6429
"23858","70229","2021",4,4,0,118750,1520.75,77.5
"23859","70230","2021",3,3,0,123333.3,976.6667,134
"23860","70232","2021",3,3,0,174233.3,1187.333,162.6667
"23861","70233","2021",3,3,0,153600,2521,61.66667
"23862","70234","2021",2,2,0,168250,1057,172
"23863","70235","2021",2,2,0,107925,920.5,116.5
"23864","70236","2021",1,1,0,194900,1585,123
"23865","70239","2021",2,2,0,90000,1022.5,88
"23866","70240","2021",13,13,0,99607.69,933.6154,104.5385
"23867","70242","2021",1,1,0,26800,335,80
"23868","70243","2021",2,2,0,128875,1449,94
"23869","70245","2021",40,38,2,92316.75,1006.3,93.95
"23870","70247","2021",6,6,0,63775.5,692.6667,93.66667
"23871","70248","2021",11,10,1,201480.3,2135.364,98.63636
"23872","70249","2021",1,1,0,44000,383,115
"23873","70250","2021",4,4,0,241500,1421,140.75
"23874","70251","2021",3,3,0,86000,693,119
"23875","70252","2021",3,3,0,85666.67,701.3333,120.3333
"23876","70253","2021",7,7,0,128278.6,1233,105.5714
"23877","70254","2021",3,3,0,113826.7,1363.667,91.33333
"23878","70255","2021",4,4,0,165375,1728,98.5
"23879","70256","2021",12,11,1,111677.5,1559.25,92.58333
"23880","70257","2021",8,8,0,123850,1095.375,123.5
"23881","70258","2021",18,16,2,119136.9,1301.833,97.27778
"23882","70259","2021",5,5,0,175060,1333.4,123.6
"23883","70260","2021",4,4,0,157200,1617,97.25
"23884","70261","2021",8,7,1,156162.5,1785.875,88.75
"23885","70262","2021",3,3,0,144500,1092.333,128.3333
"23886","70263","2021",3,3,0,78000,759,105
"23887","70264","2021",1,1,0,113000,1299,87
"23888","70267","2021",4,4,0,89512.5,1039.25,91
"23889","70268","2021",4,4,0,253725,1533.25,169.5
"23890","70271","2021",6,6,0,108433.3,1182.5,94.83333
"23891","70272","2021",4,4,0,61272.5,756.25,80.5
"23892","70273","2021",1,1,0,40000,500,80
"23893","70274","2021",1,1,0,60000,400,150
"23894","70275","2021",1,1,0,187330,2230,84
"23895","70276","2021",6,6,0,102333.3,1016,97.83333
"23896","70277","2021",2,2,0,72470,1111.5,77
"23897","70278","2021",2,2,0,262000,2084,131
"23898","70279","2021",58,25,33,83866.9,1007.966,83.72414
"23899","70280","2021",13,13,0,158692.3,1329.462,119.4615
"23900","70282","2021",14,11,3,109785.7,1087.143,113.9286
"23901","70283","2021",3,2,1,37166.67,681,67
"23902","70284","2021",6,6,0,97583.33,880.5,111.5
"23903","70285","2021",121,83,38,128777.3,1523.355,84.16529
"23904","70286","2021",3,1,2,185133.3,1463,122
"23905","70288","2021",1,1,0,65000,1354,48
"23906","70289","2021",1,1,0,147000,1455,101
"23907","70290","2021",2,2,0,65250,920,67.5
"23908","70291","2021",1,1,0,66000,825,80
"23909","70292","2021",29,25,4,84737.07,798.7241,104.5517
"23910","70293","2021",4,4,0,109225,956.75,117.5
"23911","70294","2021",10,10,0,166117,1534.1,110.9
"23912","70295","2021",4,4,0,251625,1712,154
"23913","70296","2021",3,3,0,146333.3,1632.333,89.66667
"23914","70297","2021",1,1,0,98000,516,190
"23915","70298","2021",1,1,0,109800,610,180
"23916","70299","2021",3,3,0,71666.67,648,94.33333
"23917","70303","2021",3,3,0,198033.3,2085.333,94
"23918","70304","2021",2,2,0,95050,856,111
"23919","70305","2021",1,1,0,75000,577,130
"23920","70306","2021",4,4,0,139325,1217.25,122
"23921","70307","2021",1,1,0,92500,746,124
"23922","70308","2021",4,4,0,92925,925.25,100.5
"23923","70309","2021",6,6,0,141116.7,1371.5,101.8333
"23924","70310","2021",95,62,33,106808,1230.642,87.50526
"23925","70311","2021",123,52,71,86819.34,983.2764,85.30081
"23926","70312","2021",14,14,0,163787.9,1799.286,91.07143
"23927","70313","2021",2,2,0,251000,1473.5,166
"23928","70314","2021",6,6,0,133536.3,1216.333,111.1667
"23929","70315","2021",4,4,0,106250,1153,92.5
"23930","70316","2021",1,1,0,215350,2393,90
"23931","70317","2021",1,1,0,1e+05,1370,73
"23932","70318","2021",11,11,0,148222.7,1375.182,105.7273
"23933","70319","2021",1,1,0,245850,2138,115
"23934","70321","2021",22,22,0,159812.7,1727.227,104.6364
"23935","70322","2021",3,3,0,315350,2688.667,139.3333
"23936","70323","2021",2,2,0,51920,525.5,101.5
"23937","70324","2021",9,9,0,122503.3,1187.778,110.6667
"23938","70326","2021",2,2,0,187300,1613.5,131
"23939","70327","2021",2,2,0,244170,1371.5,180
"23940","70328","2021",4,4,0,105042.5,1177.25,91
"23941","70331","2021",6,6,0,111910.8,1298.5,88.83333
"23942","70334","2021",11,8,3,182480.9,1883.727,108.8182
"23943","70336","2021",3,3,0,135933.3,1191.667,111
"23944","70338","2021",4,4,0,99300,966.25,104
"23945","70339","2021",20,19,1,106694,1221.75,95.8
"23946","70340","2021",6,6,0,103583.3,945.3333,100.6667
"23947","70341","2021",2,2,0,44000,368,120
"23948","70342","2021",1,1,0,25000,333,75
"23949","70343","2021",4,4,0,113050,1185,94.75
"23950","70344","2021",4,4,0,117400,910.75,127
"23951","70347","2021",3,3,0,166416.7,1698,100.6667
"23952","70348","2021",6,6,0,169016.7,1335.333,127
"23953","70349","2021",3,3,0,133833.3,874,160.3333
"23954","70350","2021",4,4,0,111125,1045.5,109
"23955","70351","2021",2,2,0,155318,1321.5,124.5
"23956","70352","2021",1,1,0,480000,3664,131
"23957","70353","2021",7,7,0,119778.6,1461,83.85714
"23958","70355","2021",3,3,0,128666.7,1395,88.33333
"23959","70357","2021",8,7,1,138874,1937.375,76.25
"23960","70359","2021",1,1,0,67000,354,189
"23961","70360","2021",1,1,0,80000,1000,80
"23962","70362","2021",1,1,0,40000,444,90
"23963","70363","2021",11,6,5,116133.6,1171.455,106.0909
"23964","70364","2021",1,1,0,75000,833,90
"23965","70366","2021",3,3,0,86333.33,1034.333,84.33333
"23966","70367","2021",2,2,0,104450,634.5,168.5
"23967","70368","2021",2,2,0,104000,818,123.5
"23968","70369","2021",1,1,0,99000,1650,60
"23969","70371","2021",1,1,0,29500,484,61
"23970","70372","2021",1,1,0,33600,634,53
"23971","70373","2021",3,3,0,69058.33,511.3333,131
"23972","70374","2021",1,1,0,1e+05,1042,96
"23973","70376","2021",7,7,0,177510,1463.857,123.5714
"23974","70378","2021",33,30,3,142534.3,1566.97,93.42424
"23975","70381","2021",3,3,0,191266.7,1602.667,121.3333
"23976","70383","2021",1,1,0,212000,1413,150
"23977","70385","2021",2,2,0,125000,1439.5,85.5
"23978","70386","2021",1,1,0,112000,862,130
"23979","70387","2021",7,7,0,119268.6,1285.571,95.85714
"23980","70388","2021",31,30,1,147313.2,1398.452,106.3548
"23981","70390","2021",9,9,0,117819.4,1079.333,116
"23982","70392","2021",2,2,0,122075,810.5,159
"23983","70393","2021",5,5,0,229040,1987.8,119
"23984","70397","2021",2,2,0,166500,1918.5,88
"23985","70399","2021",4,4,0,83275,519,155.5
"23986","70401","2021",3,3,0,123666.7,960.3333,139.3333
"23987","70402","2021",8,7,1,114212.5,1035.25,118.25
"23988","70403","2021",1,1,0,67000,1015,66
"23989","70404","2021",7,7,0,99864.29,786.5714,116.2857
"23990","70406","2021",2,2,0,84890,901,100
"23991","70408","2021",21,20,1,164670.5,1654.857,114.0476
"23992","70409","2021",2,2,0,35000,401.5,85.5
"23993","70410","2021",4,3,1,342405,3057.75,109.75
"23994","70411","2021",1,1,0,165000,1130,146
"23995","70412","2021",1,1,0,45000,592,76
"23996","70413","2021",29,27,2,128519.7,1338.207,96.89655
"23997","70414","2021",12,11,1,123625,939.8333,127.9167
"23998","70415","2021",5,5,0,70140,647.2,109.4
"23999","70416","2021",2,2,0,143925,1027.5,120
"24000","70417","2021",3,3,0,104300,1007.333,105
"24001","70418","2021",5,5,0,116460,969.6,132.2
"24002","70419","2021",4,4,0,70837.5,713.25,98
"24003","70420","2021",1,1,0,52500,350,150
"24004","70421","2021",43,39,4,122817.4,1277.163,98.93023
"24005","70425","2021",1,1,0,273000,8029,34
"24006","70426","2021",2,2,0,108500,1084,96
"24007","70427","2021",5,5,0,77620,741.8,100.8
"24008","70428","2021",16,15,1,157647.5,1546.562,105.625
"24009","70429","2021",5,5,0,155960,1397.4,110.4
"24010","70430","2021",1,1,0,46000,885,52
"24011","70431","2021",2,2,0,187500,1634.5,114
"24012","70432","2021",7,7,0,192642.9,2755.143,103.2857
"24013","70433","2021",19,18,1,153481.1,1387.368,113.2632
"24014","70435","2021",17,16,1,101290.9,1063.059,96.11765
"24015","70436","2021",2,2,0,62250,557,111.5
"24016","70438","2021",1,1,0,115000,669,172
"24017","70439","2021",8,8,0,90781.25,995.5,93.625
"24018","70441","2021",5,5,0,177610,1517.8,118.2
"24019","70442","2021",2,2,0,107215,1113.5,95.5
"24020","70443","2021",1,1,0,148000,987,150
"24021","70444","2021",1,1,0,182500,1193,153
"24022","70445","2021",1,1,0,105000,1061,99
"24023","70446","2021",8,8,0,131306.2,1211.125,103.375
"24024","70447","2021",20,18,2,207579,1768.95,120.25
"24025","70448","2021",3,3,0,67513.33,621.3333,100.6667
"24026","70449","2021",2,2,0,201000,1230.5,141
"24027","70451","2021",31,27,4,107800,1069.323,106.871
"24028","70452","2021",6,6,0,195333.3,1683.667,115.1667
"24029","70453","2021",4,4,0,197625,2442.25,82.25
"24030","70454","2021",3,3,0,125950,948.3333,145.6667
"24031","70455","2021",18,17,1,122485,1316.056,94.94444
"24032","70456","2021",1,1,0,1e+05,1000,100
"24033","70457","2021",2,2,0,98500,717.5,134.5
"24034","70459","2021",10,10,0,121815,1228.5,98.9
"24035","70460","2021",7,7,0,149946.4,2701,86.57143
"24036","70461","2021",2,2,0,129000,1256,101
"24037","70464","2021",19,19,0,139971.1,1352.947,107.2105
"24038","70466","2021",2,2,0,139500,794.5,189
"24039","70467","2021",16,14,2,87070,947.125,89.625
"24040","70469","2021",1,1,0,165000,1650,100
"24041","70470","2021",1,1,0,45000,484,93
"24042","70472","2021",6,6,0,100508.3,848.3333,119.3333
"24043","70473","2021",17,13,4,94385.29,988.4118,99.70588
"24044","70474","2021",2,2,0,187000,1199,155.5
"24045","70476","2021",3,3,0,83666.67,601,135.3333
"24046","70477","2021",7,7,0,97167.71,1308,82.28571
"24047","70478","2021",4,3,1,174625,1414,127
"24048","70479","2021",1,1,0,205000,1708,120
"24049","70480","2021",3,3,0,90166.67,713,125
"24050","70481","2021",2,2,0,89000,870,103.5
"24051","70482","2021",16,16,0,112288.1,1152.5,95
"24052","70483","2021",3,3,0,185266.7,999.6667,194.3333
"24053","70484","2021",4,4,0,151125,1306,119
"24054","70485","2021",5,5,0,74706.4,737.8,108.6
"24055","70487","2021",2,2,0,102150,1218.5,86
"24056","70488","2021",2,2,0,57000,408,143.5
"24057","70489","2021",10,10,0,113107,2550.3,52
"24058","70490","2021",2,2,0,132500,1819.5,69.5
"24059","70491","2021",9,9,0,96361.11,842.8889,124.1111
"24060","70492","2021",11,11,0,102849.1,918.0909,110.2727
"24061","70493","2021",1,1,0,230880,2286,101
"24062","70494","2021",3,3,0,113000,935,128.3333
"24063","70496","2021",2,2,0,62800,566.5,97
"24064","70498","2021",14,14,0,139702.1,1635.643,94.85714
"24065","70499","2021",1,1,0,105000,905,116
"24066","70501","2021",5,5,0,127486,1219.4,111.6
"24067","70502","2021",1,1,0,98100,908,108
"24068","70503","2021",4,4,0,125525,1020.25,133
"24069","70504","2021",10,10,0,127075,1217.5,109.1
"24070","70505","2021",3,3,0,115500,1061,112
"24071","70506","2021",1,1,0,137000,1903,72
"24072","70507","2021",3,3,0,204850,1599,129.3333
"24073","70509","2021",1,1,0,215000,1114,193
"24074","70511","2021",6,6,0,118333.3,937.5,117.3333
"24075","70512","2021",3,3,0,166100,1273,120.3333
"24076","70513","2021",25,17,8,127040.2,1346.64,95.16
"24077","70514","2021",3,3,0,108800,1052,102
"24078","70515","2021",1,1,0,35000,412,85
"24079","70516","2021",5,5,0,148072,1067.2,136.8
"24080","70517","2021",2,2,0,382500,1978,190
"24081","70518","2021",2,2,0,121265,1097.5,106
"24082","70520","2021",1,1,0,50000,625,80
"24083","70521","2021",2,2,0,135850,1397,96.5
"24084","70522","2021",2,2,0,156100,1328,118
"24085","70523","2021",1,1,0,80000,816,98
"24086","70525","2021",5,5,0,83132,913.4,95.6
"24087","70526","2021",12,12,0,95225,866.3333,112.6667
"24088","70527","2021",2,2,0,192470,1327.5,145
"24089","70528","2021",2,2,0,164300,1601.5,104.5
"24090","70529","2021",4,4,0,121215,1306.5,97.75
"24091","70530","2021",2,2,0,159750,1091,148.5
"24092","70532","2021",4,4,0,179150,1460.75,125.5
"24093","70533","2021",3,3,0,150000,1158.667,130
"24094","70534","2021",1,1,0,90000,732,123
"24095","70535","2021",1,1,0,109900,999,110
"24096","70536","2021",3,3,0,82666.67,700,121.6667
"24097","70537","2021",4,4,0,107675,1142,95.5
"24098","70538","2021",2,2,0,45450,591.5,77.5
"24099","70539","2021",4,4,0,100937.5,780.75,129
"24100","70540","2021",1,1,0,383300,1291,297
"24101","70541","2021",4,4,0,105325,1342.75,78.75
"24102","70542","2021",2,2,0,141990,1174.5,122
"24103","70544","2021",3,3,0,82333.33,1074,74.33333
"24104","70545","2021",1,1,0,85320,416,205
"24105","70546","2021",1,1,0,164500,1015,162
"24106","70547","2021",1,1,0,95000,531,179
"24107","70548","2021",4,4,0,98000,901,108.5
"24108","70550","2021",227,52,175,100092.5,1278.934,77.51982
"24109","70552","2021",2,2,0,127500,1237,103.5
"24110","70554","2021",4,4,0,76800,663.5,122
"24111","70555","2021",3,3,0,161523.3,1372,125.3333
"24112","70557","2021",1,1,0,113300,1827,62
"24113","70559","2021",1,1,0,148000,1370,108
"24114","70560","2021",2,2,0,59500,661.5,97.5
"24115","70561","2021",18,15,3,84086.67,984.6667,85.33333
"24116","70562","2021",1,1,0,26600,543,49
"24117","70563","2021",9,9,0,132850,1225.667,115.5556
"24118","70564","2021",2,2,0,136500,1098,111.5
"24119","70566","2021",2,2,0,131000,677.5,169.5
"24120","70567","2021",1,1,0,165000,1310,126
"24121","70568","2021",3,3,0,92800,867.3333,97.33333
"24122","70572","2021",4,4,0,113550,775.75,133.75
"24123","70573","2021",1,1,0,60000,1500,40
"24124","70574","2021",2,2,0,73750,592,115
"24125","70575","2021",8,5,3,147302.5,1736.375,82.5
"24126","70576","2021",1,1,0,43000,538,80
"24127","70577","2021",6,6,0,154666.7,1586.833,104.5
"24128","70578","2021",2,2,0,201642.5,1807,112.5
"24129","70579","2021",4,4,0,235471.8,1807,135.25
"24130","70580","2021",2,2,0,104500,1117,93.5
"24131","70581","2021",6,6,0,150416.7,1348.333,118.6667
"24132","70582","2021",2,2,0,92885,743,122.5
"24133","71001","2021",18,18,0,161112.2,1413.889,112.7778
"24134","71002","2021",17,17,0,170367.6,1466.882,121.2941
"24135","71003","2021",9,9,0,169797.2,1421.111,116.6667
"24136","71004","2021",14,13,1,269041.4,1969.214,136.9286
"24137","71005","2021",3,3,0,211000,1737.667,114.6667
"24138","71006","2021",3,3,0,151016.7,1365.333,107
"24139","71007","2021",5,5,0,235666,2177.4,107.6
"24140","71008","2021",3,3,0,95380,1145,76
"24141","71009","2021",23,23,0,70019.13,1032.435,70.13043
"24142","71010","2021",16,16,0,175056.6,1605.188,98.4375
"24143","71011","2021",9,9,0,184322.2,1624,116.7778
"24144","71012","2021",5,5,0,114280,1014.8,112.2
"24145","71013","2021",2,2,0,95500,1276,71.5
"24146","71014","2021",193,99,94,103728.6,1143.523,87.48187
"24147","71015","2021",11,10,1,118200,1174.818,99.27273
"24148","71016","2021",11,11,0,178587.3,2136.364,94.18182
"24149","71017","2021",3,3,0,89603.33,964.3333,94.66667
"24150","71018","2021",17,17,0,128447.9,1214.059,106.7059
"24151","71019","2021",1,1,0,30000,612,49
"24152","71020","2021",4,4,0,71205,927,78.25
"24153","71021","2021",6,6,0,196841.7,1774.667,114.3333
"24154","71022","2021",10,10,0,211025,1720.2,120.1
"24155","71023","2021",13,13,0,207635.4,1513.692,132.9231
"24156","71024","2021",3,3,0,95111,779.6667,115
"24157","71025","2021",9,9,0,159144.4,1986.667,77.22222
"24158","71026","2021",4,3,1,144400,1615,88.75
"24159","71027","2021",17,17,0,161402.9,1735.294,94.17647
"24160","71028","2021",2,2,0,161710,1869,87
"24161","71029","2021",10,10,0,130546,1134.2,111
"24162","71030","2021",2,1,1,106250,1422.5,70
"24163","71032","2021",15,15,0,205004,2114.4,93.6
"24164","71033","2021",8,8,0,178452.5,2132,91.25
"24165","71034","2021",4,4,0,181500,1559.25,126.5
"24166","71035","2021",3,3,0,113533.3,1562,72
"24167","71036","2021",4,4,0,55000,1366,40.5
"24168","71037","2021",2,2,0,116000,2301,51
"24169","71038","2021",2,2,0,162687.5,1414.5,122
"24170","71039","2021",2,2,0,147500,2034,73
"24171","71040","2021",59,56,3,100264.7,1208.085,87.52542
"24172","71041","2021",4,4,0,191241.8,2006.75,105.25
"24173","71042","2021",4,4,0,173250,1573.25,111.75
"24174","71044","2021",7,7,0,135285.7,1400.286,100
"24175","71045","2021",2,2,0,125000,1371,92
"24176","71046","2021",3,3,0,45941.67,1152.333,40.33333
"24177","71047","2021",69,66,3,101588.2,1229.826,91.33333
"24178","71048","2021",1,1,0,148480,1388,107
"24179","71050","2021",6,6,0,185266.7,1952.667,89.16667
"24180","71051","2021",1,1,0,50000,1190,42
"24181","71052","2021",7,7,0,167328.6,1132.429,144.5714
"24182","71054","2021",13,13,0,81353.85,1216.923,66.53846
"24183","71056","2021",40,37,3,126748.8,1332.675,97.625
"24184","71057","2021",3,3,0,146666.7,1188,143
"24185","71058","2021",3,3,0,337333.3,1662,174
"24186","71059","2021",41,38,3,129757,1289.366,99.31707
"24187","71060","2021",4,4,0,140800,806.25,158.25
"24188","71061","2021",7,7,0,135710,1277.571,104.7143
"24189","71062","2021",7,7,0,155000,1432.857,100.8571
"24190","71063","2021",22,21,1,137638,1475.909,97.31818
"24191","71064","2021",18,18,0,197522.2,1838.611,104.6667
"24192","71065","2021",4,4,0,150825,1347.75,106
"24193","71066","2021",2,2,0,138500,1276.5,105.5
"24194","71067","2021",6,6,0,89645.83,1470.667,63.66667
"24195","71068","2021",1,1,0,185000,925,200
"24196","71069","2021",5,1,4,194218,2047,95.6
"24197","71070","2021",32,29,3,177303.3,1740.875,103.0625
"24198","71071","2021",6,4,2,73666.67,825.5,89.16667
"24199","71072","2021",2,2,0,207500,2138.5,95.5
"24200","71073","2021",62,47,15,145923.1,1610.742,93.64516
"24201","71074","2021",5,5,0,282098,1984.6,140.2
"24202","71075","2021",11,10,1,132144.1,1188.182,111.9091
"24203","71076","2021",861,122,739,101141.5,1372.286,72.05691
"24204","71077","2021",11,10,1,131594.5,1151.909,111.5455
"24205","71078","2021",2,2,0,154000,1423,99
"24206","71079","2021",2,2,0,122500,1580.5,81.5
"24207","71080","2021",5,5,0,169400,1766.6,92.6
"24208","71081","2021",37,28,9,177539.5,1640.649,104.8378
"24209","71082","2021",2,2,0,220000,1462,150
"24210","71084","2021",7,7,0,218942.9,1808.714,126.7143
"24211","71085","2021",4,4,0,99750,898.25,107.5
"24212","71086","2021",3,3,0,122166.7,1823.333,71.66667
"24213","71087","2021",4,4,0,240650,2394,122.75
"24214","71088","2021",4,4,0,65912.5,1005.25,67.5
"24215","71089","2021",4,4,0,208500,2394.75,93.25
"24216","71090","2021",57,47,10,235802.6,2167.93,112.1228
"24217","71092","2021",12,12,0,157662.5,1720.5,97.91667
"24218","71093","2021",15,15,0,157400,1378.533,110.8
"24219","71094","2021",4,4,0,196375,1697.5,111.75
"24220","71095","2021",11,11,0,90554.55,1150.545,82.18182
"24221","71096","2021",3,3,0,1e+05,1611,67
"24222","71097","2021",17,17,0,156828.9,1659.529,93.58824
"24223","71098","2021",8,8,0,96210,1235.125,75.125
"24224","71099","2021",1,1,0,175000,2188,80
"24225","71100","2021",3,3,0,125833.3,1735,79.33333
"24226","71101","2021",11,11,0,124640.9,1332.455,89.81818
"24227","71102","2021",11,11,0,221723.6,1966.273,114.3636
"24228","71103","2021",1,1,0,108000,1200,90
"24229","71104","2021",2,2,0,69500,515.5,130
"24230","71105","2021",157,66,91,180133.2,2154.529,84.57962
"24231","71106","2021",38,33,5,111853.6,1311.921,89.18421
"24232","71107","2021",3,3,0,108333.3,1445,65.66667
"24233","71108","2021",4,4,0,215812.5,2656.75,80.25
"24234","71109","2021",9,9,0,212193.3,1750.444,123.7778
"24235","71110","2021",7,6,1,150285.7,1399.857,111.4286
"24236","71111","2021",3,3,0,91666.67,921.3333,100.3333
"24237","71112","2021",2,2,0,352000,2222.5,160.5
"24238","71113","2021",2,2,0,63500,620,99.5
"24239","71115","2021",2,2,0,208875,1497.5,137.5
"24240","71116","2021",1,1,0,2e+05,1538,130
"24241","71117","2021",13,13,0,188557.7,1743.846,106.9231
"24242","71118","2021",123,93,30,148030.7,1884.138,81.49593
"24243","71119","2021",14,13,1,245263.6,1734.5,140
"24244","71120","2021",65,59,6,109505.4,1342.769,84.15385
"24245","71121","2021",7,7,0,135300,1225.571,110.7143
"24246","71122","2021",9,9,0,125444.4,1781.889,72.44444
"24247","71123","2021",8,8,0,101587.5,1095.875,90
"24248","71124","2021",3,3,0,90666.67,1158,80.33333
"24249","71125","2021",2,2,0,76250,1426.5,54
"24250","71126","2021",6,6,0,294136.7,3945.5,96.66667
"24251","71127","2021",1,1,0,145020,2072,70
"24252","71129","2021",8,8,0,94206.25,1069.75,90
"24253","71130","2021",5,5,0,113443,955.2,105.6
"24254","71131","2021",13,13,0,130539.2,1382.231,97.15385
"24255","71132","2021",42,36,6,80690.81,996.0714,81.07143
"24256","71133","2021",25,23,2,111940,1230.32,93.92
"24257","71134","2021",13,13,0,99763.08,1096.308,95.23077
"24258","71135","2021",9,9,0,180555.6,1544,115.8889
"24259","71136","2021",7,7,0,138140,1530.571,89.28571
"24260","71137","2021",45,41,4,233740.6,2166.511,106.9333
"24261","71139","2021",4,4,0,112075,1233.5,102.25
"24262","71140","2021",1,1,0,55500,793,70
"24263","71141","2021",3,3,0,73500,824.3333,88.33333
"24264","71142","2021",4,4,0,181375,2213.25,82
"24265","71143","2021",8,8,0,100600,1048.375,102.75
"24266","71144","2021",2,2,0,117500,1274.5,94
"24267","71145","2021",8,8,0,138450,1608.125,87.875
"24268","71146","2021",4,4,0,135730,1370.75,90
"24269","71147","2021",6,6,0,76000,1029.333,72.83333
"24270","71148","2021",23,23,0,117482.6,1218.522,100.9565
"24271","71149","2021",25,24,1,138711,1337.44,101.96
"24272","71150","2021",45,41,4,214051,2132.267,102.7111
"24273","71151","2021",4,4,0,132912.5,1230,92.25
"24274","71152","2021",2,2,0,104733,1136.5,91.5
"24275","71153","2021",248,140,108,92992.46,1190.613,80.75403
"24276","71154","2021",19,18,1,189470.5,1772.158,108.2105
"24277","71155","2021",11,11,0,75936.36,912.0909,82.09091
"24278","71156","2021",6,6,0,152083.3,1094.667,112.6667
"24279","71157","2021",31,28,3,142811.3,1295.903,102.2903
"24280","71158","2021",32,27,5,118795.2,1341.906,90.28125
"24281","71159","2021",8,8,0,138218.8,1256.5,98.875
"24282","71160","2021",5,5,0,140018.4,1172.4,115.2
"24283","71161","2021",3,3,0,194000,1282.667,139.3333
"24284","71162","2021",20,20,0,111317.1,1246.2,92.75
"24285","71163","2021",2,2,0,116725,1825.5,84
"24286","71164","2021",1,1,0,69000,920,75
"24287","71165","2021",17,17,0,88666.47,979.9412,88.64706
"24288","71166","2021",2,2,0,107500,1105,102
"24289","71167","2021",7,7,0,153671.4,1639.429,90.42857
"24290","71168","2021",4,4,0,110812.5,1246.5,93.25
"24291","71169","2021",3,3,0,362800,2931.333,128.6667
"24292","71170","2021",20,18,2,232399.4,1987.3,120.6
"24293","71171","2021",3,3,0,123833.3,1360.667,88
"24294","71172","2021",1,1,0,1e+05,800,125
"24295","71173","2021",8,8,0,161625,1652,104.875
"24296","71174","2021",4,4,0,160937.5,1728,102.25
"24297","71175","2021",9,9,0,134888.9,1288.111,100.7778
"24298","71176","2021",118,71,47,87534.78,1034.212,84.05932
"24299","71177","2021",12,12,0,143278.3,1320.25,118.5
"24300","71178","2021",17,17,0,150355.9,1294.941,116.7059
"24301","71179","2021",1,1,0,115000,1597,72
"24302","71182","2021",10,10,0,335495.7,2487.9,134.3
"24303","71183","2021",3,3,0,141333.3,2132,52
"24304","71184","2021",4,4,0,71762.5,856.75,80.75
"24305","71185","2021",4,4,0,156875,1255.25,115
"24306","71186","2021",4,4,0,104060,1301.75,74.25
"24307","71187","2021",29,27,2,136584.8,1411.379,101.6552
"24308","71188","2021",1,1,0,39500,1234,32
"24309","71189","2021",19,17,2,171872.4,1596.579,107.6842
"24310","71190","2021",33,33,0,92027.12,1056.061,87.39394
"24311","71191","2021",6,6,0,166080.8,1329.5,121.6667
"24312","71192","2021",27,26,1,117980.5,1202.556,99.96296
"24313","71193","2021",7,7,0,166472.9,1412.571,103.5714
"24314","71194","2021",8,8,0,242027.5,2209.75,111.875
"24315","71195","2021",1,1,0,255150,1585,161
"24316","71196","2021",16,16,0,152478.1,1571.875,95.1875
"24317","71198","2021",12,12,0,114708.7,1233.167,94
"24318","71199","2021",4,4,0,84500,1102.5,69.5
"24319","71200","2021",8,8,0,188062.5,1280.875,138.5
"24320","71201","2021",4,4,0,226875,2352.5,109.75
"24321","71202","2021",24,22,2,218143.8,2256.917,94.58333
"24322","71204","2021",14,14,0,202663.6,1815.571,112.7857
"24323","71205","2021",16,16,0,137894.9,1270.125,99.0625
"24324","71206","2021",7,7,0,137214.3,1305.714,111.7143
"24325","71207","2021",10,10,0,88400,839.3,107.9
"24326","71208","2021",5,5,0,126200,1200.2,110.6
"24327","71209","2021",23,23,0,162658.3,1444.565,118.9565
"24328","71210","2021",3,3,0,192550,1916.333,97.66667
"24329","71212","2021",21,19,2,102541.3,1127.19,92.52381
"24330","71213","2021",7,7,0,113285.7,1237.429,99.57143
"24331","71214","2021",15,15,0,90769,1234.067,71.73333
"24332","71215","2021",21,21,0,175768.3,1606.571,108.619
"24333","71216","2021",4,4,0,168875,1391,125.5
"24334","71218","2021",9,9,0,134363.3,1349.111,96.66667
"24335","71219","2021",4,4,0,141237.5,1464.75,105.5
"24336","71220","2021",10,10,0,81780,915.3,85.7
"24337","71221","2021",64,58,6,230661.2,2028.531,115.6094
"24338","71222","2021",12,12,0,152950,1371.583,111.1667
"24339","71223","2021",11,11,0,112356.5,1357.636,83.81818
"24340","71224","2021",2,2,0,125500,1665,88
"24341","71225","2021",8,8,0,247067.5,1880.25,129.25
"24342","71226","2021",1,1,0,138000,1533,90
"24343","71227","2021",8,8,0,80375,825.25,87.5
"24344","71228","2021",3,3,0,161267,1206,143
"24345","71229","2021",6,6,0,90958.33,1063,79.5
"24346","71230","2021",81,71,10,93009.2,1016.136,91.5679
"24347","71231","2021",8,8,0,96616.62,908.375,111.75
"24348","71232","2021",2,2,0,213750,1664,122
"24349","71233","2021",2,2,0,95000,1195.5,73.5
"24350","71234","2021",14,14,0,126142.9,1213.786,102.5714
"24351","71235","2021",20,19,1,238622.2,2379.8,100.5
"24352","71236","2021",7,7,0,145485.7,1317.571,111.5714
"24353","71237","2021",6,6,0,71500,711.5,96.5
"24354","71238","2021",23,23,0,145814.3,1141.826,123.4783
"24355","71239","2021",20,20,0,78511,863.25,88.35
"24356","71240","2021",4,4,0,151325,1564.25,86.75
"24357","71241","2021",5,5,0,208540,1622,124.8
"24358","71242","2021",11,11,0,156346.4,1423.818,104.7273
"24359","71243","2021",8,8,0,105050,1160.375,94.625
"24360","71244","2021",10,10,0,121695,1196,108.4
"24361","71245","2021",11,11,0,151507.5,1348.909,103.9091
"24362","71246","2021",9,9,0,140111.1,1536.222,99.88889
"24363","71247","2021",4,4,0,84000,1260.5,62.75
"24364","71248","2021",10,10,0,133510,1282,100.2
"24365","71249","2021",19,19,0,194744.9,1804.158,119
"24366","71250","2021",8,8,0,260651.4,2057.875,122.25
"24367","71251","2021",6,6,0,166511.7,1440.333,93.33333
"24368","71252","2021",7,7,0,221842.9,2286.857,116.4286
"24369","71253","2021",10,10,0,190660,2109.9,92.7
"24370","71254","2021",7,7,0,77428.57,787.8571,94.42857
"24371","71255","2021",1,1,0,38000,760,50
"24372","71256","2021",13,13,0,144003.1,1449.846,101.1538
"24373","71257","2021",10,10,0,223735,1699,136.3
"24374","71258","2021",4,4,0,207032.5,1809.75,104.25
"24375","71259","2021",4,4,0,118837.5,898.75,134.5
"24376","71261","2021",13,13,0,177996.2,1452.462,114.6154
"24377","71262","2021",5,5,0,84680,1138.8,79.6
"24378","71263","2021",99,74,25,134011.1,1415.263,95.24242
"24379","71264","2021",3,3,0,209223.3,2536,91.33333
"24380","71266","2021",12,12,0,111700,931,117.3333
"24381","71267","2021",12,12,0,233636.7,1704.5,139.9167
"24382","71268","2021",4,4,0,107350,1609.5,67.5
"24383","71269","2021",46,26,20,130043.9,1659.609,78.58696
"24384","71270","2021",593,154,439,134642.5,1656.292,80.26138
"24385","71271","2021",5,5,0,139682,1195,134.2
"24386","71272","2021",5,5,0,145360,1377.6,94.6
"24387","71273","2021",3,3,0,79999.67,664.6667,119.6667
"24388","71274","2021",4,4,0,127660,1368.75,101.25
"24389","71275","2021",21,12,9,95064.76,976.6667,90.33333
"24390","71276","2021",3,3,0,129883.3,1144,119.6667
"24391","71277","2021",5,5,0,151180,1338.2,113.2
"24392","71279","2021",16,16,0,135922.5,1425.188,94.75
"24393","71280","2021",2,2,0,180000,876.5,207
"24394","71281","2021",4,4,0,62750,839,72.5
"24395","71282","2021",19,18,1,128320.5,1556.474,87.42105
"24396","71283","2021",6,6,0,222945,1467,143.3333
"24397","71284","2021",5,5,0,114660,2124,54.8
"24398","71285","2021",6,6,0,101166.7,970.6667,117.1667
"24399","71286","2021",6,6,0,215400,1498,138.3333
"24400","71287","2021",4,4,0,130654.2,1374.5,91.5
"24401","71289","2021",9,9,0,104633.3,1177.333,88
"24402","71290","2021",1,1,0,235000,2527,93
"24403","71291","2021",24,24,0,135336.2,1357.833,100.7083
"24404","71292","2021",28,28,0,244228.4,2102,112
"24405","71293","2021",13,13,0,143623.1,1373.154,104.8462
"24406","71294","2021",21,19,2,297776.4,2396.333,119.1429
"24407","71295","2021",29,29,0,143201.7,1307.172,112.8276
"24408","71296","2021",18,18,0,215472.8,1866.222,118.4444
"24409","71297","2021",12,11,1,99058.33,1037,99.5
"24410","71299","2021",4,4,0,275550,2354,118
"24411","71300","2021",5,4,1,114000,1097.2,102.8
"24412","71301","2021",1,1,0,380000,3455,110
"24413","71302","2021",5,5,0,156030,1699.8,99.6
"24414","71303","2021",10,10,0,153774.4,1662.1,95.1
"24415","71305","2021",12,12,0,192214.2,1934,121.6667
"24416","71306","2021",211,148,63,86565.48,1029.867,82.77725
"24417","71307","2021",3,3,0,172666.7,974,146
"24418","71308","2021",1,1,0,218000,1615,135
"24419","71309","2021",27,23,4,109473.4,1328.296,81.96296
"24420","71310","2021",41,37,4,116661.5,1336.22,85.39024
"24421","71311","2021",6,6,0,155908.3,1113.5,141
"24422","71312","2021",6,6,0,115253.3,1243.167,89.66667
"24423","71313","2021",8,8,0,159457.5,1379.125,111.875
"24424","71314","2021",4,4,0,146500,1625.25,92.5
"24425","71315","2021",2,2,0,112500,1491.5,73.5
"24426","71316","2021",4,4,0,137950,1439,106
"24427","71317","2021",6,6,0,101733.2,941.8333,113.5
"24428","71318","2021",15,15,0,137202,1550.667,87.4
"24429","71319","2021",18,18,0,131463.6,1316.278,98.66667
"24430","71320","2021",7,7,0,233650,1638,141.5714
"24431","71321","2021",1,1,0,60000,984,61
"24432","71322","2021",1,1,0,124600,1175,106
"24433","71323","2021",1,1,0,67500,1089,62
"24434","71324","2021",13,13,0,148903.8,1652.923,90.46154
"24435","71325","2021",17,17,0,120008.2,1141.706,101.2941
"24436","71326","2021",10,10,0,114392,1678.4,69.7
"24437","71327","2021",4,4,0,111250,1325,89.25
"24438","71328","2021",13,13,0,134586.9,1464.846,104.3077
"24439","71329","2021",11,11,0,144190.5,1373.636,92.63636
"24440","71330","2021",15,15,0,89572.67,889.7333,110.4
"24441","71331","2021",2,2,0,126000,1210,104.5
"24442","71332","2021",5,5,0,137800,1667.8,85.8
"24443","71333","2021",20,20,0,223065.5,1938.4,116.45
"24444","71334","2021",5,5,0,116340,1276.8,90.6
"24445","71335","2021",3,3,0,180276.7,1808,93.33333
"24446","71336","2021",38,37,1,152585.3,1562.421,102.9211
"24447","71337","2021",6,6,0,170016.7,1236.5,127.6667
"24448","71338","2021",3,3,0,64000,687.6667,111
"24449","71339","2021",10,10,0,127156,1199.1,99
"24450","71340","2021",19,18,1,99100.26,1071,102.6842
"24451","71341","2021",4,4,0,123250,1334.5,97.25
"24452","71342","2021",163,89,74,120167.2,1676.577,79.83436
"24453","71343","2021",7,7,0,120142.9,1230,99.28571
"24454","71344","2021",2,2,0,384162.5,3729.5,105.5
"24455","71345","2021",17,17,0,191224.9,2098.941,96.05882
"24456","71346","2021",25,24,1,99037.64,1108.72,90.56
"24457","71347","2021",4,4,0,93975,1113.25,86
"24458","71348","2021",4,4,0,182533.8,1406,124.5
"24459","71349","2021",1,1,0,85000,850,100
"24460","71350","2021",10,10,0,208895,1770.8,111.1
"24461","71351","2021",35,31,4,125088.4,1242.286,103.0286
"24462","71352","2021",5,5,0,95217.6,1117.8,82.2
"24463","71353","2021",5,5,0,266646,2377.6,100
"24464","71354","2021",9,9,0,166160,1346.333,127.1111
"24465","71355","2021",5,5,0,94300,1318.4,84.6
"24466","71356","2021",4,4,0,115125,1972.25,89
"24467","71357","2021",4,4,0,158275,1640.75,96.25
"24468","71359","2021",11,11,0,214414.5,1708.727,123.5455
"24469","71360","2021",16,15,1,189018.2,1720.875,120.0625
"24470","71361","2021",1,1,0,160000,1194,134
"24471","71362","2021",4,4,0,153800,1833,77
"24472","71363","2021",4,4,0,112687.5,1162.75,99.75
"24473","71364","2021",3,3,0,162850,1292.667,123
"24474","71365","2021",20,20,0,113394.1,1227.1,91.8
"24475","71366","2021",9,9,0,164148.9,1377.667,120
"24476","71367","2021",10,10,0,125805,1175.6,97.4
"24477","71368","2021",3,3,0,82271.67,916.6667,85.33333
"24478","71369","2021",7,7,0,132700,1737.286,76.71429
"24479","71370","2021",9,9,0,97088.89,1138.667,96.33333
"24480","71371","2021",20,18,2,226263.4,2312.55,96.75
"24481","71372","2021",22,21,1,235952.7,2379.5,110.6364
"24482","71373","2021",30,30,0,120784.7,1329.567,96.2
"24483","71374","2021",4,4,0,233750,2478.25,93.25
"24484","71376","2021",7,7,0,82571.43,1041.857,81.71429
"24485","71377","2021",5,5,0,127400,1469.2,97.2
"24486","71378","2021",18,17,1,239978.9,2026.056,115.6111
"24487","71379","2021",21,21,0,160215.2,1541.714,109.8095
"24488","71380","2021",8,8,0,176106.2,1764,99.75
"24489","71381","2021",4,4,0,110750,1732.25,63
"24490","71382","2021",10,10,0,105574,1089.9,98.9
"24491","71383","2021",7,7,0,147512.9,1549.286,97
"24492","71385","2021",7,7,0,239428.6,1930.571,114.5714
"24493","71386","2021",1,1,0,169000,676,250
"24494","71387","2021",10,10,0,160696,1410.6,110.2
"24495","71388","2021",6,6,0,118200,1397.167,85.33333
"24496","71389","2021",5,5,0,100950,1054.8,90.6
"24497","71390","2021",13,13,0,113151.6,1161.462,98.61538
"24498","71391","2021",8,8,0,107718.8,1176.75,88.125
"24499","71392","2021",13,13,0,165746.2,1707.385,94.76923
"24500","71393","2021",7,7,0,132278.6,1125.429,115.5714
"24501","71394","2021",10,9,1,114307,1084.7,106.7
"24502","71395","2021",4,4,0,131750,1380,97.25
"24503","71396","2021",10,10,0,123900,1133.8,112
"24504","71397","2021",6,6,0,242373.3,2402.167,114.3333
"24505","71398","2021",15,15,0,183316.7,1991.467,93.53333
"24506","71399","2021",10,10,0,134625,1399.8,113
"24507","71400","2021",3,3,0,156773.3,1388.667,102
"24508","71401","2021",15,14,1,145735.3,1799.6,86.4
"24509","71402","2021",12,12,0,175327.5,1528.333,112.1667
"24510","71403","2021",6,6,0,190067.3,1967.167,95.5
"24511","71404","2021",22,21,1,202743.6,1944.955,106.7727
"24512","71405","2021",5,4,1,106050,1173,86.6
"24513","71406","2021",4,4,0,219722.5,1260.75,151.75
"24514","71407","2021",5,5,0,64600,942.2,70.4
"24515","71408","2021",8,8,0,163475.4,1401.5,114.625
"24516","71409","2021",8,8,0,78844.88,877.5,90.625
"24517","71410","2021",16,16,0,133196.9,1321.438,101.375
"24518","71411","2021",2,2,0,170150,1443,117
"24519","71412","2021",14,13,1,150370.1,1688.143,90.35714
"24520","71413","2021",10,10,0,143645.5,1393.6,99.3
"24521","71414","2021",9,9,0,55395.56,753.8889,71.44444
"24522","71415","2021",3,3,0,250000,1878,126.6667
"24523","71416","2021",13,13,0,208991.5,2110.385,109.9231
"24524","71417","2021",26,25,1,126955.4,1228.538,102.5769
"24525","71419","2021",51,48,3,161531.5,1601.431,103.2549
"24526","71420","2021",29,27,2,165425.4,1682.172,102.4828
"24527","71421","2021",2,2,0,99500,1192.5,100
"24528","71422","2021",2,2,0,387645,1866.5,208.5
"24529","71423","2021",3,3,0,229333.3,1899.333,121.3333
"24530","71424","2021",1,1,0,71500,753,95
"24531","71425","2021",5,5,0,108511,1296.8,80.8
"24532","71426","2021",7,7,0,159942.9,2000,88.57143
"24533","71428","2021",13,13,0,130026.9,1201.077,108.9231
"24534","71430","2021",5,5,0,150700,1408.6,102.2
"24535","71431","2021",9,9,0,217577.8,1530.778,124.8889
"24536","71433","2021",11,11,0,172784.6,1531.636,118.8182
"24537","71434","2021",3,3,0,191936.7,1523,120.3333
"24538","71435","2021",3,2,1,150100,1413.333,100.3333
"24539","71436","2021",10,8,2,113305,1290,86.4
"24540","71437","2021",6,6,0,142316.7,1175.333,119.5
"24541","71438","2021",7,7,0,88621.43,1135.286,80
"24542","71439","2021",4,4,0,199806,1487.25,131.75
"24543","71440","2021",9,9,0,72196.44,1046.667,72.11111
"24544","71441","2021",4,4,0,142295,1081.75,126.75
"24545","71442","2021",21,21,0,114623.8,1237.238,90.04762
"24546","71443","2021",21,21,0,177487.2,1597.286,113.9048
"24547","71444","2021",13,11,2,206372.3,1779.154,114.4615
"24548","71445","2021",76,56,20,159847.8,1725.671,91.28947
"24549","71446","2021",6,6,0,177125,2009.5,87.5
"24550","71447","2021",2,1,1,55250,568.5,105
"24551","71448","2021",11,11,0,196435.1,1974.364,101.1818
"24552","71449","2021",3,3,0,138279.3,1312,112.6667
"24553","71450","2021",2,2,0,30500,405,73.5
"24554","71451","2021",2,2,0,205000,1360,138
"24555","71452","2021",5,5,0,157000,1639.2,90.2
"24556","71453","2021",2,2,0,157500,1330,118
"24557","71454","2021",2,2,0,160000,1922,92.5
"24558","71455","2021",3,3,0,126333.3,1413.667,77.66667
"24559","71456","2021",28,27,1,166353.8,1460.071,123.7143
"24560","71457","2021",3,3,0,170500,1595.333,111.3333
"24561","71458","2021",3,3,0,165460,1420.333,127.6667
"24562","71459","2021",7,7,0,331978.6,2676.857,114.4286
"24563","71460","2021",4,4,0,235597.5,2542.5,113.25
"24564","71461","2021",1,1,0,194000,1764,110
"24565","71462","2021",7,7,0,119674.9,1029.143,116.1429
"24566","71463","2021",10,10,0,138975.9,1321.7,105.2
"24567","71464","2021",3,3,0,118516.7,1324.333,94
"24568","71465","2021",2,2,0,97750,996,100.5
"24569","71466","2021",6,6,0,68250,920.8333,74.5
"24570","71468","2021",10,10,0,135100,1330.5,92.4
"24571","71469","2021",7,7,0,80357.14,1028.857,80.28571
"24572","71470","2021",4,4,0,102472.5,1565.25,69.5
"24573","71471","2021",1,1,0,165000,1130,146
"24574","71472","2021",7,7,0,87751.43,1025.143,104.8571
"24575","71473","2021",3,3,0,126966.7,1553.333,86
"24576","71474","2021",3,3,0,101021.7,1206.333,80
"24577","71475","2021",82,67,15,174076.6,1821.244,97.67073
"24578","71477","2021",13,13,0,125596.2,1381.154,87.23077
"24579","71479","2021",12,12,0,167230,1529.75,108.9167
"24580","71480","2021",16,16,0,85236.25,1107.75,81.5
"24581","71481","2021",15,14,1,207721.3,2225.467,99.93333
"24582","71482","2021",9,9,0,94194.44,1120.111,79.77778
"24583","71483","2021",10,10,0,112325,1253.3,92.7
"24584","71484","2021",18,18,0,109250,1117.5,96.72222
"24585","71485","2021",3,3,0,148666.7,1664.333,91.66667
"24586","71486","2021",113,111,2,108972.7,1215.549,90.84071
"24587","71487","2021",1,1,0,3e+05,1136,264
"24588","71488","2021",4,4,0,262625,2004.75,158.25
"24589","71489","2021",7,7,0,133721.4,1360.143,99.42857
"24590","71490","2021",9,9,0,161796.7,1432.444,116.1111
"24591","71491","2021",20,20,0,166418.6,1361.6,119.85
"24592","71492","2021",4,4,0,150897.5,1391.25,99
"24593","71493","2021",14,14,0,105318.8,1117.5,97.85714
"24594","71494","2021",11,10,1,202695.5,1832.455,114.9091
"24595","71495","2021",13,13,0,144238.5,1518.154,92.23077
"24596","71496","2021",3,3,0,246466.7,1932.333,128.3333
"24597","71497","2021",25,23,2,225684.4,2138.6,110.76
"24598","71498","2021",2,2,0,101800,1321,88.5
"24599","71499","2021",58,57,1,99964.93,1092.569,89.41379
"24600","71500","2021",4,4,0,148810.8,1363,105.25
"24601","71501","2021",5,5,0,104890,1686.8,74.4
"24602","71502","2021",16,16,0,180684.6,1533.812,116.375
"24603","71503","2021",3,3,0,105250,1255,91
"24604","71506","2021",24,24,0,143395.8,1441.583,101.9167
"24605","71507","2021",5,5,0,161430,1261.2,132.6
"24606","71508","2021",7,7,0,142428.6,1422.143,98
"24607","71509","2021",8,8,0,85209.12,929.5,96.25
"24608","71510","2021",4,4,0,109312.5,1523.25,77
"24609","71512","2021",38,36,2,167137.4,1621.395,104.8684
"24610","71513","2021",20,20,0,226735,1783.55,129.45
"24611","71514","2021",11,11,0,197778.6,1302.091,157.5455
"24612","71515","2021",1,1,0,34000,971,35
"24613","71516","2021",11,11,0,164570.9,1945.727,88.18182
"24614","71517","2021",6,6,0,114104,1363.667,85.33333
"24615","71518","2021",5,5,0,377168,1977.8,179.8
"24616","71519","2021",1,1,0,48000,565,85
"24617","71520","2021",8,8,0,149930.9,1784.375,87.375
"24618","71521","2021",4,4,0,171875,888.5,202.25
"24619","71522","2021",22,22,0,142705.5,1403.455,100.5
"24620","71523","2021",18,18,0,137847.2,1462.5,98.83333
"24621","71524","2021",5,5,0,283673.6,1892,140.4
"24622","71525","2021",7,7,0,165321.4,1666.143,104.1429
"24623","71526","2021",5,5,0,186440,1842,95.4
"24624","71527","2021",4,4,0,94550,1006.75,97
"24625","71528","2021",41,40,1,143595.2,1330.537,107.2927
"24626","71529","2021",2,2,0,239750,1918,118.5
"24627","71530","2021",10,10,0,136760,923.1,148.1
"24628","71531","2021",2,2,0,84000,666.5,110
"24629","71532","2021",2,2,0,83500,1242,78
"24630","71533","2021",3,3,0,108540,1149.333,91.66667
"24631","71534","2021",2,2,0,75000,1279.5,60
"24632","71535","2021",7,7,0,82213.57,897.4286,86.28571
"24633","71537","2021",3,3,0,133333.3,1534.333,87
"24634","71538","2021",12,12,0,129168.3,1252.833,110
"24635","71539","2021",3,3,0,200125,1378.333,140.3333
"24636","71540","2021",17,15,2,114192.1,1328.118,91.05882
"24637","71541","2021",10,10,0,131225,1357.6,97.5
"24638","71542","2021",16,15,1,98015.62,1048.438,94.6875
"24639","71543","2021",125,79,46,121820.3,1322.92,89.84
"24640","71545","2021",13,12,1,146145.4,1458.385,105.6154
"24641","71546","2021",12,12,0,135775,1654.083,85.75
"24642","71547","2021",3,3,0,182000,1597,120
"24643","71548","2021",6,6,0,157866.7,1299.167,125
"24644","71549","2021",5,5,0,146948,1283,108.2
"24645","71550","2021",21,21,0,112767.1,1250.333,106.2381
"24646","71551","2021",2,2,0,210000,887,212
"24647","71552","2021",9,9,0,97311.11,1225.778,86.33333
"24648","71553","2021",5,5,0,116700,1424.2,80.6
"24649","71554","2021",2,2,0,193650,1457.5,127.5
"24650","71555","2021",14,14,0,177789,1663,112.5714
"24651","71556","2021",2,2,0,336000,3917.5,87
"24652","71557","2021",6,6,0,206861.7,1777.667,118.3333
"24653","71558","2021",15,14,1,125894.3,1254.667,98.06667
"24654","71559","2021",10,10,0,104913.5,1161.4,93
"24655","71561","2021",10,10,0,142550,1107,127.7
"24656","71562","2021",4,4,0,103000,1086.5,109.25
"24657","71564","2021",14,14,0,128432.9,1491.214,98.5
"24658","71565","2021",5,5,0,84200,871.6,101.8
"24659","71566","2021",21,16,5,104581,1199.048,90.57143
"24660","71567","2021",3,3,0,153150,1750.333,92
"24661","71570","2021",10,10,0,132175,1118.2,123.4
"24662","71571","2021",6,6,0,199983.3,1372.333,142.6667
"24663","71572","2021",2,2,0,166950,1293,116
"24664","71573","2021",2,2,0,167500,1454,126.5
"24665","71574","2021",7,6,1,219911.4,2353.286,102.8571
"24666","71576","2021",3,3,0,140666.7,1182.667,151
"24667","71577","2021",3,3,0,181116.7,1882,102.6667
"24668","71578","2021",6,6,0,106666.7,1232.667,91.83333
"24669","71579","2021",2,2,0,145775,1308,120
"24670","71580","2021",9,9,0,137444.4,1283.778,102.7778
"24671","71581","2021",3,3,0,115000,1339,85.33333
"24672","71582","2021",8,8,0,222400,1954,114.625
"24673","71583","2021",8,8,0,282165,2636.75,105.125
"24674","71584","2021",16,16,0,208976.9,1779.562,121.1875
"24675","71585","2021",15,11,4,212255.3,2028.133,98.8
"24676","71586","2021",2,2,0,248300,1485,143.5
"24677","71588","2021",16,15,1,148156.2,1447.062,98.875
"24678","71589","2021",10,10,0,70900,751.3,96.8
"24679","71590","2021",5,5,0,185225.4,1420.2,132
"24680","71591","2021",12,12,0,194390.6,1768.25,111
"24681","72001","2021",22,22,0,181292,1662.682,108.5909
"24682","72002","2021",6,6,0,135916.7,1360.833,98.5
"24683","72003","2021",124,78,46,121865.8,1473.944,80.98387
"24684","72004","2021",10,10,0,251799,1749.2,141.6
"24685","72005","2021",15,15,0,167826.7,1387.667,119.1333
"24686","72006","2021",22,22,0,155504.5,1632,98.27273
"24687","72007","2021",3,3,0,154333.3,1632.667,94.33333
"24688","72008","2021",93,93,0,197394.8,1880.989,106.172
"24689","72009","2021",2,2,0,220873.5,1092,200.5
"24690","72010","2021",13,13,0,125653.8,870.7692,137.6154
"24691","72011","2021",16,16,0,121243.8,1159.812,105.5
"24692","72012","2021",9,9,0,101822.2,1341.222,82.88889
"24693","72013","2021",37,36,1,102659.5,1271,78.64865
"24694","72015","2021",2,2,0,206500,2082,108.5
"24695","72016","2021",16,16,0,99565.88,1146.875,97.875
"24696","72017","2021",2,2,0,1e+05,858.5,89
"24697","72019","2021",3,3,0,140333.3,1038.667,136
"24698","72020","2021",9,9,0,253994.4,1273.889,187
"24699","72021","2021",13,13,0,133846.2,1329.154,98.84615
"24700","72022","2021",20,20,0,127992,1132.75,111.7
"24701","72023","2021",55,55,0,131159.8,1265.291,105.8182
"24702","72024","2021",53,53,0,211765.5,2067.962,104.2264
"24703","72025","2021",32,31,1,136478.1,1400.531,97.96875
"24704","72026","2021",20,20,0,145710,1500.1,102.35
"24705","72027","2021",9,9,0,111777.8,1013.333,103.7778
"24706","72028","2021",9,9,0,147797.8,1469.889,104.2222
"24707","72029","2021",32,32,0,88734.38,1021.031,84.5625
"24708","72031","2021",11,11,0,134192.8,1293.182,105.7273
"24709","72032","2021",4,4,0,99125,1063,88.75
"24710","72034","2021",7,7,0,213750,1667.714,122.5714
"24711","72035","2021",50,47,3,82439.74,1045.24,81.3
"24712","72036","2021",3,3,0,147735,1292.667,109.6667
"24713","72037","2021",2,2,0,50000,566.5,88
"24714","72038","2021",12,12,0,125350,1269,113.75
"24715","72039","2021",63,62,1,95854.76,1112.016,84.53968
"24716","72042","2021",33,33,0,132139.5,1394.424,98.09091
"24717","72043","2021",5,5,0,173547,1258.4,137.2
"24718","72044","2021",4,4,0,73750,810.5,109.75
"24719","72045","2021",17,17,0,162855.8,1486,112.1765
"24720","72046","2021",35,35,0,126319.1,1206.2,102.7714
"24721","72047","2021",38,38,0,183192.4,1705.789,110.2632
"24722","72048","2021",3,3,0,165333.3,1416.333,122.3333
"24723","72049","2021",7,7,0,75335.71,952.2857,75.42857
"24724","72050","2021",21,20,1,108597.1,1081.238,101.381
"24725","72051","2021",48,48,0,156542.1,1493.771,107.2917
"24726","72052","2021",16,15,1,162812.5,1579.625,116.625
"24727","72053","2021",23,23,0,157802.2,1744.522,98.52174
"24728","72054","2021",30,30,0,187052.3,1744.267,107.9667
"24729","72056","2021",18,18,0,166036.1,1521.278,116.8333
"24730","72057","2021",2,2,0,75000,828.5,79
"24731","72058","2021",72,70,2,266006,2041.083,129.6528
"24732","72059","2021",14,14,0,144445,1561.786,99.85714
"24733","72060","2021",3,3,0,136166.7,1681.667,84.33333
"24734","72061","2021",23,23,0,145173.9,1819.609,96.95652
"24735","72062","2021",10,10,0,133833,1367.3,88
"24736","72064","2021",12,12,0,113169.3,1106.333,90.83333
"24737","72065","2021",34,33,1,263221,2195.147,117.7353
"24738","72066","2021",7,7,0,214458.3,1835,121.1429
"24739","72067","2021",15,15,0,151300,1582.2,99.6
"24740","72068","2021",27,26,1,95094.3,1078.852,89.44444
"24741","72070","2021",7,7,0,88820,997.7143,89.71429
"24742","72071","2021",96,91,5,111537.4,1366.906,84
"24743","72072","2021",2,2,0,93000,933,118.5
"24744","72073","2021",18,18,0,170993.1,1689.056,105.2778
"24745","72074","2021",6,6,0,113833.3,1176.667,96.5
"24746","72075","2021",12,12,0,131705.3,1573.083,82.83333
"24747","72076","2021",2,2,0,186500,1845,101.5
"24748","72077","2021",7,7,0,114735.7,1123,103.4286
"24749","72078","2021",6,6,0,95833.33,1106.833,92.66667
"24750","72079","2021",3,3,0,172789.3,1567.667,112
"24751","72080","2021",32,32,0,183904.6,1647.406,112.2188
"24752","72083","2021",2,2,0,180000,1329.5,131.5
"24753","72084","2021",24,24,0,138848.3,1417.875,100.5
"24754","72085","2021",8,8,0,114055,984.75,105.75
"24755","72086","2021",4,4,0,169716.2,1484.25,120.75
"24756","72087","2021",9,9,0,126833.3,1168,99
"24757","72088","2021",9,9,0,70755.56,903.3333,73.77778
"24758","72089","2021",37,36,1,120461.3,1196.378,100
"24759","72090","2021",52,50,2,127761.2,1470.712,91.65385
"24760","72091","2021",3,3,0,184333.3,1204.333,141
"24761","72093","2021",11,11,0,131281.8,1557.091,85.09091
"24762","72094","2021",24,24,0,70827.5,939.125,75.5
"24763","72095","2021",73,51,22,173747.5,2101.384,85.69863
"24764","72096","2021",25,25,0,143848.6,1488.56,98.32
"24765","72098","2021",17,17,0,115139.5,1165.882,97.76471
"24766","72099","2021",9,9,0,169562.2,1421.111,125.3333
"24767","72100","2021",6,6,0,110416.7,1064.667,106.6667
"24768","72101","2021",10,10,0,99455,1136.5,87.6
"24769","72102","2021",3,3,0,123333.3,1366.333,88.66667
"24770","72103","2021",11,11,0,103843.6,1080.364,97.09091
"24771","72104","2021",5,5,0,112241,1106.8,120
"24772","72105","2021",16,16,0,101810.6,1031.125,91.9375
"24773","72106","2021",7,7,0,170985.7,1574.429,112.1429
"24774","72107","2021",9,9,0,174667.8,1409,107.6667
"24775","72109","2021",6,6,0,108505,1370.667,79
"24776","72110","2021",22,22,0,118250.4,1159.727,101.8182
"24777","72111","2021",2,2,0,165102.5,1878,85
"24778","72112","2021",10,10,0,124835,1371.3,85
"24779","72113","2021",5,5,0,196000,1702.6,114.6
"24780","72114","2021",5,5,0,108900,1143.6,105.6
"24781","72115","2021",9,9,0,215219.6,1694.667,108.4444
"24782","72118","2021",39,39,0,112064.1,1237.821,93.35897
"24783","72119","2021",16,16,0,160623.1,1416.188,108.6875
"24784","72120","2021",5,5,0,182400,1181.6,146.8
"24785","72121","2021",5,5,0,74100,855.4,90.2
"24786","72122","2021",17,17,0,147059.4,1525.353,97.64706
"24787","72123","2021",1,1,0,1e+05,826,121
"24788","72124","2021",78,76,2,161370.9,1513.359,108.8974
"24789","72125","2021",3,3,0,113500,1247.667,89.66667
"24790","72126","2021",3,3,0,171666.7,1080.667,136.6667
"24791","72127","2021",19,19,0,192744.3,1792.474,108.0526
"24792","72128","2021",12,12,0,82583.33,955.4167,88.5
"24793","72129","2021",10,10,0,184383,1867.2,101.8
"24794","72130","2021",5,5,0,209800,2294.8,93
"24795","72131","2021",9,9,0,82133.22,1227.333,71
"24796","72132","2021",3,3,0,251000,2381,118.3333
"24797","72133","2021",21,21,0,203878,1744,120.619
"24798","72134","2021",11,11,0,138481.8,1565.455,87.63636
"24799","72135","2021",10,10,0,124900,1348.9,88.5
"24800","72136","2021",4,4,0,172400,1205.5,115.25
"24801","72137","2021",41,41,0,167141.2,1446.171,119.122
"24802","72138","2021",67,67,0,90110,944.5224,93.92537
"24803","72139","2021",35,35,0,148022.9,1372.971,105.1714
"24804","72141","2021",15,15,0,157057.8,1604.333,101.4667
"24805","72142","2021",1,1,0,49900,805,62
"24806","72143","2021",32,32,0,108831.6,1223.875,86.25
"24807","72144","2021",12,12,0,116208.3,1080,99.91667
"24808","72145","2021",1,1,0,104990,814,129
"24809","72146","2021",43,43,0,203318.3,1791.721,116.6512
"24810","72147","2021",25,25,0,164954.4,1631.08,97.92
"24811","72148","2021",1,1,0,61000,452,135
"24812","72149","2021",8,8,0,136700,1371.375,110.5
"24813","72150","2021",22,22,0,192605,1654.455,117.3636
"24814","72151","2021",22,22,0,140847,1345.136,107.5909
"24815","72152","2021",10,10,0,160850,1237.2,129
"24816","72153","2021",17,17,0,109058.8,1059.471,104.4118
"24817","72154","2021",202,193,9,148796.9,1517.837,100.7723
"24818","72155","2021",30,30,0,185062.1,1884.533,104.0333
"24819","72156","2021",23,23,0,111053.4,1236.478,91.26087
"24820","72157","2021",14,14,0,159157.1,1512.286,103.2143
"24821","72158","2021",19,19,0,125236.8,1392.474,96.36842
"24822","72160","2021",12,12,0,101600,922.0833,108
"24823","72161","2021",26,26,0,103515.4,1156.308,87.73077
"24824","72163","2021",12,12,0,115491.7,1265.417,98.5
"24825","72164","2021",2,2,0,115900,1072,109
"24826","72165","2021",35,35,0,147106.9,1362.571,114.5429
"24827","72166","2021",10,10,0,137051,1262,106.2
"24828","72167","2021",10,10,0,158800,1365.3,121.1
"24829","72168","2021",30,30,0,108508.7,1143.6,92.66667
"24830","72169","2021",26,26,0,174022.6,1664.692,107.5385
"24831","72170","2021",4,4,0,162500,1276.25,153
"24832","72171","2021",3,3,0,59000,622,95.33333
"24833","72172","2021",34,34,0,134837.6,1373.824,100.8235
"24834","72173","2021",16,16,0,158118.8,1506.125,106.25
"24835","72174","2021",2,2,0,161000,1930,83.5
"24836","72175","2021",19,19,0,90084.21,998.6842,95.73684
"24837","72176","2021",79,79,0,96238.23,1057.873,91.89873
"24838","72177","2021",7,7,0,118970.9,1355.286,91
"24839","72178","2021",3,3,0,120000,1061.667,109.6667
"24840","72179","2021",37,37,0,119404.7,1373.081,88.91892
"24841","72180","2021",97,96,1,79516.13,879.6701,89.26804
"24842","72181","2021",3046,1422,1624,144394.8,1899.341,75.15332
"24843","72182","2021",37,37,0,136819.2,1301.811,106.5135
"24844","72183","2021",14,14,0,126570.4,1355.143,87.14286
"24845","72184","2021",5,5,0,122125.6,1443.8,88
"24846","72185","2021",11,11,0,114909.1,1060.636,109.4545
"24847","72186","2021",21,21,0,96714.76,1116.333,84
"24848","72187","2021",39,39,0,137845.8,1389.718,103.6154
"24849","72188","2021",2,2,0,96500,1330,73.5
"24850","72189","2021",28,28,0,96498.21,1061.536,84.35714
"24851","72190","2021",4,4,0,86312.5,774.75,104
"24852","72191","2021",60,60,0,116758.6,1344.083,90.55
"24853","72192","2021",3,3,0,99000,887.3333,111.6667
"24854","72193","2021",11,11,0,104109.1,1130.727,93.54545
"24855","72194","2021",4,4,0,205493.8,1825.75,148.5
"24856","72195","2021",31,31,0,132283.9,1333.323,95.93548
"24857","72196","2021",6,6,0,92166.67,1331.833,72
"24858","72197","2021",9,9,0,121411.1,1019.444,123.3333
"24859","72198","2021",33,32,1,245994.8,2063.061,123
"24860","72199","2021",8,8,0,87625,1203.5,70.75
"24861","72200","2021",57,57,0,195328.9,1871.579,104.6491
"24862","72201","2021",3,3,0,112000,1266,90.33333
"24863","72202","2021",8,8,0,111187.5,1101.875,105.75
"24864","72204","2021",9,9,0,96577.78,968,114.1111
"24865","72205","2021",24,24,0,178718.8,1513,119.5417
"24866","72208","2021",4,4,0,135550,1071,110
"24867","72209","2021",5,5,0,93980,1188.2,80.8
"24868","72210","2021",8,8,0,90425,1187.125,83.375
"24869","72211","2021",10,10,0,92034,935,93.2
"24870","72212","2021",15,15,0,134979.3,1389.6,96.66667
"24871","72213","2021",69,60,9,173217.6,2392.928,88.04348
"24872","72215","2021",14,14,0,93837.71,1061.5,94.35714
"24873","72216","2021",11,11,0,128663.6,1336.545,92.72727
"24874","72217","2021",29,29,0,163482.8,1881.345,88.10345
"24875","72218","2021",10,10,0,151067,1597.3,96.2
"24876","72219","2021",13,13,0,143318.1,1354,107.0769
"24877","72220","2021",26,26,0,125799.2,1340.654,89.92308
"24878","72221","2021",12,12,0,99541.67,1172.833,87.16667
"24879","72222","2021",6,6,0,120666.7,1055.5,125.6667
"24880","72223","2021",66,65,1,127221.8,1298.742,99.01515
"24881","72224","2021",6,6,0,142500,1428.167,97.5
"24882","72225","2021",10,10,0,158880,1748.4,88
"24883","72226","2021",17,17,0,140938.2,1417.824,98.52941
"24884","72227","2021",1,1,0,45000,643,70
"24885","72228","2021",32,32,0,137421.9,1373.625,105.0625
"24886","72229","2021",8,8,0,74487.5,852.5,83
"24887","72230","2021",17,17,0,158957.9,1564.529,99
"24888","72231","2021",58,58,0,197732.6,1885.362,106.1207
"24889","72232","2021",10,10,0,127700,1375.4,92.9
"24890","72233","2021",2,2,0,89700,462,169.5
"24891","72234","2021",5,5,0,117700,1222.2,90.2
"24892","72235","2021",14,14,0,93632,1087.857,87.85714
"24893","72236","2021",3,3,0,78166.67,1004,81.33333
"24894","72237","2021",4,4,0,117187.5,857.25,127.25
"24895","72239","2021",8,8,0,125125,1218.125,104.25
"24896","72241","2021",69,69,0,151785.9,1477.87,102.7536
"24897","72243","2021",29,29,0,131646.9,1304.276,100.7931
"24898","72244","2021",44,41,3,129953.3,1306.045,96.63636
"24899","72245","2021",12,12,0,130083.3,1470.25,90.66667
"24900","72246","2021",11,11,0,134991.8,1309.091,113.2727
"24901","72247","2021",11,11,0,270362.3,1910,140.9091
"24902","72248","2021",22,22,0,109559.1,1188,95.36364
"24903","72249","2021",12,12,0,170316.7,1635.083,105.1667
"24904","72250","2021",3,3,0,67166.67,941.6667,89.33333
"24905","72251","2021",8,8,0,112075,1049.5,105.875
"24906","72252","2021",16,16,0,111781.2,1006.312,106.5
"24907","72253","2021",28,28,0,196614.8,1649.786,118.8214
"24908","72254","2021",5,5,0,62900,719.2,95.2
"24909","72255","2021",17,17,0,111749.2,981.1176,108.7647
"24910","72256","2021",11,11,0,84169.64,966.7273,86.09091
"24911","72257","2021",20,20,0,324404.7,2303.4,139.75
"24912","72259","2021",1,1,0,29000,408,71
"24913","72260","2021",52,49,3,235430.8,2064.981,114.9423
"24914","72261","2021",6,6,0,115833.3,1112.167,96.5
"24915","72262","2021",47,45,2,101385.2,1072.426,96.10638
"24916","72264","2021",143,122,21,119680.2,1413.161,85.90909
"24917","72265","2021",12,12,0,119500,1161.083,108.3333
"24918","72266","2021",7,7,0,98952.29,1018,93.57143
"24919","72267","2021",11,11,0,129545.5,1467.818,94.54545
"24920","72268","2021",11,10,1,159689.5,1571.636,101.2727
"24921","72269","2021",47,47,0,88143.87,1006.766,90.87234
"24922","72270","2021",3,3,0,142000,989.6667,138.3333
"24923","72271","2021",18,18,0,181417.6,2000.333,106.3333
"24924","72272","2021",7,7,0,175085.7,1097.143,166
"24925","72273","2021",6,6,0,108083.3,974.6667,107.8333
"24926","72274","2021",4,4,0,130500,1188.75,122.25
"24927","72275","2021",18,18,0,168250,1816.556,93.94444
"24928","72276","2021",36,36,0,106958.3,1183,90.38889
"24929","72277","2021",3,3,0,123286.7,1338.667,96
"24930","72278","2021",22,22,0,126215.7,1164.909,112.2727
"24931","72279","2021",4,4,0,138375,1679,92.5
"24932","72280","2021",26,24,2,225834.7,2094.346,105.8462
"24933","72281","2021",12,12,0,96443,1127.083,85.08333
"24934","72282","2021",14,13,1,84476.29,889,93.5
"24935","72283","2021",7,7,0,110400,1011.286,107.2857
"24936","72286","2021",3,3,0,61166.67,739.3333,80.33333
"24937","72287","2021",32,32,0,202166.2,1848.781,108
"24938","72289","2021",38,38,0,149176.3,1502.237,100.0526
"24939","72290","2021",31,31,0,163858.1,1536.194,105.5806
"24940","72291","2021",20,20,0,137300,1259.1,110.5
"24941","72292","2021",5,5,0,158000,1490.8,108
"24942","72293","2021",10,10,0,123162.4,1414.7,94.1
"24943","72294","2021",20,20,0,150405,1196.25,113.6
"24944","72295","2021",7,7,0,107000,2279.286,68.71429
"24945","72296","2021",14,14,0,144975,1212,113.9286
"24946","72297","2021",7,7,0,130471.4,1067.714,122.7143
"24947","72298","2021",19,19,0,119103.7,1276.053,92.57895
"24948","72299","2021",34,34,0,167395.1,1536.941,119.8529
"24949","72300","2021",37,37,0,147622.8,1660.162,93.72973
"24950","72302","2021",1,1,0,40000,331,121
"24951","72303","2021",11,11,0,95824.55,1123.455,89.81818
"24952","72305","2021",16,16,0,91937.5,1076.5,86.9375
"24953","72306","2021",26,26,0,158424.2,1552.077,104.0769
"24954","72307","2021",7,7,0,120171.4,1332.286,89
"24955","72308","2021",22,22,0,162723.9,1538.364,104.8636
"24956","72309","2021",9,9,0,104051.7,926.5556,113.3333
"24957","72310","2021",19,19,0,243491.1,2192.895,115.6316
"24958","72311","2021",8,8,0,72375,918.625,81.125
"24959","72312","2021",3,3,0,135000,1118,129.6667
"24960","72313","2021",6,6,0,99833.33,1271.833,83.33333
"24961","72314","2021",6,6,0,81583.33,1057.167,76.33333
"24962","72315","2021",14,14,0,105642.9,1004,103.3571
"24963","72316","2021",6,6,0,118000,1155.5,101.6667
"24964","72317","2021",15,15,0,121293.3,1077.467,114.8
"24965","72319","2021",17,17,0,155797.4,1564.235,101.0588
"24966","72320","2021",36,36,0,251123.6,2009.778,124.6111
"24967","72321","2021",8,8,0,99115.5,1207.5,83.375
"24968","72322","2021",9,9,0,98655.56,1170,88.77778
"24969","72323","2021",5,5,0,116600,1210.8,102
"24970","72324","2021",3,3,0,96333.33,1182.667,80
"24971","72325","2021",13,12,1,97174.62,945.6154,98.38462
"24972","72326","2021",3,3,0,139666.7,1498.667,93
"24973","72327","2021",2,2,0,106000,885.5,130.5
"24974","72328","2021",45,45,0,235842,2032.156,118.1778
"24975","72329","2021",59,59,0,198085.1,1851.22,106
"24976","72330","2021",8,8,0,124437.5,1403.75,100.5
"24977","72331","2021",10,10,0,106230,1125.6,102.3
"24978","72332","2021",10,10,0,126790,1446.9,88.8
"24979","72333","2021",9,9,0,102793.3,1284.333,77.88889
"24980","72334","2021",47,45,2,91373.4,1034.617,86.08511
"24981","72335","2021",13,13,0,169295.8,1456.077,114
"24982","72336","2021",18,18,0,188388.9,1646,115.6667
"24983","72337","2021",26,26,0,88750,963.6154,91.88462
"24984","72338","2021",5,5,0,204600,1726,134.4
"24985","72339","2021",10,10,0,138657,1514.1,92.3
"24986","72340","2021",17,17,0,152905.9,1487.176,99.23529
"24987","72341","2021",10,10,0,117162,1287,93.8
"24988","72342","2021",3,3,0,214240,1301,160
"24989","72343","2021",6,6,0,208000,1722.667,115.6667
"24990","72344","2021",32,32,0,179852.5,1694.594,109.0938
"24991","72345","2021",6,6,0,124983.3,1140.5,111.1667
"24992","72346","2021",62,59,3,140737.8,1574.565,93.37097
"24993","72347","2021",7,7,0,104428.6,1137.286,87.14286
"24994","72348","2021",2,2,0,151526,1516,100
"24995","72349","2021",13,13,0,131767.7,1538,91.53846
"24996","72350","2021",56,56,0,180438.2,1781.357,102.1607
"24997","72351","2021",13,13,0,88719.23,993.5385,86.61538
"24998","72352","2021",1,1,0,72000,576,125
"24999","72353","2021",5,5,0,133600,1758.2,107.6
"25000","72354","2021",3,3,0,96166.67,981.6667,100.6667
"25001","72355","2021",5,5,0,100880,999.8,103.8
"25002","72356","2021",7,7,0,104760.4,1354.571,77.42857
"25003","72357","2021",15,15,0,110433.3,1288.4,85.93333
"25004","72358","2021",30,30,0,143224.7,1607.567,97.46667
"25005","72359","2021",26,26,0,128606.2,1342,102.6923
"25006","72360","2021",16,16,0,229170.5,2072.25,110.8125
"25007","72361","2021",12,12,0,105343.3,1204.5,85.58333
"25008","72363","2021",35,35,0,151780.3,1539.171,99.14286
"25009","72364","2021",30,30,0,87642,964.6,92.1
"25010","72366","2021",4,4,0,88250,995.75,98.25
"25011","72367","2021",17,17,0,106833.1,1150.706,95.17647
"25012","72368","2021",5,5,0,154420,1454,102.8
"25013","72369","2021",10,10,0,113800,1066,109.3
"25014","72370","2021",6,6,0,154783.3,1014.167,158.3333
"25015","72373","2021",42,42,0,126226.2,1294.476,96.54762
"25016","72374","2021",2,2,0,106750,1167,91.5
"25017","72375","2021",13,13,0,138676.9,1408.615,100.7692
"25018","72376","2021",10,10,0,106455.3,1095.9,96.2
"25019","72377","2021",14,14,0,131071.4,1172.429,111.6429
"25020","72378","2021",22,22,0,163172.7,1455.909,112.9091
"25021","72379","2021",4,4,0,93500,762.25,116
"25022","72380","2021",15,15,0,114659.1,1169,103.8
"25023","72381","2021",22,22,0,172659.5,1658.182,101.5
"25024","72382","2021",20,20,0,136530,1403.45,98.95
"25025","72383","2021",5,5,0,144100,1394.4,100.6
"25026","72385","2021",31,31,0,128467.7,1459.29,89.32258
"25027","72386","2021",59,59,0,234839.3,2106.068,114.6102
"25028","73001","2021",7,3,4,238820,4623,54
"25029","73003","2021",59,28,31,196330.6,2560.576,80
"25030","73004","2021",37,3,34,73817.65,2113.162,33.97297
"25031","73005","2021",4,4,0,251358.2,1923.75,126
"25032","73006","2021",127,26,101,186286.5,3352.37,55.96063
"25033","73007","2021",13,10,3,243994.6,2681.385,95
"25034","73008","2021",765,126,639,251070.9,3978.528,64.97778
"25035","73010","2021",70,49,21,329275.6,3225.671,106.3286
"25036","73011","2021",351,64,287,145631.9,2052.647,71.49573
"25037","73012","2021",7,5,2,138244,2203.857,71.71429
"25038","73013","2021",36,7,29,152883.1,3001.167,46.25
"25039","73014","2021",3,3,0,358882.3,3254.333,105
"25040","73015","2021",148,14,134,503185.8,8637.858,54.84459
"25041","73017","2021",7,6,1,290531.4,3769.429,79.28571
"25042","73018","2021",8,6,2,248033.1,2732.125,91.625
"25043","73019","2021",10,10,0,179137.5,2180.9,89.3
"25044","73020","2021",3,3,0,230600,2459.333,113.3333
"25045","73021","2021",16,13,3,151140.6,1678.125,90
"25046","73022","2021",17,16,1,257774.7,2304.588,114.0588
"25047","73023","2021",26,2,24,158428,3586.231,47.5
"25048","73024","2021",85,13,72,149199.7,4110.647,38.23529
"25049","73025","2021",5,5,0,255121.2,2214.6,118.4
"25050","73026","2021",5,3,2,108550,1816.6,59.4
"25051","73027","2021",3,3,0,211528.3,2480,92.66667
"25052","73028","2021",7,7,0,293371.4,2331.714,128.5714
"25053","73029","2021",45,20,25,265173.3,3159.8,85.77778
"25054","73030","2021",49,10,39,216527.1,2996.878,74.53061
"25055","73031","2021",70,18,52,251288.5,3053.671,82.85714
"25056","73032","2021",20,15,5,196354.8,2504.1,84.5
"25057","73033","2021",7,6,1,277935.7,2383.714,119.5714
"25058","73034","2021",58,18,40,232221.1,4129.069,61.27586
"25059","73036","2021",10,9,1,221030.5,3058.6,79.4
"25060","73039","2021",8,8,0,208111.2,2018.75,106.75
"25061","73040","2021",8,3,5,136850,2529.875,54.125
"25062","73041","2021",10,5,5,164394,1992.1,81.1
"25063","73042","2021",1,1,0,167500,1523,110
"25064","73043","2021",43,27,16,324401.5,3444.744,94.5814
"25065","73047","2021",9,2,7,208322.2,4771.444,42.66667
"25066","73048","2021",4,4,0,159673.5,1195.25,132.5
"25067","73049","2021",3,3,0,81113.33,1153.333,64.33333
"25068","73050","2021",4,3,1,312462.5,3461.5,93.25
"25069","73051","2021",46,20,26,308641.1,4262.63,73.78261
"25070","73052","2021",3,3,0,186423.3,2552.333,77.66667
"25071","73053","2021",5,5,0,205919,2304.2,90.2
"25072","73054","2021",288,40,248,189746.1,4178.649,47.19444
"25073","73055","2021",40,18,22,333374.4,4516.4,77.3
"25074","73057","2021",38,4,34,156596.3,3824.789,43.71053
"25075","73058","2021",17,10,7,191088.9,1905.471,103.4118
"25076","73059","2021",29,24,5,507854.2,4944.414,102.7241
"25077","73061","2021",2,2,0,300330,2661,115
"25078","73063","2021",9,7,2,128644.4,2082.111,65
"25079","73064","2021",86,31,55,289552.2,3278.86,87.09302
"25080","73065","2021",1051,107,944,190352.1,2763.084,70.67935
"25081","73067","2021",16,10,6,163742.5,2024.438,79.5
"25082","73068","2021",7,5,2,197536.4,1770.714,109.2857
"25083","73069","2021",18,17,1,199161.2,1964.111,105.2222
"25084","73070","2021",11,11,0,229281.8,2016.091,114.9091
"25085","73071","2021",29,8,21,245723.6,4709.793,55.37931
"25086","73072","2021",4,4,0,107222.5,1727.75,60
"25087","73073","2021",8,8,0,281662.5,2745.375,102.125
"25088","73074","2021",2,1,1,70000,1954,38
"25089","73075","2021",7,7,0,332745.4,3625.857,96.71429
"25090","73076","2021",5,4,1,441112,3996.4,114
"25091","73077","2021",9,7,2,283688.9,3770.444,76.77778
"25092","73078","2021",2,2,0,256500,2168.5,121.5
"25093","73079","2021",10,9,1,224201,2229.3,107.8
"25094","73081","2021",12,9,3,215359.2,2482.75,93.75
"25095","73082","2021",7,3,4,217028.6,4179.714,57.28571
"25096","73083","2021",3,2,1,192750,3722.667,64
"25097","73084","2021",7,7,0,333380,2769.143,115.1429
"25098","73085","2021",29,25,4,251904.8,2594.103,96.93103
"25099","73086","2021",3,3,0,282896.7,3022,95.66667
"25100","73087","2021",80,18,62,223340.4,3174.975,74.15
"25101","73088","2021",34,5,29,179657.2,4032.412,44.17647
"25102","73089","2021",12,11,1,203289.8,2458.833,90
"25103","73090","2021",4,4,0,157750,2755.75,57.5
"25104","73091","2021",4,4,0,412975,3622.75,114.75
"25105","73092","2021",3,3,0,165807.7,2885.667,58.66667
"25106","73094","2021",21,7,14,332616.3,5548.095,55.80952
"25107","73095","2021",2,2,0,196600,3502,56
"25108","73096","2021",18,17,1,262272.8,2467.889,104.1667
"25109","73097","2021",5,4,1,299500,2958.4,111.8
"25110","73098","2021",22,13,9,197443.1,2970.727,74.09091
"25111","73099","2021",4,3,1,222800,2798.75,80.25
"25112","73100","2021",20,17,3,294818.8,2582.35,117.95
"25113","73101","2021",4,3,1,182500,1913.25,99.75
"25114","73103","2021",53,21,32,335525.6,3941.321,84.09434
"25115","73104","2021",6,5,1,156616.7,1784.667,88.16667
"25116","73105","2021",27,16,11,175359.3,2013.148,88.14815
"25117","73106","2021",10,10,0,147592.1,1811.7,85.4
"25118","73107","2021",17,16,1,186902.9,2208.706,82.11765
"25119","73109","2021",8,8,0,185075,1688.875,113
"25120","73110","2021",10,9,1,120509.2,1702.8,69.6
"25121","73113","2021",2,1,1,288402.5,2763.5,106
"25122","73114","2021",42,5,37,169028.2,3291.762,52.92857
"25123","73116","2021",102,8,94,111955.5,2892.529,37.85294
"25124","73117","2021",13,2,11,72356.92,1748.846,57.38462
"25125","73120","2021",8,6,2,204946.2,2347.5,89
"25126","73121","2021",25,14,11,236148.4,2529.4,88.44
"25127","73122","2021",6,6,0,287760,2496.5,112.8333
"25128","73123","2021",50,3,47,188468.2,3616.58,52.2
"25129","73124","2021",37,28,9,347664.8,3123.919,116.3243
"25130","73128","2021",67,37,30,344410.9,3771.552,93.01493
"25131","73129","2021",24,20,4,192544.8,2121.833,90.83333
"25132","73130","2021",20,15,5,226188,2568.8,87.6
"25133","73131","2021",4,1,3,168610,2602,68.75
"25134","73132","2021",95,20,75,238434.3,5832.516,43.53684
"25135","73133","2021",4,3,1,250370,2322.5,106
"25136","73135","2021",13,11,2,212669.2,2281.846,87
"25137","73137","2021",60,8,52,255501.5,3714.7,65.26667
"25138","73138","2021",9,8,1,188242.2,1995.222,112.1111
"25139","73139","2021",4,3,1,251125,3771.5,86.5
"25140","73140","2021",4,4,0,178500,2335,73.75
"25141","73141","2021",11,10,1,239655,2811,89.18182
"25142","73142","2021",34,7,27,290179.4,4535.971,59.94118
"25143","73145","2021",5,5,0,285100,3932.6,83.4
"25144","73146","2021",10,8,2,212769.5,2410.3,95.8
"25145","73147","2021",2,2,0,225000,2699,86.5
"25146","73149","2021",5,5,0,232648,2266.4,101.6
"25147","73150","2021",343,29,314,170145.4,4148.466,39.89504
"25148","73151","2021",42,27,15,268300.5,3010.786,93.88095
"25149","73152","2021",4,4,0,253362.5,2799.75,100.25
"25150","73153","2021",16,15,1,230202,2543.812,89.9375
"25151","73154","2021",42,32,10,325753.1,3056.286,109.3333
"25152","73155","2021",27,11,16,313579.7,3914.778,81.55556
"25153","73156","2021",2,2,0,293500,2261,142
"25154","73157","2021",157,7,150,76969.75,1904.675,44.97452
"25155","73159","2021",7,7,0,258152.9,2791.857,91.42857
"25156","73160","2021",9,6,3,330706.4,3540.444,103.7778
"25157","73161","2021",8,8,0,235895,3500.5,78.75
"25158","73162","2021",5,4,1,223140,2947.6,79
"25159","73164","2021",9,9,0,334947.8,3479.889,96.11111
"25160","73166","2021",2,2,0,143950,1874,77
"25161","73168","2021",5,5,0,149870,1743.4,76.4
"25162","73170","2021",2,2,0,275500,2153,119
"25163","73171","2021",44,11,33,171539.2,2366.273,74.52273
"25164","73173","2021",8,6,2,68687.5,1340.25,51.875
"25165","73175","2021",5,5,0,231989.8,2017.2,121.2
"25166","73176","2021",73,12,61,216149.8,4529.836,44.21918
"25167","73177","2021",5,5,0,148670,1702.6,80.6
"25168","73178","2021",11,11,0,250659,2919.545,85.72727
"25169","73179","2021",155,47,108,273787.6,3383.652,80.54839
"25170","73180","2021",8,8,0,277533.8,2548.75,106.5
"25171","73181","2021",48,3,45,130466.7,1770.771,72
"25172","73182","2021",35,26,9,404240.7,3825.829,106
"25173","73183","2021",15,10,5,366816.4,4049.4,96.93333
"25174","73184","2021",5,5,0,308490,3648,89.2
"25175","73186","2021",59,5,54,214966.5,4510.831,45.18644
"25176","73187","2021",49,34,15,173190.7,2430.327,78.14286
"25177","73188","2021",6,6,0,191067,2247.667,87.66667
"25178","73189","2021",5,5,0,198980,1664.8,117.8
"25179","73190","2021",4,4,0,150872.5,1894.75,75.5
"25180","73191","2021",18,14,4,317203.1,3062.778,103.7222
"25181","73192","2021",8,8,0,245507.5,2421.25,113
"25182","73193","2021",2,2,0,155700,1919,82
"25183","73194","2021",20,3,17,68501,2157.85,34.1
"25184","73196","2021",9,8,1,277191.1,2809.444,99.33333
"25185","73197","2021",36,6,30,250458.9,3656,67.16667
"25186","73200","2021",8,5,3,262611.4,2625,104.875
"25187","73201","2021",13,9,4,154325.8,2395.231,67
"25188","73202","2021",5,5,0,285499,2481,101.8
"25189","73204","2021",32,21,11,196673.8,2188.781,90.375
"25190","73205","2021",4,4,0,165982.5,1698.5,90.75
"25191","73206","2021",48,8,40,200848.1,4115.417,48.9375
"25192","73207","2021",9,9,0,227320,2624.111,88
"25193","73208","2021",12,9,3,700259.9,4686.167,145.0833
"25194","73210","2021",2,2,0,279850,2520,109
"25195","73211","2021",23,17,6,239975.6,2974,86.26087
"25196","73212","2021",25,14,11,119561.8,1844.64,72.68
"25197","73213","2021",127,35,92,244504.1,3147.173,78.85039
"25198","73214","2021",1,1,0,2e+05,2632,76
"25199","73215","2021",63,34,29,182034.4,2169.27,89.93651
"25200","73216","2021",4,4,0,208915,2059.5,97
"25201","73217","2021",3,3,0,294593.3,2455,129
"25202","73218","2021",20,14,6,202337,2240.3,89.9
"25203","73219","2021",9,7,2,262630,2490,107.7778
"25204","73220","2021",7,7,0,141571.4,1955.143,79.57143
"25205","73221","2021",4,4,0,125000,1789.75,63
"25206","73222","2021",72,21,51,278245.8,3418.097,80.38889
"25207","73223","2021",8,6,2,116628.9,1602.5,79
"25208","73224","2021",12,10,2,169495.8,1954.417,90.08333
"25209","73225","2021",24,13,11,306930.1,3212.167,96.625
"25210","73226","2021",22,19,3,218514.9,2087.682,109.0909
"25211","73227","2021",115,16,99,463391,8289.583,58.23478
"25212","73228","2021",8,7,1,391783.1,3193.5,118.5
"25213","73229","2021",6,6,0,181125,1879.5,104.8333
"25214","73230","2021",10,2,8,104413,2020.6,50.9
"25215","73231","2021",12,10,2,130491.7,1656.667,80.25
"25216","73232","2021",34,12,22,373524.5,5126.382,78.44118
"25217","73233","2021",2,2,0,272500,3505,88
"25218","73234","2021",4,4,0,247200,1474.75,143
"25219","73235","2021",105,21,84,125926,3166.781,40.22857
"25220","73236","2021",53,39,14,196355,2004.755,96.56604
"25221","73237","2021",10,10,0,147329.5,2048.5,77.2
"25222","73240","2021",10,10,0,254755,2597.9,104.5
"25223","73241","2021",14,14,0,239266.9,2495.5,100.1429
"25224","73242","2021",38,8,30,103555.1,2629.947,38.60526
"25225","73243","2021",19,11,8,319785.6,3162.632,101.1053
"25226","73245","2021",7,6,1,167985.7,2095.286,84.57143
"25227","73247","2021",16,15,1,162752.2,1989.375,82.0625
"25228","73248","2021",104,12,92,127243.5,1730.5,75.00962
"25229","73249","2021",22,10,12,327862.7,3621.273,91.90909
"25230","73250","2021",20,16,4,154608,1623.8,97.65
"25231","73252","2021",2,2,0,176000,2292.5,76
"25232","73253","2021",6,4,2,123683.3,1834.333,67.66667
"25233","73254","2021",2,2,0,53500,873.5,73.5
"25234","73255","2021",7,7,0,221056.4,1995,110.2857
"25235","73256","2021",5,3,2,135109.4,1838,74.6
"25236","73257","2021",314,42,272,242078.3,5854.519,41.34395
"25237","73258","2021",13,13,0,188057.7,1675.769,112.9231
"25238","73259","2021",6,6,0,201625,2284.5,81.66667
"25239","73261","2021",41,25,16,118032.7,1752.659,73.12195
"25240","73262","2021",11,6,5,244896.8,3244.091,69.90909
"25241","73263","2021",11,11,0,347474.6,3321.727,106.2727
"25242","73265","2021",3,3,0,534738.3,4085.333,137
"25243","73267","2021",10,5,5,187200.5,2478.6,61.5
"25244","73268","2021",7,6,1,144015.6,1827.429,84.14286
"25245","73269","2021",13,13,0,349794.6,2951.462,117.7692
"25246","73270","2021",53,38,15,203834.5,2385.472,89.81132
"25247","73271","2021",7,7,0,293728.6,2669.571,110.5714
"25248","73272","2021",4,4,0,143750,1700,88.5
"25249","73273","2021",5,5,0,282026,2963.2,97
"25250","73274","2021",11,11,0,214618.2,2292.364,95.45455
"25251","73275","2021",2,0,2,245250,2819,87
"25252","73276","2021",5,5,0,188651.6,1348.4,120.2
"25253","73277","2021",3,3,0,201433.3,1683,116.3333
"25254","73278","2021",22,21,1,164821.3,1795.318,96.04545
"25255","73280","2021",41,3,38,134112.4,2900.463,43.04878
"25256","73281","2021",9,7,2,336067.2,3747.333,90.33333
"25257","73282","2021",16,16,0,284607.5,3030.875,96.125
"25258","73283","2021",6,5,1,236666.7,2504.167,102.1667
"25259","73284","2021",13,3,10,178034.6,2656.308,72.53846
"25260","73285","2021",25,11,14,307187.5,3638.48,83
"25261","73286","2021",20,17,3,260126.5,2694.95,95.7
"25262","73288","2021",25,17,8,336030.4,3225.44,106.72
"25263","73289","2021",10,10,0,174896,1760.5,99.6
"25264","73290","2021",105,18,87,159773.5,3071.924,51.99048
"25265","73292","2021",7,7,0,216848.7,2038.286,103.4286
"25266","73293","2021",8,8,0,292475.6,3739.875,101.375
"25267","73294","2021",7,5,2,186264.3,2701.429,64.85714
"25268","73296","2021",134,5,129,242606.4,5987.381,39.54478
"25269","73297","2021",7,7,0,264312,3350.143,93.28571
"25270","73298","2021",15,13,2,249016,2299.133,114.9333
"25271","73299","2021",3,3,0,367838,2603.333,133
"25272","73300","2021",45,27,18,536607.3,4763.222,108.4
"25273","73301","2021",16,11,5,349071.9,3477.062,95.875
"25274","73302","2021",7,7,0,290778.6,2195.286,136.7143
"25275","73303","2021",56,35,21,205072.1,2403.482,87.58929
"25276","73304","2021",99,1,98,334503.3,9609.152,33.72727
"25277","73306","2021",104,8,96,221105.4,4407.269,49.13462
"25278","73307","2021",126,8,118,97482.84,2829.913,34.61111
"25279","73308","2021",2,1,1,212500,3675,137
"25280","73309","2021",1,1,0,330000,4583,72
"25281","73310","2021",1,1,0,146050,4711,31
"25282","73311","2021",3,3,0,164516.7,1798.333,100
"25283","73312","2021",8,7,1,214006.2,2328.25,90.625
"25284","73313","2021",5,5,0,251505,2580,100.6
"25285","73314","2021",1,1,0,135000,1023,132
"25286","73315","2021",7,7,0,179528.6,1871,87.28571
"25287","73316","2021",11,9,2,268918.6,2298.727,116.6364
"25288","73317","2021",54,12,42,285229.9,4766.574,65.55556
"25289","73318","2021",119,3,116,64115.31,2061.479,29.51261
"25290","73320","2021",6,4,2,89033.33,1307.333,66
"25291","73322","2021",48,7,41,99774.69,2723.688,37.22917
"25292","73323","2021",1,1,0,79000,1254,63
"25293","73324","2021",1,1,0,388000,2874,135
"25294","73326","2021",22,15,7,372937,4239.182,87.81818
"25295","73327","2021",4,4,0,313477.5,2385,140
"25296","73328","2021",31,20,11,342557.9,4004.323,86.25806
"25297","73329","2021",31,21,10,353236,3686.935,99.45161
"25298","73330","2021",44,30,14,176457.2,2359.818,79.56818
"25299","74001","2021",55,12,43,151058.3,3113.418,45.52727
"25300","74002","2021",32,16,16,291903.5,3565.594,82.625
"25301","74003","2021",15,14,1,540680.3,4789.933,111.4
"25302","74004","2021",3,3,0,263777.3,4592,86
"25303","74005","2021",67,46,21,339171.7,3603,94.85075
"25304","74006","2021",30,9,21,339731.3,4278.1,82.83333
"25305","74007","2021",47,16,31,318223.6,3666.213,87.57447
"25306","74008","2021",82,7,75,269753.2,3764.671,69.57317
"25307","74009","2021",6,6,0,588308.3,4567,129.6667
"25308","74010","2021",1584,167,1417,346179.6,4837.562,71.6452
"25309","74012","2021",497,17,480,195298.9,3304.308,61.03622
"25310","74013","2021",41,26,15,566890,4864.585,111.5366
"25311","74014","2021",238,29,209,218012.5,4433.739,46.67227
"25312","74015","2021",16,14,2,391097.6,3475.375,124.9375
"25313","74016","2021",31,7,24,391828.3,4537.065,87.19355
"25314","74018","2021",31,17,14,315931.3,3444.677,97.51613
"25315","74019","2021",32,7,25,368363.2,5100,71.5
"25316","74020","2021",14,12,2,535013.9,4342.5,124.0714
"25317","74021","2021",25,11,14,320629.2,3309.68,102.04
"25318","74024","2021",35,28,7,375491.4,3765.171,104.8286
"25319","74025","2021",25,19,6,502963,4150.56,120.4
"25320","74026","2021",52,23,29,369489.9,4424.462,85.32692
"25321","74027","2021",2,2,0,231740,2675,85
"25322","74029","2021",8,8,0,147937.5,1988.75,73.375
"25323","74030","2021",7,6,1,443364.3,4216.857,133
"25324","74031","2021",30,19,11,420467.9,4383.9,93.66667
"25325","74032","2021",52,7,45,97239.29,2551.154,37.11538
"25326","74033","2021",57,16,41,193887.8,3173.807,57.5614
"25327","74034","2021",59,18,41,162746.2,3111.475,47.59322
"25328","74035","2021",2,1,1,486587.5,2406,191
"25329","74036","2021",7,6,1,736131.4,6368.429,116.7143
"25330","74037","2021",28,21,7,308608.1,3196.071,102
"25331","74038","2021",29,13,16,195516.4,3413.379,57.65517
"25332","74040","2021",40,26,14,344213.9,4132.9,86.2
"25333","74041","2021",3,3,0,327350,3674.667,91.66667
"25334","74042","2021",202,54,148,217353.1,2888.406,75.82673
"25335","74043","2021",94,62,32,317680.2,3467.936,92.90426
"25336","74044","2021",20,13,7,676776.2,4861.5,138.85
"25337","74045","2021",3,3,0,360813.3,6093.333,69
"25338","74046","2021",3,3,0,342550,2918.333,116.3333
"25339","74048","2021",9,9,0,525650,4996.333,109.5556
"25340","74049","2021",19,18,1,174634.2,2699.684,69.78947
"25341","74050","2021",8,7,1,281000,3458.625,85.875
"25342","74051","2021",8,6,2,372833.8,4057.5,91.25
"25343","74052","2021",12,11,1,573171.8,4387.333,126.5833
"25344","74053","2021",7,7,0,401641.4,3856.286,109.2857
"25345","74054","2021",7,5,2,420823.6,3707.857,111
"25346","74055","2021",11,7,4,211985.3,1836.636,128.1818
"25347","74056","2021",333,62,271,481719.8,7950.709,58.97297
"25348","74057","2021",13,13,0,371618.4,4045.846,96.53846
"25349","74058","2021",47,11,36,260830.8,4283.553,58.14894
"25350","74059","2021",5,4,1,376872,3866.4,114.4
"25351","74061","2021",15,3,12,314914.1,4010.8,78.53333
"25352","74062","2021",16,4,12,350679.1,4260.938,82.75
"25353","74063","2021",165,15,150,267313.7,4980.842,49.90909
"25354","74064","2021",16,15,1,373775.6,3393.5,128.125
"25355","74065","2021",7,7,0,336322.1,3467.857,97.57143
"25356","74067","2021",11,7,4,466295.5,3694.182,124.7273
"25357","74068","2021",3,3,0,374840.7,3064.333,125
"25358","74069","2021",8,3,5,339336.2,4060.875,82.375
"25359","74070","2021",61,29,32,439217.4,4371.672,100.5574
"25360","74071","2021",1,1,0,363320,3003,121
"25361","74072","2021",1,1,0,818220,6818,120
"25362","74073","2021",9,9,0,255655.6,2995.333,99.11111
"25363","74074","2021",13,7,6,367407.7,3114.923,113.6154
"25364","74075","2021",24,20,4,313685.6,3003.417,109.8333
"25365","74076","2021",21,20,1,495477,4483.048,114.5714
"25366","74077","2021",15,14,1,358246.7,3390.067,127.6667
"25367","74078","2021",4,4,0,381375,3178.75,121.75
"25368","74079","2021",2,2,0,357380,4593.5,78
"25369","74080","2021",73,20,53,604219.8,8408.945,67.71233
"25370","74081","2021",235,42,193,174481.2,2279.102,77.06809
"25371","74082","2021",56,22,34,403303.1,4688.304,83.25
"25372","74083","2021",143,39,104,492036.3,5455.371,73.79021
"25373","74085","2021",79,20,59,268172,4534.899,55.86076
"25374","74086","2021",5,4,1,424820,3857.2,124.2
"25375","74087","2021",33,20,13,317992.5,3836.242,84.57576
"25376","74088","2021",20,15,5,443840.3,4112.3,109.75
"25377","74089","2021",30,7,23,395788.7,4721.9,76.16667
"25378","74090","2021",14,5,9,329709.7,3678.643,91
"25379","74091","2021",7,5,2,297117.3,4330.714,78.28571
"25380","74094","2021",58,43,15,410739.1,4292.931,97.7931
"25381","74095","2021",8,8,0,203033.1,2174.75,91
"25382","74096","2021",69,26,43,337125.7,4147.507,81.07246
"25383","74097","2021",20,17,3,320640.5,3775.4,100.9
"25384","74098","2021",10,5,5,465568,4504.3,102.5
"25385","74099","2021",60,14,46,578426.1,6898.917,66.53333
"25386","74100","2021",14,12,2,277475,2587.357,119.7857
"25387","74101","2021",11,10,1,517763.6,4229.818,122.4545
"25388","74102","2021",7,4,3,555614.3,4926.714,117
"25389","74103","2021",26,20,6,435654,4145.269,107.5
"25390","74104","2021",51,23,28,366404.7,4070.275,90.94118
"25391","74105","2021",148,62,86,306457.9,3741.655,83.38514
"25392","74106","2021",7,6,1,509257.1,3528.571,144.4286
"25393","74107","2021",2,2,0,272750,1952,146
"25394","74108","2021",9,1,8,299751.1,5722.889,59.66667
"25395","74109","2021",5,5,0,406587.4,2809,146.8
"25396","74111","2021",3,3,0,274470,4247.667,61
"25397","74112","2021",82,19,63,374965.3,4795.073,79.54878
"25398","74114","2021",13,7,6,292771.5,4347.154,64.92308
"25399","74116","2021",13,10,3,435961.5,3770.846,114.9231
"25400","74117","2021",6,6,0,438688.3,3859.833,116
"25401","74118","2021",35,14,21,320794.1,4105.686,77.57143
"25402","74119","2021",225,45,180,320045.4,4244.818,73.81333
"25403","74121","2021",28,20,8,452579.6,4439.821,108.0357
"25404","74122","2021",8,8,0,468265.6,3488.375,141.375
"25405","74123","2021",93,37,56,199783.2,2686.269,73.44086
"25406","74124","2021",20,16,4,517135.5,4171.75,128.8
"25407","74126","2021",8,8,0,478807.5,3396.375,136.375
"25408","74127","2021",22,17,5,349206.4,3420.909,99.63636
"25409","74128","2021",32,23,9,399790.9,3935.25,107.0625
"25410","74129","2021",2,2,0,327500,3228.5,102.5
"25411","74130","2021",6,5,1,331500,3234.333,104.1667
"25412","74131","2021",25,15,10,272234.2,3046.92,94.44
"25413","74133","2021",165,16,149,209997.7,3487.006,59.35758
"25414","74134","2021",131,35,96,436913,6877.008,62.35115
"25415","74135","2021",12,2,10,134748.3,2475.083,58.5
"25416","74136","2021",93,17,76,287910.7,5275.806,54.32258
"25417","74137","2021",51,28,23,418870.6,4234.059,102.2157
"25418","74138","2021",22,12,10,336041.9,3394.818,104.7273
"25419","74139","2021",14,13,1,343705,2944.429,120.8571
"25420","74140","2021",55,21,34,184166.3,2789.945,62.4
"25421","74141","2021",13,12,1,337981.2,3147.154,115.7692
"25422","74142","2021",8,7,1,410316.1,3632.625,120.375
"25423","74143","2021",128,39,89,412656.7,5838.242,72.78906
"25424","74144","2021",11,9,2,418302.8,3636.727,118.5455
"25425","74145","2021",9,7,2,480337.8,3912,124.1111
"25426","74146","2021",23,18,5,354870,3395.261,106.2609
"25427","74147","2021",12,7,5,441124.8,3845.75,124.5833
"25428","74148","2021",3,0,3,114033.3,2500.333,47
"25429","74150","2021",26,22,4,431462.7,4152.346,111.8846
"25430","74151","2021",2,2,0,317425,3013.5,105.5
"25431","74152","2021",14,8,6,455954.6,4635.643,95.28571
"25432","74153","2021",20,14,6,369791,4057.45,94.75
"25433","74154","2021",54,39,15,374340.4,4013.37,90.2963
"25434","74155","2021",18,15,3,201238.3,2743.778,76.27778
"25435","74156","2021",10,10,0,365097,3593.9,112.5
"25436","74157","2021",14,13,1,389615,3451.643,118.9286
"25437","74158","2021",12,7,5,394775,4033.333,103
"25438","74159","2021",50,23,27,190027.8,2652.76,83.92
"25439","74160","2021",46,8,38,187773.8,5231.217,34.3913
"25440","74161","2021",15,14,1,376907.3,3596.867,111.0667
"25441","74162","2021",8,6,2,452815.6,4008.25,118.875
"25442","74163","2021",23,19,4,377481.7,3864.957,99.43478
"25443","74164","2021",70,27,43,237780.5,2956.671,81.65714
"25444","74165","2021",6,4,2,379555,3017.833,130.6667
"25445","74166","2021",19,12,7,291049.8,3017.737,99
"25446","74167","2021",11,8,3,264095.5,3404.727,85.81818
"25447","74168","2021",21,15,6,366651.9,4024.476,95
"25448","74169","2021",78,41,37,255550.5,2755.282,93.79487
"25449","74170","2021",5,5,0,232816,2568.4,94.6
"25450","74171","2021",22,20,2,475979.4,4387.591,108.8182
"25451","74172","2021",32,19,13,357531.1,3816.5,93.4375
"25452","74173","2021",265,37,228,712936.9,8335.883,78.07925
"25453","74174","2021",7,7,0,303415.1,4320.571,81.42857
"25454","74175","2021",6,1,5,160108.3,2392,61.83333
"25455","74176","2021",29,13,16,804659.3,7271.31,104.8276
"25456","74177","2021",10,8,2,527464,4097.3,138.6
"25457","74178","2021",7,7,0,301065.6,3182.714,105.7143
"25458","74179","2021",7,7,0,288242.7,2980.714,96.14286
"25459","74180","2021",38,32,6,566257.1,4660.605,121.8158
"25460","74183","2021",41,14,27,208781.5,3345.341,65.04878
"25461","74184","2021",11,8,3,374259.1,3642.818,105.1818
"25462","74185","2021",30,21,9,343330.4,3621.033,96.26667
"25463","74186","2021",7,7,0,515068.9,4612.143,113.8571
"25464","74188","2021",34,14,20,531783.7,5953.618,78.38235
"25465","74189","2021",63,17,46,132584,2533.429,48.98413
"25466","74190","2021",123,9,114,165676.5,3872.797,42.96748
"25467","74191","2021",274,36,238,365957,6609.573,54.77007
"25468","74192","2021",12,12,0,248333.3,3142.25,89
"25469","74193","2021",11,7,4,290993.2,3603.909,85.27273
"25470","74194","2021",4,3,1,303860,3206.75,101.25
"25471","74195","2021",3,3,0,342700,3064.333,112
"25472","74196","2021",7,7,0,211622.9,2619.857,79.14286
"25473","74197","2021",29,11,18,261707,3150.276,83.82759
"25474","74198","2021",6,3,3,520166.7,5235.333,98.66667
"25475","74199","2021",14,10,4,716552.9,5192.5,136.4286
"25476","74200","2021",52,32,20,438786.2,4560.577,98.94231
"25477","74201","2021",26,15,11,518552.7,4661.846,113.5385
"25478","74202","2021",4,3,1,312127.8,3636.5,86.25
"25479","74203","2021",2,2,0,155000,2426,72
"25480","74205","2021",34,15,19,204878.8,3477.147,58.73529
"25481","74206","2021",6,5,1,277766.7,2475.167,117.1667
"25482","74208","2021",183,69,114,248021.3,3287.137,77.56831
"25483","74209","2021",11,11,0,464202.7,3665.455,128.7273
"25484","74210","2021",31,20,11,297678.4,3717.613,86.74194
"25485","74211","2021",19,16,3,445536.8,3561.158,124.5789
"25486","74212","2021",31,24,7,270228.4,3392.387,82.32258
"25487","74213","2021",109,32,77,376805,4695.633,81.19266
"25488","74215","2021",124,11,113,216347.4,4653.202,42.08065
"25489","74216","2021",7,1,6,408295,5083,78.14286
"25490","74218","2021",129,62,67,366980.9,4180.403,87.76744
"25491","74219","2021",7,3,4,341369.1,4790.857,83
"25492","74220","2021",72,23,49,294191.2,3766.014,80.09722
"25493","74221","2021",3,1,2,84833.33,2011.333,43.33333
"25494","74222","2021",9,6,3,284444.4,2855,99.22222
"25495","74223","2021",11,10,1,325295.4,3444.273,108.8182
"25496","74224","2021",163,35,128,257012.9,3426.417,75.59509
"25497","74225","2021",188,42,146,200029,3024.936,68.22872
"25498","74226","2021",5,5,0,357084,4233.4,87.4
"25499","74228","2021",2,2,0,435500,2902,145.5
"25500","74229","2021",31,25,6,393916.4,4019.258,99.29032
"25501","74231","2021",5,5,0,341752,3540.2,103.2
"25502","74232","2021",8,5,3,507913.1,4653.75,119.125
"25503","74233","2021",22,11,11,272200.4,3329.864,83.77273
"25504","74234","2021",6,5,1,242105.3,3729.833,67.5
"25505","74235","2021",8,8,0,426351.2,3469.875,128.125
"25506","74236","2021",291,63,228,280613.5,4368.567,59.69072
"25507","74237","2021",16,7,9,212803.1,3387.812,63.4375
"25508","74238","2021",96,28,68,220234.2,3798.552,54.8125
"25509","74239","2021",24,7,17,358094.6,4752,72.375
"25510","74240","2021",12,11,1,320165.8,3974.667,82.08333
"25511","74241","2021",60,20,40,178030.6,2620.45,67.75
"25512","74242","2021",66,27,39,478791.6,5156.455,91.69697
"25513","74243","2021",200,27,173,349120,4437.9,78.39
"25514","74244","2021",9,8,1,281537.8,3665.556,78.88889
"25515","74249","2021",41,32,9,357728.9,3618.268,108.561
"25516","74250","2021",124,58,66,296580.3,3515.21,86.82258
"25517","74252","2021",8,7,1,385821.8,4418.25,105.125
"25518","74253","2021",9,9,0,380907.8,4029,98.66667
"25519","74254","2021",1,1,0,330000,2409,137
"25520","74255","2021",23,19,4,305726.1,3293.043,93.91304
"25521","74256","2021",313,51,262,212199.1,3215.923,65.85304
"25522","74257","2021",6,6,0,550704.7,3605,163.6667
"25523","74258","2021",209,46,163,258668.9,4718.842,55.41148
"25524","74259","2021",8,8,0,306203.8,3395.875,89.875
"25525","74260","2021",2,2,0,158927.5,1882,78
"25526","74261","2021",8,8,0,306687.4,4465.375,74.75
"25527","74262","2021",14,10,4,340750,3312.5,101.2143
"25528","74263","2021",115,78,37,374717.2,3969.217,95.4
"25529","74264","2021",121,58,63,216324.7,2602.992,83.77686
"25530","74265","2021",9,7,2,270945.7,3909.111,74.33333
"25531","74266","2021",24,10,14,327133.5,5223.958,62.16667
"25532","74267","2021",47,17,30,524104.8,5518.043,97.14894
"25533","74269","2021",32,22,10,274114.1,3026.188,100.5625
"25534","74271","2021",7,6,1,508097,5629.857,97.71429
"25535","74272","2021",51,28,23,423844.9,4405.863,97.45098
"25536","74273","2021",14,10,4,267076.4,3850.214,76.85714
"25537","74275","2021",29,9,20,451179.5,5265.759,75.27586
"25538","74276","2021",96,37,59,228250.6,4003.562,59.39583
"25539","74278","2021",94,43,51,254412.9,3085.628,82.51064
"25540","74279","2021",83,13,70,133992.1,3174.723,41.04819
"25541","74280","2021",60,18,42,302581.2,3888.1,79.56667
"25542","74281","2021",747,95,652,225609.7,3360.806,66.917
"25543","74282","2021",77,51,26,447621,4205.662,110.6883
"25544","74283","2021",9,7,2,300934.4,3142.333,93.11111
"25545","74284","2021",16,6,10,200978.1,2925.375,63.625
"25546","74285","2021",4,4,0,412250,3805.5,133
"25547","74286","2021",11,8,3,208120.9,2808.455,75
"25548","74287","2021",6,5,1,338377,5549.333,84.5
"25549","74288","2021",79,24,55,312311.6,3707.38,84.3038
"25550","74289","2021",25,19,6,276422.8,2843.84,106.16
"25551","74290","2021",11,5,6,400751.5,5835.364,65.81818
"25552","74291","2021",3,2,1,262333.3,3143.333,95
"25553","74292","2021",8,8,0,520221.2,4286.875,134.625
"25554","74293","2021",100,49,51,438303.1,4349.77,99.3
"25555","74294","2021",14,11,3,475013.1,5480.357,87.28571
"25556","74295","2021",3,3,0,355066.7,4274.667,95
"25557","74296","2021",22,12,10,350864.7,4071.545,88.36364
"25558","74297","2021",9,9,0,332778.7,3162.667,110.4444
"25559","74298","2021",103,40,63,355810.5,3997.796,86.25243
"25560","74299","2021",38,22,16,1024843,7938.868,123.2368
"25561","74301","2021",11,5,6,221934,2734.364,80.09091
"25562","74302","2021",15,9,6,319590.7,4365.867,73.26667
"25563","74303","2021",26,18,8,493777.3,4979.462,102.9231
"25564","74304","2021",14,8,6,301605.1,3139.143,102.3571
"25565","74305","2021",103,25,78,293190,3812.252,75.75728
"25566","74306","2021",3,3,0,312175,2692.333,128.6667
"25567","74307","2021",7,2,5,368968.7,4148.429,86
"25568","74308","2021",13,13,0,343750.5,3918.077,100.9231
"25569","74309","2021",71,42,29,426996.9,4341.859,102.8169
"25570","74310","2021",8,4,4,374406.2,4213.25,89.375
"25571","74311","2021",63,28,35,257464.1,3197.746,76.98413
"25572","74312","2021",13,12,1,327730.4,2967.846,110.2308
"25573","74313","2021",8,4,4,304561.2,3842.5,81.75
"25574","74314","2021",20,14,6,314666.3,3738.75,85.75
"25575","74315","2021",14,11,3,433128.6,4598.429,103.2143
"25576","75056","2021",28505,82,28423,550317.5,10453.34,52.36611
"25577","76001","2021",8,8,0,170343.8,1595.25,104
"25578","76002","2021",7,7,0,198300,2169.429,97.42857
"25579","76004","2021",5,5,0,208060,1924.6,105.6
"25580","76005","2021",54,43,11,164119.8,2025.5,83.05556
"25581","76006","2021",2,2,0,256700,2594.5,111
"25582","76007","2021",6,6,0,257875,1830,141.6667
"25583","76008","2021",5,5,0,125300,1384.2,98.8
"25584","76009","2021",3,3,0,160333.3,1652,100.3333
"25585","76010","2021",1,1,0,105000,1382,76
"25586","76011","2021",4,4,0,130250,2052,64
"25587","76012","2021",5,5,0,216200,1652,127.2
"25588","76013","2021",7,7,0,135928.6,1368.571,105.2857
"25589","76014","2021",21,21,0,227623.8,2694.714,92.28571
"25590","76015","2021",9,9,0,275969.3,2706,109.7778
"25591","76016","2021",3,3,0,182833.3,1617,114.3333
"25592","76017","2021",1,1,0,140000,933,150
"25593","76018","2021",18,17,1,158027.8,1668.556,96.44444
"25594","76019","2021",1,1,0,254170,1033,246
"25595","76020","2021",19,19,0,181402.6,1756.632,106.8947
"25596","76021","2021",9,9,0,164222.2,1847.889,91.55556
"25597","76022","2021",3,3,0,212050,1936.333,110.3333
"25598","76023","2021",3,3,0,176333.3,1671,114.6667
"25599","76024","2021",3,3,0,227100,2412.333,101
"25600","76025","2021",9,9,0,144442.2,1605.333,93.44444
"25601","76026","2021",45,34,11,162680.1,1816.778,92.08889
"25602","76028","2021",1,1,0,123800,1317,94
"25603","76029","2021",2,2,0,174000,1932.5,91.5
"25604","76030","2021",5,5,0,203686,1974.4,100.8
"25605","76032","2021",3,3,0,147400,1363.333,104.3333
"25606","76033","2021",6,6,0,268011.7,2018.333,137.6667
"25607","76034","2021",29,28,1,160366.8,1637.138,98.82759
"25608","76035","2021",30,30,0,113575,1177.867,100.7667
"25609","76036","2021",10,10,0,166810,1951.5,89.1
"25610","76038","2021",2,2,0,253245,2393.5,106.5
"25611","76039","2021",11,11,0,308300,2000.455,152.3636
"25612","76040","2021",2,2,0,165000,2253,71
"25613","76041","2021",14,14,0,199986.8,1980.857,103.9286
"25614","76042","2021",1,1,0,238600,1835,130
"25615","76043","2021",11,11,0,214095.5,2075.091,103.7273
"25616","76045","2021",2,2,0,234500,1538.5,155
"25617","76046","2021",10,10,0,252980,2222.3,117.6
"25618","76048","2021",4,4,0,183750,1543.75,107
"25619","76049","2021",7,7,0,123600,1489,89.28571
"25620","76050","2021",18,18,0,174935.1,1690.556,106.8889
"25621","76051","2021",15,15,0,156610,1482.6,104.3333
"25622","76053","2021",2,2,0,138750,2094,67.5
"25623","76054","2021",7,7,0,145714.3,1647.714,91.57143
"25624","76055","2021",4,4,0,215562.5,2024.5,106
"25625","76056","2021",12,12,0,211818.3,2043.167,106.1667
"25626","76057","2021",106,96,10,187185.7,2044.179,93.57547
"25627","76058","2021",2,2,0,157000,1752,87.5
"25628","76059","2021",4,4,0,131537.5,1314.5,99.5
"25629","76060","2021",6,6,0,109591.8,1192.833,97.33333
"25630","76062","2021",3,3,0,126333.3,1457.667,92.66667
"25631","76063","2021",10,10,0,188914.9,1800.7,106.7
"25632","76064","2021",9,9,0,257111.1,2230.889,116.8889
"25633","76065","2021",9,9,0,147761.1,2166.667,73.66667
"25634","76066","2021",2,2,0,197000,1590,124.5
"25635","76067","2021",12,12,0,172852.5,1802.25,104.75
"25636","76068","2021",16,16,0,168130.6,1639.562,102.1875
"25637","76069","2021",20,20,0,381315.3,2738.65,142.15
"25638","76070","2021",11,11,0,112636.4,1268.818,89.63636
"25639","76071","2021",11,11,0,187922.7,1813.727,108
"25640","76072","2021",11,11,0,207851.6,1702.091,124.6364
"25641","76074","2021",1,1,0,242000,2262,107
"25642","76075","2021",4,4,0,186600,1680.75,117.5
"25643","76076","2021",7,7,0,147571.4,1917.429,86.57143
"25644","76077","2021",4,4,0,275150,1616.75,154.75
"25645","76079","2021",1,1,0,330000,3173,104
"25646","76082","2021",8,8,0,216900,1890.375,117.75
"25647","76083","2021",1,1,0,190000,1086,175
"25648","76084","2021",2,2,0,131500,1738,72.5
"25649","76085","2021",4,4,0,179625,1446.75,124.75
"25650","76086","2021",3,3,0,98633.33,1109.667,86.66667
"25651","76087","2021",10,10,0,159750,1685.3,101
"25652","76088","2021",7,7,0,185757.1,1736,107.2857
"25653","76090","2021",18,18,0,199427.8,2006.889,100.5556
"25654","76091","2021",1,1,0,212150,1929,110
"25655","76092","2021",12,12,0,164641.7,1874.417,92
"25656","76093","2021",5,5,0,158200,1643.2,91
"25657","76094","2021",3,3,0,193466.7,1996.333,96
"25658","76095","2021",122,59,63,209978,2196.148,90.61475
"25659","76096","2021",10,10,0,182845,1848.6,104.8
"25660","76097","2021",2,2,0,185300,1865,99.5
"25661","76099","2021",6,6,0,212666.7,1808,124.1667
"25662","76100","2021",13,13,0,287462.5,2057.308,144.3077
"25663","76101","2021",40,39,1,139060.2,1458.325,97.65
"25664","76103","2021",100,41,59,208884,2423.84,87.14
"25665","76104","2021",4,4,0,206705,2022,103.5
"25666","76105","2021",10,10,0,194050,1842.6,114.9
"25667","76106","2021",5,5,0,241366,2402.8,103
"25668","76107","2021",5,5,0,159240,1518.4,109.8
"25669","76108","2021",252,128,124,289247.2,3015.643,96.36905
"25670","76109","2021",1,1,0,179680,1536,117
"25671","76110","2021",2,2,0,292500,1915.5,151
"25672","76111","2021",6,6,0,247000,1906.833,131
"25673","76112","2021",2,2,0,201250,2014,100
"25674","76113","2021",3,3,0,196333.3,1689.333,115.3333
"25675","76114","2021",186,150,36,105087.4,1399.027,77.51075
"25676","76115","2021",8,8,0,202073.8,1976.375,104.625
"25677","76116","2021",42,41,1,249024,2395.5,104.2857
"25678","76117","2021",9,9,0,246444.4,2473.111,99.22222
"25679","76118","2021",3,3,0,249666.7,1982.667,126
"25680","76119","2021",1,1,0,207000,2226,93
"25681","76120","2021",4,4,0,154177.5,1201.25,139.75
"25682","76121","2021",8,8,0,170168.8,1582.625,111.75
"25683","76122","2021",5,5,0,107920,1148.4,99.6
"25684","76123","2021",14,14,0,294917.9,2341.143,132.5
"25685","76124","2021",5,5,0,161200,1534.6,111.4
"25686","76125","2021",21,20,1,158850,2040.952,80.42857
"25687","76126","2021",5,5,0,180180,2305.2,76.4
"25688","76128","2021",9,9,0,177322.2,1690.667,97.77778
"25689","76129","2021",2,2,0,156500,1685.5,91.5
"25690","76130","2021",2,2,0,365050,1656,219.5
"25691","76131","2021",18,13,5,228680.6,1907.056,118
"25692","76132","2021",6,6,0,125333.3,1477.167,89.16667
"25693","76133","2021",9,9,0,193922.2,1887.222,96.77778
"25694","76134","2021",6,6,0,156000,1575.333,99.83333
"25695","76135","2021",8,8,0,163200,1512.125,108
"25696","76136","2021",13,13,0,142864.2,1705.231,90.07692
"25697","76138","2021",8,8,0,178312.5,1655,110.75
"25698","76139","2021",2,2,0,177450,2128,82
"25699","76140","2021",3,3,0,158900,2095,78.33333
"25700","76141","2021",16,16,0,155067.5,2048.625,80.375
"25701","76142","2021",6,6,0,190275,1755,115.8333
"25702","76143","2021",13,13,0,170769.2,1950.846,93.30769
"25703","76144","2021",5,5,0,228840,1617.4,143.2
"25704","76146","2021",34,33,1,158932.4,2024,87.67647
"25705","76147","2021",17,17,0,172600,1716,107.1765
"25706","76148","2021",6,6,0,112133.3,1144.5,105.1667
"25707","76149","2021",5,5,0,254990,2004.8,128.4
"25708","76151","2021",3,3,0,174333.3,1837.333,94.66667
"25709","76152","2021",9,9,0,170300,1435.222,130.6667
"25710","76153","2021",1,1,0,236000,1595,148
"25711","76154","2021",4,4,0,114750,1843.75,67.25
"25712","76155","2021",5,5,0,97780,1604.4,64.4
"25713","76156","2021",7,7,0,164421.4,1982.571,85.42857
"25714","76157","2021",98,43,55,141454.7,1842.316,77.32653
"25715","76158","2021",7,7,0,197714.3,1902.286,103.7143
"25716","76159","2021",59,57,2,150909.4,1636.797,96.50847
"25717","76160","2021",5,5,0,210200,2219,97.6
"25718","76161","2021",3,3,0,287333.3,1620.333,178.3333
"25719","76162","2021",8,8,0,194020.1,2044.25,97.625
"25720","76163","2021",8,8,0,194012.5,2169.875,91.875
"25721","76164","2021",55,40,15,156051.2,1862.509,84.98182
"25722","76165","2021",116,82,34,131278.3,1506.75,86.02586
"25723","76166","2021",3,3,0,174568,1529,118.3333
"25724","76167","2021",18,18,0,277827.8,2380.167,120.3889
"25725","76169","2021",13,13,0,254503.8,2282,111
"25726","76170","2021",3,3,0,151000,1809.667,84
"25727","76172","2021",6,6,0,223951,1421.667,157.3333
"25728","76173","2021",3,3,0,143166.7,1746,81.66667
"25729","76174","2021",4,4,0,186250,1757.25,112.5
"25730","76175","2021",2,2,0,87500,1382,57
"25731","76176","2021",2,2,0,169000,1555.5,110.5
"25732","76177","2021",5,5,0,228752,2069.6,111.8
"25733","76178","2021",39,36,3,160992.2,1862.974,88.5641
"25734","76179","2021",19,18,1,185958.9,1871.263,98.47368
"25735","76180","2021",4,4,0,270400,1659.75,166.25
"25736","76181","2021",1,1,0,130433,1499,87
"25737","76182","2021",1,1,0,75000,852,88
"25738","76183","2021",11,11,0,173300,1727,100.1818
"25739","76184","2021",2,2,0,214500,1912.5,119.5
"25740","76185","2021",1,1,0,111000,1233,90
"25741","76186","2021",6,6,0,115654.2,1392.5,80.5
"25742","76187","2021",3,3,0,125000,1117,119.3333
"25743","76189","2021",3,3,0,209166.7,2352.333,98
"25744","76190","2021",4,4,0,198800,2476.25,82.5
"25745","76192","2021",88,70,18,151513.7,2080.398,80.27273
"25746","76193","2021",4,4,0,153375,1586.5,102.25
"25747","76194","2021",4,4,0,172400,1888,93.25
"25748","76195","2021",3,3,0,145283.3,1226.667,146
"25749","76196","2021",3,3,0,410000,2270.333,186
"25750","76197","2021",1,1,0,140000,1359,103
"25751","76198","2021",9,9,0,180240,1830.778,100.2222
"25752","76199","2021",17,17,0,163941.2,1586.882,105.8824
"25753","76200","2021",1,1,0,42200,534,79
"25754","76201","2021",7,7,0,159248.6,1527,106.5714
"25755","76202","2021",5,5,0,125477,1500,85.8
"25756","76203","2021",3,3,0,139333.3,1532.333,98
"25757","76204","2021",3,3,0,176166.7,1699,99.33333
"25758","76205","2021",4,4,0,152500,1630,96.25
"25759","76206","2021",12,12,0,212425,2185.417,103.25
"25760","76207","2021",4,4,0,133912.5,1814,78.25
"25761","76208","2021",8,8,0,211193.8,1985.125,115
"25762","76209","2021",6,6,0,154750,1746.5,101.6667
"25763","76210","2021",9,9,0,126627.8,1942.222,69.55556
"25764","76211","2021",5,5,0,153200,1419.6,102.8
"25765","76212","2021",105,78,27,153330.1,2064.781,75.28571
"25766","76213","2021",7,7,0,172714.3,1693.857,107.7143
"25767","76214","2021",4,4,0,159812.5,1359,120.75
"25768","76216","2021",154,73,81,140009.7,1923.922,73.68182
"25769","76217","2021",547,184,363,135373.2,2002.618,67.91956
"25770","76218","2021",3,3,0,162166.7,1691.667,94.33333
"25771","76219","2021",47,44,3,141222.2,1604.702,88.61702
"25772","76220","2021",3,3,0,256333.3,2137,125
"25773","76221","2021",5,5,0,203150,1963.2,114.2
"25774","76222","2021",38,31,7,184150,1910.5,99.71053
"25775","76223","2021",7,7,0,166042.9,1833.286,94.42857
"25776","76224","2021",20,20,0,222578.5,2370.4,102.6
"25777","76225","2021",10,10,0,200608.3,1992.2,102.9
"25778","76226","2021",2,2,0,145000,1607,90.5
"25779","76227","2021",12,12,0,187240,1944.75,98.58333
"25780","76228","2021",4,4,0,251000,1916.5,137
"25781","76229","2021",3,3,0,312543.3,2241,141.3333
"25782","76230","2021",2,2,0,222600,2021.5,110
"25783","76231","2021",142,68,74,120718.8,1538.162,79.88732
"25784","76232","2021",8,8,0,129912.5,1527.625,84.875
"25785","76233","2021",3,3,0,152333.3,1173.333,114.6667
"25786","76234","2021",7,7,0,199810.7,1833.857,113.1429
"25787","76235","2021",18,18,0,147468.2,1501.611,101.7222
"25788","76236","2021",6,6,0,142000,1626.167,93.5
"25789","76237","2021",5,5,0,187100,2126,90.4
"25790","76238","2021",34,33,1,214050.9,2564.088,93.38235
"25791","76239","2021",10,10,0,258465,2460.6,107.7
"25792","76240","2021",14,14,0,184092.1,1927.429,102.7143
"25793","76241","2021",2,2,0,206000,1887.5,100
"25794","76242","2021",4,4,0,224375,2366,96
"25795","76243","2021",3,3,0,198666.7,2100.667,102.6667
"25796","76244","2021",4,4,0,327500,1459.75,208.25
"25797","76245","2021",15,15,0,218215.5,2344.467,96.86667
"25798","76247","2021",4,4,0,262250,1942,136.25
"25799","76249","2021",16,16,0,182921.9,1661.188,116.5625
"25800","76250","2021",17,17,0,216214.5,2163.235,106.2941
"25801","76251","2021",4,4,0,130250,1109.5,124.75
"25802","76252","2021",10,10,0,150265,1544.1,100.7
"25803","76253","2021",7,7,0,216390.7,1736.286,125.7143
"25804","76254","2021",43,30,13,231621.4,2704.907,91.62791
"25805","76255","2021",122,91,31,135113.7,1579.303,84.04098
"25806","76257","2021",3,3,0,52333.33,640,81.66667
"25807","76258","2021",44,41,3,171575.1,1825.455,95.59091
"25808","76259","2021",357,244,113,151970.3,1978.832,77.42297
"25809","76260","2021",24,23,1,151208.3,1821.833,86.625
"25810","76261","2021",6,6,0,237583.3,1606.5,135
"25811","76262","2021",1,1,0,74000,1088,68
"25812","76263","2021",16,15,1,198771.9,1880.375,111.75
"25813","76264","2021",8,8,0,178506.2,2062.125,89.625
"25814","76265","2021",2,2,0,80000,723,109
"25815","76266","2021",5,5,0,195480,2076.6,98.4
"25816","76268","2021",3,3,0,186841.7,2281.667,88.66667
"25817","76269","2021",2,2,0,194500,1360.5,143
"25818","76270","2021",30,30,0,333761.7,3099.767,113.5333
"25819","76271","2021",23,23,0,194032.2,1946.043,99.65217
"25820","76272","2021",11,11,0,161009.3,2098.818,81.63636
"25821","76273","2021",9,9,0,351122.2,2530.889,140.4444
"25822","76275","2021",16,16,0,326103.8,2856.375,123.5625
"25823","76276","2021",56,50,6,143744.6,1494.571,101.3929
"25824","76278","2021",8,7,1,98762.5,1188.5,93.75
"25825","76279","2021",5,5,0,174900,1415.8,134.4
"25826","76280","2021",1,1,0,105000,1400,75
"25827","76281","2021",31,31,0,198359.7,2147.065,95.25806
"25828","76282","2021",16,16,0,199368.8,1800.938,105.25
"25829","76283","2021",1,1,0,142600,2037,70
"25830","76284","2021",1,1,0,174000,1611,108
"25831","76285","2021",6,6,0,271731.7,2264.833,118.6667
"25832","76286","2021",6,6,0,135000,1475,93.16667
"25833","76287","2021",10,10,0,236380.1,1903,123.2
"25834","76288","2021",4,4,0,134125,1608.5,84
"25835","76289","2021",14,14,0,176400,2080.857,94.35714
"25836","76290","2021",3,3,0,212666.7,2023.333,117.3333
"25837","76291","2021",16,15,1,191888,1937.938,100.375
"25838","76292","2021",2,2,0,221375,2031,103.5
"25839","76293","2021",2,2,0,72500,659,110
"25840","76294","2021",6,6,0,201470,2121.667,101.1667
"25841","76295","2021",13,13,0,182795.1,1880.923,98.46154
"25842","76296","2021",18,17,1,215676.1,2114.611,102.5
"25843","76297","2021",4,4,0,298500,2009.75,136.5
"25844","76298","2021",9,9,0,214772.2,2116.667,109.1111
"25845","76299","2021",3,3,0,174500,1785.333,97.33333
"25846","76300","2021",8,8,0,177137.5,1599.125,107.625
"25847","76302","2021",1,1,0,227000,1974,115
"25848","76303","2021",11,11,0,232536.4,1943.455,118.8182
"25849","76304","2021",4,4,0,202797.5,2077.5,113
"25850","76305","2021",69,62,7,176305.8,2328.478,79.82609
"25851","76306","2021",4,4,0,169850,1702.75,100
"25852","76307","2021",19,17,2,193841.7,2358.632,88
"25853","76308","2021",6,6,0,176093.3,1357.333,137.6667
"25854","76309","2021",4,4,0,194250,1723.75,112.75
"25855","76311","2021",1,1,0,166000,2024,82
"25856","76312","2021",80,68,12,133805.1,1556.688,88.225
"25857","76313","2021",12,11,1,195987.5,2026.167,99.25
"25858","76314","2021",5,5,0,166480,1543.6,114.6
"25859","76315","2021",12,12,0,136266.7,1645.5,85.66667
"25860","76316","2021",2,2,0,207875,2791,78
"25861","76317","2021",6,6,0,230827,1902.833,144.6667
"25862","76318","2021",3,3,0,167666.7,1652.333,100.3333
"25863","76319","2021",90,88,2,197109,2189.589,93.62222
"25864","76320","2021",10,10,0,87920,1089.3,87.4
"25865","76321","2021",22,21,1,163667.5,1995.045,87.22727
"25866","76322","2021",178,121,57,187383.8,2377.056,80.82022
"25867","76323","2021",3,3,0,113000,1421.667,80.33333
"25868","76324","2021",7,7,0,284120.7,1988,146.1429
"25869","76325","2021",9,9,0,186322.2,1651.333,117.6667
"25870","76327","2021",4,4,0,238725,1895.75,134.5
"25871","76328","2021",6,6,0,219916.7,2307.333,96.5
"25872","76329","2021",30,24,6,153210.1,1875.9,83.96667
"25873","76330","2021",11,11,0,195575.6,1631.273,120.1818
"25874","76331","2021",6,6,0,167833.3,1784.333,97.33333
"25875","76332","2021",6,6,0,107666.7,1142.333,91.16667
"25876","76333","2021",1,1,0,220000,1833,120
"25877","76334","2021",8,8,0,171790.5,1537.5,109.125
"25878","76335","2021",1,1,0,150000,1282,117
"25879","76336","2021",12,12,0,249704.2,2241.25,113.8333
"25880","76338","2021",6,6,0,156000.8,1345.667,126.6667
"25881","76339","2021",1,1,0,187000,1798,104
"25882","76340","2021",6,6,0,161100,1781.667,92.33333
"25883","76341","2021",97,72,25,172783,2278.01,77.79381
"25884","76342","2021",6,6,0,141738.3,1162,116
"25885","76343","2021",2,2,0,88500,1267.5,71
"25886","76344","2021",6,6,0,115666.7,1043,119.1667
"25887","76345","2021",8,8,0,190525,1459.625,149.75
"25888","76346","2021",2,2,0,102500,1075,97
"25889","76347","2021",2,2,0,191000,1405.5,153.5
"25890","76348","2021",12,11,1,166395.8,1731.333,96.33333
"25891","76349","2021",21,21,0,219437.5,2169.857,104
"25892","76350","2021",8,8,0,183881.2,2022.375,98.5
"25893","76351","2021",3033,1006,2027,155376.2,2271.3,68.37916
"25894","76352","2021",4,4,0,174075,1871.25,94
"25895","76353","2021",2,2,0,88000,1107.5,72
"25896","76354","2021",11,11,0,316328.2,2255.273,132.5455
"25897","76355","2021",14,14,0,236407.1,2321.286,92.78571
"25898","76356","2021",2,2,0,57700,747.5,76.5
"25899","76357","2021",10,10,0,216689,2146.8,106.3
"25900","76358","2021",5,5,0,114810,1288,83.8
"25901","76359","2021",1,1,0,150000,1071,140
"25902","76360","2021",5,5,0,103800,1445,73.8
"25903","76361","2021",6,6,0,235450,2271,97.16667
"25904","76362","2021",8,8,0,178843.8,1863.875,104.875
"25905","76363","2021",5,5,0,95900,1281,76
"25906","76364","2021",6,6,0,167440,1800.833,99.66667
"25907","76365","2021",2,2,0,159500,1831.5,87
"25908","76366","2021",67,61,6,149182.8,1841.313,81.1194
"25909","76367","2021",28,27,1,270477.4,2326.179,117.3571
"25910","76369","2021",5,5,0,227100,1823,125.2
"25911","76370","2021",6,6,0,244975,1886.167,131.6667
"25912","76371","2021",2,2,0,170495,1403.5,135
"25913","76372","2021",8,8,0,124375,1541.875,85.5
"25914","76373","2021",6,6,0,159025,1707,98.5
"25915","76374","2021",17,17,0,83648.82,1407.824,61
"25916","76375","2021",3,3,0,135333.3,1241.667,115
"25917","76377","2021",31,30,1,395895.2,2866.645,139.4194
"25918","76378","2021",15,14,1,205293.3,1986.667,114.4
"25919","76379","2021",2,2,0,208500,1875.5,105.5
"25920","76380","2021",6,6,0,145000,1785.333,83.66667
"25921","76381","2021",2,2,0,142500,1903,75
"25922","76382","2021",25,25,0,148222.4,1731.88,83.76
"25923","76384","2021",120,103,17,133486.2,1651.433,84.33333
"25924","76385","2021",13,13,0,189474.2,1879.385,105.5385
"25925","76386","2021",4,4,0,245205,1757,141
"25926","76387","2021",10,10,0,162620,1545.2,105.9
"25927","76388","2021",8,8,0,176391.2,2226.25,87.125
"25928","76389","2021",1,1,0,219000,2047,107
"25929","76390","2021",20,20,0,192425,2106.55,101.2
"25930","76391","2021",27,27,0,229520.4,2042.778,118.5185
"25931","76392","2021",15,15,0,128593.3,1373.333,99
"25932","76394","2021",9,9,0,151542.7,1680.556,89.11111
"25933","76395","2021",8,8,0,173945.6,2643.75,79.5
"25934","76396","2021",5,5,0,147620,1769.4,87.4
"25935","76397","2021",10,7,3,219758.6,2007.1,95.4
"25936","76398","2021",17,17,0,234182.4,2315.647,104.2941
"25937","76399","2021",5,5,0,103400,1115.4,101.4
"25938","76400","2021",26,24,2,204452.4,1928.654,111.1923
"25939","76401","2021",35,35,0,180447.1,1755.057,106.0286
"25940","76402","2021",68,65,3,198150,2007.338,99.44118
"25941","76403","2021",7,7,0,210857.1,2006.571,109.7143
"25942","76404","2021",23,23,0,215842.8,2104.652,104.9565
"25943","76405","2021",2,2,0,111000,1656,82
"25944","76406","2021",11,4,7,120644.1,1501.545,68.45455
"25945","76407","2021",8,8,0,251787.5,2314.5,111
"25946","76408","2021",22,22,0,161726.4,1891.045,95.5
"25947","76409","2021",11,11,0,236927.3,2406.455,99.45455
"25948","76410","2021",117,52,65,117707,1544.556,75.13675
"25949","76411","2021",3,3,0,150766.7,1945.333,114
"25950","76412","2021",13,13,0,178471.6,1667.231,111.3077
"25951","76413","2021",5,5,0,133400,1507.2,87
"25952","76414","2021",18,18,0,241066.7,1924.556,130.9444
"25953","76415","2021",4,4,0,133750,1438.5,105.5
"25954","76416","2021",1,1,0,80000,672,119
"25955","76417","2021",2,2,0,109750,1307,73.5
"25956","76418","2021",10,10,0,172032,1729.3,106.7
"25957","76419","2021",3,3,0,198766.7,1366.667,126.6667
"25958","76420","2021",6,6,0,233475,2105.5,109.6667
"25959","76421","2021",16,16,0,197408.9,1828.688,110.25
"25960","76422","2021",4,4,0,43975,842.75,49.75
"25961","76423","2021",5,5,0,223049.6,3816.2,69.8
"25962","76424","2021",3,3,0,175050,1471,120
"25963","76425","2021",6,6,0,166125,2274,84.33333
"25964","76426","2021",6,6,0,143258.3,1868.167,70
"25965","76427","2021",10,10,0,135733.9,1517.6,91.2
"25966","76429","2021",95,75,20,265144.6,2950.568,96.78947
"25967","76430","2021",3,3,0,147666.7,1365,114
"25968","76431","2021",2,2,0,175000,1752.5,100
"25969","76432","2021",5,5,0,171000,1387.8,125.8
"25970","76433","2021",4,4,0,253650,2192.75,128.5
"25971","76434","2021",17,17,0,181877.6,1715.412,107.5294
"25972","76435","2021",12,12,0,157739.3,1552,103.5833
"25973","76436","2021",8,8,0,165187.5,1938.875,81.875
"25974","76437","2021",9,9,0,151983.3,1932.778,80.22222
"25975","76438","2021",2,2,0,82500,750.5,107
"25976","76439","2021",2,2,0,287625,1980,145
"25977","76440","2021",4,4,0,217925,1752.25,119.75
"25978","76441","2021",13,13,0,126423.1,1530.846,81.38462
"25979","76442","2021",8,8,0,129057.6,1304,94.125
"25980","76443","2021",9,9,0,218407.1,1928.333,113
"25981","76445","2021",7,7,0,245000,2016.571,103.8571
"25982","76446","2021",12,12,0,310020.8,2794.25,115
"25983","76447","2021",254,192,62,209778.7,2415.031,89.66929
"25984","76448","2021",9,9,0,235838.9,2491.778,93.44444
"25985","76449","2021",10,10,0,157312.2,1392.8,112.7
"25986","76450","2021",7,7,0,166839.3,1776.286,95.57143
"25987","76451","2021",279,118,161,255184.9,2582.108,93.81362
"25988","76452","2021",48,46,2,181166.1,2009.854,91.8125
"25989","76453","2021",10,10,0,177050,1677.8,100.1
"25990","76454","2021",1,1,0,170000,567,300
"25991","76455","2021",4,4,0,127000,1553.5,80.25
"25992","76456","2021",14,14,0,179107.1,1952.643,105.7857
"25993","76457","2021",17,15,2,170635.3,1790.176,96.11765
"25994","76458","2021",2,2,0,168000,1513.5,106
"25995","76459","2021",3,3,0,122000,1187.667,103.3333
"25996","76460","2021",7,7,0,112428.6,1141.286,95.28571
"25997","76461","2021",2,2,0,133150,2010.5,66
"25998","76462","2021",48,34,14,126329,1564.542,83.3125
"25999","76463","2021",11,11,0,167113.6,1603.727,106.4545
"26000","76464","2021",19,19,0,225055.5,1928,120.0526
"26001","76465","2021",5,5,0,113760,1149,100.8
"26002","76467","2021",39,39,0,163517.4,1713.872,94.12821
"26003","76468","2021",12,12,0,178387.5,1949.75,88.25
"26004","76469","2021",4,4,0,157300,1806.5,87.75
"26005","76470","2021",10,10,0,179583.1,1769,109.2
"26006","76471","2021",15,15,0,185953.3,2010.467,97.86667
"26007","76472","2021",4,4,0,285650,2485,116.5
"26008","76473","2021",9,9,0,187944.4,2430.889,81.77778
"26009","76474","2021",65,57,8,159441.6,1984.477,82.09231
"26010","76475","2021",79,70,9,305485.5,2510.684,125.4304
"26011","76476","2021",137,128,9,159263.8,1714.708,96.17518
"26012","76477","2021",7,7,0,262614.3,2212,123.1429
"26013","76478","2021",5,5,0,153400,1290.8,116
"26014","76479","2021",5,5,0,112640,1023,110.6
"26015","76480","2021",13,13,0,186089.9,1912.615,92.69231
"26016","76481","2021",82,76,6,357227.3,2977.573,124.8293
"26017","76482","2021",28,27,1,215170.3,2065,107.5
"26018","76483","2021",11,11,0,212686.4,1576.636,133.5455
"26019","76484","2021",96,96,0,169064.3,1981.427,86.125
"26020","76485","2021",5,5,0,139000,1217.4,107.8
"26021","76486","2021",23,23,0,131923.9,1622.696,83.86957
"26022","76487","2021",2,2,0,138000,1591,85
"26023","76488","2021",4,4,0,232550,1783,126.25
"26024","76489","2021",6,6,0,220500,2526.333,92.83333
"26025","76490","2021",15,15,0,143780,1751.333,88.06667
"26026","76491","2021",13,13,0,207816.2,2084.231,107
"26027","76492","2021",7,7,0,121528.6,1520.286,83
"26028","76493","2021",3,3,0,200666.7,1322,169.3333
"26029","76494","2021",7,7,0,242100,2370,103.7143
"26030","76495","2021",60,57,3,191109.4,1805.55,101.2333
"26031","76497","2021",113,74,39,151344.4,1885.637,79.34513
"26032","76498","2021",305,189,116,127657.9,1804.77,70.32459
"26033","76499","2021",15,15,0,166532.2,1871.6,92.53333
"26034","76500","2021",8,8,0,120062.5,1391.5,90.5
"26035","76501","2021",2,2,0,461775,4579.5,137
"26036","76502","2021",3,3,0,257200,2150.333,121
"26037","76503","2021",13,10,3,220350,2010.923,109.8462
"26038","76504","2021",6,6,0,187041.7,1938.333,97
"26039","76505","2021",2,2,0,175000,1529.5,117.5
"26040","76506","2021",3,3,0,140333.3,1191.667,118
"26041","76507","2021",12,12,0,172195.8,1735,103.3333
"26042","76508","2021",9,9,0,257400,3008.111,88.44444
"26043","76509","2021",13,13,0,242684.6,2260.923,108.8462
"26044","76510","2021",4,4,0,182700,1897.25,96.75
"26045","76511","2021",2,2,0,138000,1920,72.5
"26046","76512","2021",1,1,0,57000,496,115
"26047","76513","2021",13,13,0,255693.1,2053.077,120.9231
"26048","76514","2021",13,11,2,200042.3,2194.615,91.76923
"26049","76515","2021",15,14,1,218922.9,2485.333,88.2
"26050","76516","2021",3,3,0,171833.3,1686.333,101.3333
"26051","76517","2021",27,27,0,284935.2,2449.259,122.6667
"26052","76518","2021",10,10,0,141740,1462.1,102.3
"26053","76519","2021",2,2,0,2e+05,2095,115.5
"26054","76520","2021",6,6,0,101866.7,1208.167,85.66667
"26055","76521","2021",1,1,0,152750,2092,73
"26056","76522","2021",15,15,0,208873.3,1979.067,106.4667
"26057","76523","2021",2,2,0,95500,1055.5,91
"26058","76524","2021",2,2,0,114900,1645,71.5
"26059","76526","2021",4,4,0,101740,1404.25,72.25
"26060","76527","2021",8,8,0,89750,1076,85.25
"26061","76528","2021",4,4,0,152500,1695.25,99.25
"26062","76529","2021",1,1,0,154000,1750,88
"26063","76530","2021",4,4,0,238000,2428.75,99
"26064","76531","2021",3,3,0,187000,2329.667,80.66667
"26065","76532","2021",13,13,0,205749.2,2114.077,103.4615
"26066","76533","2021",16,16,0,244837.5,2451.562,99.3125
"26067","76534","2021",12,10,2,174963.5,1932.583,90.91667
"26068","76535","2021",11,11,0,169863.6,1618.636,106.4545
"26069","76536","2021",11,11,0,231950,2412.636,100.0909
"26070","76537","2021",3,3,0,170133.3,1486.667,115.3333
"26071","76538","2021",4,4,0,189937.5,1532.25,123.75
"26072","76540","2021",2214,391,1823,161499.7,2766.269,61.05962
"26073","76541","2021",17,17,0,277094,2184.824,130.3529
"26074","76542","2021",2,2,0,324165,2240,152
"26075","76543","2021",11,11,0,218272.7,2090.727,110.3636
"26076","76544","2021",5,5,0,159132,1444.2,100
"26077","76545","2021",37,25,12,120756.8,1647.757,70.86486
"26078","76546","2021",6,6,0,129291.7,1377,93.5
"26079","76547","2021",7,7,0,271965.7,2442.571,112.4286
"26080","76548","2021",10,9,1,241410,2104.9,114.8
"26081","76549","2021",1,1,0,148000,2508,59
"26082","76550","2021",12,12,0,208929.2,2267.417,93.5
"26083","76551","2021",9,9,0,221850,2331.889,95.22222
"26084","76552","2021",126,66,60,321059.7,3355.81,94.46032
"26085","76553","2021",3,3,0,126000,1461.333,83.33333
"26086","76554","2021",7,7,0,166727.1,1595.857,110.2857
"26087","76555","2021",7,7,0,263914.3,2156.143,123.2857
"26088","76556","2021",13,13,0,187532.3,1883.462,103
"26089","76557","2021",9,9,0,203500,1981.778,105
"26090","76558","2021",10,10,0,221175,2223.6,101
"26091","76559","2021",7,7,0,190048.6,1806,115.8571
"26092","76560","2021",9,9,0,285857.7,2408.444,115.7778
"26093","76561","2021",96,60,36,129947.5,1676.104,78.89583
"26094","76562","2021",5,5,0,178680,1749.6,103.4
"26095","76563","2021",21,21,0,223347.6,2463.762,100.3333
"26096","76564","2021",9,9,0,240350,2570.444,92.88889
"26097","76565","2021",6,6,0,237533.3,1854,121.6667
"26098","76566","2021",5,5,0,176320,1769.6,103
"26099","76567","2021",5,5,0,116600,1411.4,88.6
"26100","76568","2021",9,9,0,219368.9,1818.556,127.7778
"26101","76569","2021",2,2,0,305000,2044,137.5
"26102","76570","2021",2,2,0,175000,2492.5,72
"26103","76571","2021",5,5,0,250374,2079.6,121
"26104","76572","2021",1,1,0,80000,1333,60
"26105","76573","2021",3,3,0,244666.7,2272.667,107.6667
"26106","76574","2021",6,6,0,226650,2058.333,110
"26107","76575","2021",252,213,39,162906.2,1965.032,83.18254
"26108","76576","2021",8,8,0,177861.8,1872.375,96.875
"26109","76577","2021",3,3,0,146666.7,1742,87.33333
"26110","76578","2021",5,5,0,127080,1598,89.8
"26111","76580","2021",9,9,0,284327.8,2598,109.5556
"26112","76581","2021",6,6,0,190400,1357.5,143.1667
"26113","76582","2021",1,1,0,189800,2207,86
"26114","76583","2021",4,4,0,214000,1936.25,114.5
"26115","76584","2021",6,6,0,169983.3,1500.333,124
"26116","76585","2021",1,1,0,233000,1585,147
"26117","76586","2021",11,11,0,176740.7,1738.455,108
"26118","76587","2021",8,8,0,227109.4,2301.25,101.625
"26119","76588","2021",8,8,0,166300,1814,89.75
"26120","76589","2021",4,4,0,150875,1873.75,83.5
"26121","76590","2021",5,5,0,166180,1686,99.8
"26122","76591","2021",32,32,0,267570.2,2350.688,119.2812
"26123","76592","2021",10,10,0,161841.9,1814,86.3
"26124","76593","2021",9,9,0,200466.7,1816.556,108.2222
"26125","76594","2021",12,12,0,226043.3,2117.333,108.75
"26126","76595","2021",22,22,0,240969.5,2506.182,106.5
"26127","76596","2021",18,18,0,271455.6,2325.444,117.1667
"26128","76597","2021",12,10,2,131610.8,1388.5,107.6667
"26129","76598","2021",4,4,0,110675,1201,97
"26130","76599","2021",62,52,10,183275.3,2319.952,82.80645
"26131","76600","2021",33,30,3,175674,2359.848,81.75758
"26132","76601","2021",5,5,0,175562.2,1773.2,105
"26133","76602","2021",5,5,0,153838,1800.6,85
"26134","76603","2021",9,9,0,207900,1893.333,120.4444
"26135","76604","2021",2,2,0,204850,1648,127.5
"26136","76605","2021",9,9,0,379111.1,3143.444,111.4444
"26137","76606","2021",2,2,0,135000,1236,112
"26138","76608","2021",20,20,0,208545,1754.4,122.3
"26139","76609","2021",1,1,0,456000,2036,224
"26140","76610","2021",25,25,0,179256.6,2136.48,90.04
"26141","76611","2021",2,2,0,201500,1580,135.5
"26142","76612","2021",5,5,0,132000,1491.4,87.6
"26143","76613","2021",28,26,2,172155.7,2018.357,89.92857
"26144","76614","2021",17,16,1,261881.5,2280.529,113.3529
"26145","76615","2021",9,9,0,291733.3,2396.444,121.1111
"26146","76616","2021",27,27,0,269190.7,2353.556,116.6296
"26147","76617","2021",34,33,1,400686.4,2877.412,139.5882
"26148","76618","2021",101,101,0,178022.4,1868.05,98.17822
"26149","76619","2021",4,4,0,328012.5,3879.75,111.75
"26150","76620","2021",5,5,0,196068,1774,112.8
"26151","76621","2021",19,19,0,173015.8,1615.263,110.5789
"26152","76622","2021",2,2,0,232500,2735.5,85
"26153","76623","2021",2,2,0,121000,1535.5,73.5
"26154","76624","2021",39,39,0,160101,1633.949,97.97436
"26155","76626","2021",3,3,0,207666.7,1840,134.3333
"26156","76627","2021",29,29,0,200883.4,2116.69,97.24138
"26157","76628","2021",9,9,0,162177.8,1320.778,118.8889
"26158","76629","2021",4,4,0,138500,1671.25,81
"26159","76630","2021",3,3,0,165000,1693.333,103
"26160","76631","2021",14,14,0,210244.6,2091.429,104.2143
"26161","76632","2021",3,3,0,133977,1483.333,85.33333
"26162","76634","2021",8,8,0,203412.5,1534.75,143
"26163","76635","2021",3,3,0,159400,1675,98.33333
"26164","76636","2021",20,19,1,205807.2,2052.95,103.7
"26165","76637","2021",14,13,1,177763,2150.571,82.85714
"26166","76638","2021",13,13,0,204433.6,1688.769,121.9231
"26167","76640","2021",91,78,13,156497.4,1731.077,90.78022
"26168","76641","2021",7,7,0,179959.3,1809.286,113.4286
"26169","76642","2021",4,4,0,209975,1893.25,110.75
"26170","76644","2021",8,8,0,129983.8,1413.5,94
"26171","76645","2021",1,1,0,114500,923,124
"26172","76646","2021",8,8,0,212050,2033.25,111.5
"26173","76647","2021",71,54,17,219734.6,2224.113,101.0986
"26174","76648","2021",26,25,1,125162.5,1537.462,86.53846
"26175","76649","2021",7,7,0,166638.1,1636,95.71429
"26176","76650","2021",10,10,0,279070,2684.4,108.8
"26177","76651","2021",4,4,0,174595,1630.25,107.75
"26178","76652","2021",9,9,0,135666.7,1484.889,93.33333
"26179","76653","2021",9,9,0,182083.3,1512.444,117.8889
"26180","76654","2021",6,6,0,248200,2102.167,123.1667
"26181","76655","2021",130,74,56,156613.2,2164.346,75.48462
"26182","76656","2021",9,9,0,199066.7,2842.556,77.11111
"26183","76657","2021",10,10,0,258793,2376.5,108.1
"26184","76658","2021",10,10,0,306470,2339.9,136
"26185","76660","2021",6,6,0,250800,2374.333,109.5
"26186","76663","2021",15,15,0,193620,2085.933,107.7333
"26187","76664","2021",9,9,0,148255.6,1492.667,106.5556
"26188","76665","2021",7,7,0,172352.9,1834.286,97.28571
"26189","76666","2021",4,4,0,224750,2079.5,139.25
"26190","76667","2021",4,4,0,201875,1525.5,145
"26191","76668","2021",6,6,0,225966.7,1885.667,125
"26192","76669","2021",7,7,0,138950,1617.429,84.28571
"26193","76670","2021",14,14,0,216927.9,2247.5,111.0714
"26194","76671","2021",3,3,0,173716.7,1709.667,96.66667
"26195","76672","2021",11,11,0,124090.2,1359.545,97.63636
"26196","76673","2021",13,13,0,245505.4,2071.923,119.3846
"26197","76675","2021",8,8,0,200200,2189.25,107
"26198","76676","2021",9,9,0,178416.8,2090.444,95.22222
"26199","76677","2021",2,2,0,63500,988.5,62.5
"26200","76678","2021",15,15,0,108830.8,1264.333,87.66667
"26201","76679","2021",1,1,0,62000,1292,48
"26202","76680","2021",5,5,0,214610,1669.2,132.2
"26203","76681","2021",388,276,112,158475.9,2180.874,73.73196
"26204","76682","2021",8,8,0,191062.5,1874.75,101.75
"26205","76683","2021",10,10,0,157843.8,1957.8,84.7
"26206","76684","2021",10,10,0,192500,2175.4,96.2
"26207","76685","2021",8,8,0,174287.5,1813.625,108.875
"26208","76686","2021",9,9,0,180183.9,1844,106
"26209","76688","2021",3,3,0,175400,1442.333,119
"26210","76689","2021",3,3,0,220000,1884.333,122.3333
"26211","76690","2021",10,10,0,195375,2180.6,90.3
"26212","76691","2021",3,3,0,172666.7,1673.667,118.6667
"26213","76692","2021",3,3,0,165666.7,1689,86
"26214","76693","2021",7,7,0,256385.7,2243.857,117
"26215","76694","2021",2,2,0,170375,1195.5,122.5
"26216","76695","2021",5,5,0,169600,1812,93.6
"26217","76697","2021",10,10,0,182535.5,1922.8,98.4
"26218","76698","2021",12,12,0,120854.2,1347,93.83333
"26219","76699","2021",11,11,0,178111.8,1497.818,117.1818
"26220","76700","2021",14,13,1,134492.6,1591.214,87.5
"26221","76702","2021",10,10,0,201735,1814.5,116.6
"26222","76705","2021",34,21,13,183040.9,1961.118,96
"26223","76706","2021",11,11,0,188681.8,2078.364,93.27273
"26224","76707","2021",13,13,0,171106.9,1567.385,107.3846
"26225","76708","2021",5,5,0,139400,1203.2,115.6
"26226","76709","2021",61,53,8,135823.1,1618.18,85.39344
"26227","76710","2021",1,1,0,231000,1283,180
"26228","76711","2021",156,91,65,100264.1,1936.019,57.16667
"26229","76712","2021",7,7,0,282306.9,3536,95.71429
"26230","76714","2021",9,9,0,190833.3,1992.444,101
"26231","76715","2021",5,5,0,220600,1609.6,133
"26232","76716","2021",12,12,0,244454.2,2127.75,119.8333
"26233","76717","2021",11,11,0,218600,1939,113.4545
"26234","76718","2021",22,22,0,187543.5,1699.955,110.3636
"26235","76719","2021",12,12,0,164257.5,1822.917,94.16667
"26236","76720","2021",20,19,1,370851.5,3602.9,119.9
"26237","76721","2021",3,3,0,177339.3,1453.667,119.6667
"26238","76723","2021",7,7,0,176328.6,2093.429,91.28571
"26239","76724","2021",2,2,0,181250,1992.5,95
"26240","76725","2021",6,6,0,239466.7,2347.5,100.3333
"26241","76726","2021",7,7,0,223942.9,2166.429,110.1429
"26242","76727","2021",18,18,0,160585,1600.667,105.1667
"26243","76728","2021",12,12,0,225318.8,2164.583,109.3333
"26244","76730","2021",2,2,0,129900,1577.5,82.5
"26245","76731","2021",1,1,0,108400,2409,45
"26246","76732","2021",5,5,0,230710,2394,115
"26247","76733","2021",1,1,0,216700,2408,90
"26248","76734","2021",8,8,0,287793.8,2332.75,127
"26249","76735","2021",26,13,13,192069.8,2724.346,72.73077
"26250","76736","2021",10,7,3,144933,2282.4,67.3
"26251","76737","2021",11,11,0,199381.8,1756,115.2727
"26252","76738","2021",10,10,0,228912,2025.2,120.9
"26253","76739","2021",8,8,0,109625,1136.375,89.25
"26254","76740","2021",2,2,0,193925,1643.5,118
"26255","76741","2021",6,6,0,203182.8,2136,95.5
"26256","76743","2021",25,25,0,169190,1825.44,89.28
"26257","76745","2021",3,3,0,129916.7,1178.667,104.3333
"26258","76746","2021",4,4,0,149800,1747.5,84.5
"26259","76747","2021",3,3,0,301766.7,2695.333,130.3333
"26260","76748","2021",20,20,0,187475,1801.2,103.85
"26261","76749","2021",4,4,0,61962.5,794.75,76.25
"26262","76750","2021",10,10,0,150586,1661.9,91.4
"26263","76751","2021",9,9,0,145811.1,1736.556,83.88889
"26264","76752","2021",40,38,2,179208.2,1885.575,99.45
"26265","76753","2021",14,13,1,236241.1,2279.643,105.0714
"26266","76754","2021",28,28,0,194234.4,2895.821,77.85714
"26267","76755","2021",7,7,0,140075.1,1353.857,102.7143
"26268","76756","2021",2,2,0,312000,1860,169
"26269","76757","2021",12,12,0,180720.8,1884.417,97.08333
"26270","76758","2021",186,94,92,155442.2,2038.226,75.02151
"26271","76759","2021",5,5,0,203720,1751.2,117.4
"26272","77001","2021",29,28,1,359386.8,3033.172,122.5862
"26273","77002","2021",13,12,1,199000,1961.615,113.9231
"26274","77003","2021",7,7,0,250514.3,2497.143,100.4286
"26275","77004","2021",10,9,1,261750,2379.1,110.7
"26276","77005","2021",49,40,9,350967.5,3640.837,100.3061
"26277","77006","2021",18,17,1,374711.1,3132.222,127.7778
"26278","77007","2021",3,3,0,223666.7,2513.667,94
"26279","77008","2021",16,16,0,298930.3,2791.062,115.1875
"26280","77009","2021",2,2,0,197800,1453.5,143.5
"26281","77010","2021",11,11,0,267590.9,2531.455,110.4545
"26282","77011","2021",11,10,1,240868.2,2077.455,127.3636
"26283","77012","2021",4,4,0,107750,1625.25,63.75
"26284","77013","2021",4,4,0,248522.5,2517.75,101.5
"26285","77014","2021",256,54,202,214448.9,3010.453,69.70703
"26286","77015","2021",1,1,0,175000,1902,92
"26287","77016","2021",18,18,0,146455.6,1736.278,87.83333
"26288","77018","2021",102,49,53,342984.6,4269.431,81.86275
"26289","77019","2021",8,8,0,193375,1690.75,120
"26290","77020","2021",18,18,0,241033.5,1934.444,122.7778
"26291","77021","2021",5,5,0,174920,1418.8,121.4
"26292","77022","2021",33,30,3,774598.2,4385.545,180.4242
"26293","77023","2021",2,2,0,334125,3548,95
"26294","77024","2021",1,1,0,367000,3058,120
"26295","77025","2021",23,23,0,158337.4,1357.652,120.9565
"26296","77026","2021",5,5,0,156800,1248.6,130.2
"26297","77027","2021",27,26,1,134004.1,1269.704,103.7037
"26298","77029","2021",5,5,0,306006,3191.2,112.4
"26299","77030","2021",21,21,0,172756.9,1651.619,114.8571
"26300","77031","2021",17,17,0,352941.8,2755.235,130.2941
"26301","77032","2021",13,13,0,178978.5,1733.154,114.5385
"26302","77033","2021",2,2,0,3e+05,1813.5,172
"26303","77034","2021",17,16,1,268813.8,2464.882,113.3529
"26304","77035","2021",17,17,0,159772.9,1479.412,112.2353
"26305","77036","2021",3,3,0,154000,1577.333,101
"26306","77037","2021",81,73,8,434502.2,4266.333,106.8148
"26307","77038","2021",4,4,0,269635,4256,70
"26308","77039","2021",16,16,0,366421.9,3524,118.1875
"26309","77040","2021",34,32,2,326889,2973.706,115.5294
"26310","77041","2021",8,8,0,253125,2540,106.5
"26311","77042","2021",58,56,2,260042.3,2585.034,103.7414
"26312","77043","2021",7,7,0,263542.9,1911.571,151.4286
"26313","77044","2021",10,9,1,213800,2488.3,87.7
"26314","77045","2021",13,13,0,177946.2,1599.692,113.6154
"26315","77046","2021",9,9,0,248166.7,2102,122.4444
"26316","77047","2021",19,17,2,341121.1,3309.526,105.5789
"26317","77048","2021",42,40,2,422601.4,3468.857,121.9286
"26318","77049","2021",7,7,0,351642.9,3190.714,125.2857
"26319","77050","2021",11,11,0,148818.2,1494.909,103.4545
"26320","77051","2021",35,30,5,147054.3,1654.857,97.14286
"26321","77052","2021",12,12,0,242395.8,2692.583,95.5
"26322","77053","2021",391,125,266,236019.1,3559.867,68.59847
"26323","77054","2021",17,17,0,201323.5,2186.176,96.29412
"26324","77055","2021",79,25,54,236504.9,3255.696,72
"26325","77056","2021",3,3,0,254146,2146.333,130.6667
"26326","77057","2021",7,7,0,176252.9,1848.429,88.71429
"26327","77058","2021",446,105,341,301019.8,4313.904,72.07623
"26328","77059","2021",13,11,2,550585,4201.308,136.5385
"26329","77060","2021",21,20,1,228435.7,1972.762,115.381
"26330","77061","2021",35,29,6,180998.6,2082.686,90.91429
"26331","77062","2021",4,4,0,281025,3582,78.75
"26332","77063","2021",23,22,1,239883.9,2687.652,93.82609
"26333","77065","2021",21,20,1,388446.8,3543.286,125.3333
"26334","77066","2021",4,4,0,139625,1524.25,98.5
"26335","77067","2021",154,124,30,273093.1,3095.922,91.29221
"26336","77068","2021",6,6,0,220916.7,1726.667,132.5
"26337","77069","2021",36,34,2,312763.1,2941,109.3056
"26338","77070","2021",17,17,0,191501.2,2079.706,90.64706
"26339","77071","2021",16,16,0,214025,2067.438,109.5625
"26340","77072","2021",9,9,0,162288.9,1646.556,99.22222
"26341","77073","2021",9,9,0,231172.2,1811,126.2222
"26342","77075","2021",20,15,5,238775,3875.75,72.05
"26343","77076","2021",11,11,0,190590.9,1819,104.1818
"26344","77077","2021",15,15,0,232605.9,2515.867,96.06667
"26345","77078","2021",29,29,0,231319.3,2660.655,94.03448
"26346","77079","2021",97,73,24,192517.2,2390.175,81.83505
"26347","77080","2021",1,1,0,224500,1754,128
"26348","77081","2021",10,7,3,237450,3064.9,76.2
"26349","77082","2021",18,15,3,260948.1,2769.833,112
"26350","77083","2021",258,100,158,296191.4,3839.857,79.74031
"26351","77084","2021",21,20,1,264923.4,2559.571,104.619
"26352","77085","2021",68,30,38,311531.7,3798.029,83.92647
"26353","77086","2021",22,22,0,251059.5,2482.318,108.3636
"26354","77087","2021",6,4,2,239833.3,2861.5,85.16667
"26355","77088","2021",31,26,5,240133.5,2202.839,109.3871
"26356","77089","2021",12,12,0,196708.3,2013.833,100.25
"26357","77090","2021",2,2,0,134000,2180,71.5
"26358","77091","2021",4,4,0,291247.5,3238.75,94.25
"26359","77093","2021",10,10,0,195165,1861.5,114.2
"26360","77094","2021",4,2,2,272575,2484.5,118
"26361","77095","2021",26,20,6,292296.7,3354.385,89
"26362","77096","2021",50,45,5,349171.8,3483.1,103.16
"26363","77097","2021",5,5,0,191780,1773.2,109.8
"26364","77098","2021",7,7,0,200628.6,1892,108.7143
"26365","77099","2021",63,54,9,161296,1855.46,92.92063
"26366","77100","2021",78,72,6,223454.6,2757.872,83.84615
"26367","77101","2021",16,16,0,201427.4,1787.125,115.8125
"26368","77102","2021",1,1,0,285000,2850,100
"26369","77103","2021",6,6,0,241000,3034.167,85
"26370","77104","2021",9,8,1,292583.8,3064.778,103.4444
"26371","77106","2021",18,18,0,186159.7,1737.722,114.3889
"26372","77107","2021",56,39,17,250707.1,2692.054,95.73214
"26373","77108","2021",828,342,486,259020.8,3703.57,73.07246
"26374","77109","2021",27,27,0,207121.1,2008.074,109
"26375","77110","2021",4,4,0,182750,1829.75,92.75
"26376","77111","2021",124,34,90,336890.7,4465.944,77.71774
"26377","77112","2021",8,8,0,273062.5,1971.375,136
"26378","77113","2021",15,15,0,226341.1,2327.467,105.3333
"26379","77114","2021",70,55,15,356737.3,3548.186,105.3714
"26380","77115","2021",15,15,0,216024.7,1808.2,124.2
"26381","77116","2021",22,22,0,238453.3,2230.409,114.6364
"26382","77117","2021",24,19,5,146506.2,1666.375,93.375
"26383","77118","2021",219,129,90,289450.2,3618.361,83.9726
"26384","77119","2021",7,7,0,374134.3,2903.143,118
"26385","77120","2021",11,11,0,214854.5,1962.909,114.8182
"26386","77121","2021",36,24,12,362603.7,4236.194,87.5
"26387","77122","2021",350,199,151,237273,3041.011,81.06
"26388","77123","2021",7,5,2,261921.4,2790.714,95.42857
"26389","77124","2021",25,25,0,452349.9,3495.56,135
"26390","77125","2021",27,25,2,326194.1,3489.185,95.22222
"26391","77126","2021",35,33,2,230018.6,2766,85.51429
"26392","77127","2021",32,16,16,234318.9,3065.125,77.96875
"26393","77128","2021",42,35,7,323930.6,3182.262,106.6905
"26394","77129","2021",8,8,0,176000,1875,90.25
"26395","77130","2021",10,10,0,282156.5,2712,107.3
"26396","77131","2021",222,111,111,195318,2651.856,77.73423
"26397","77132","2021",36,30,6,348866.2,3708.389,97.88889
"26398","77133","2021",4,4,0,161000,1748,94.5
"26399","77134","2021",1,1,0,83000,1317,63
"26400","77135","2021",23,22,1,252492.1,2579.652,101.3478
"26401","77136","2021",4,4,0,279595,2387.75,113.5
"26402","77137","2021",7,7,0,161857.1,1600.429,102.5714
"26403","77138","2021",8,8,0,235000,2972.875,87.125
"26404","77139","2021",98,83,15,313157.1,3574.143,91.86735
"26405","77140","2021",5,5,0,256000,2051.4,127.6
"26406","77141","2021",20,15,5,310890.9,3285.6,92.7
"26407","77142","2021",86,68,18,296543.7,3072.07,101.3605
"26408","77143","2021",68,50,18,243766.6,3036.882,81.63235
"26409","77144","2021",4,4,0,355650,2564.5,139.5
"26410","77145","2021",9,9,0,283038.9,2800.556,108.7778
"26411","77146","2021",29,24,5,364516.6,4216.793,88.93103
"26412","77147","2021",16,16,0,176000.9,1853.812,107.4375
"26413","77148","2021",25,21,4,216056,2266.2,95.52
"26414","77150","2021",10,10,0,244984.5,2660,95.8
"26415","77151","2021",5,5,0,186200,1978,95.6
"26416","77152","2021",294,135,159,196391.3,2803.639,72.56803
"26417","77153","2021",191,108,83,244368.6,3308.199,76.35079
"26418","77154","2021",29,29,0,324701,3085.172,110.5172
"26419","77155","2021",54,46,8,326348.1,3698.463,90.81481
"26420","77156","2021",18,18,0,200816.7,2279.333,91.83333
"26421","77157","2021",10,9,1,196100,2333.6,99.5
"26422","77158","2021",8,8,0,168537.5,1461.5,117.625
"26423","77159","2021",48,46,2,170443.8,1907,94.625
"26424","77161","2021",18,18,0,277679.3,2475.222,126.7222
"26425","77162","2021",22,20,2,182473,1740.364,106
"26426","77163","2021",3,3,0,309566.7,3338.667,96.66667
"26427","77164","2021",10,10,0,236535,2609.2,96.7
"26428","77165","2021",14,14,0,262012.5,2699.786,100.6429
"26429","77167","2021",5,5,0,149920,1649.4,92.6
"26430","77168","2021",38,35,3,177798.9,1724.737,104.2632
"26431","77169","2021",109,49,60,297402.1,3731,82.57798
"26432","77171","2021",117,71,46,252516.8,3787.838,71.24786
"26433","77172","2021",18,18,0,255350,2587.778,103.4444
"26434","77173","2021",20,20,0,211077.5,2682.7,86.45
"26435","77174","2021",12,12,0,160006.1,1666.75,99
"26436","77175","2021",48,44,4,345153.6,3283.333,108.9792
"26437","77176","2021",60,53,7,240308.5,2512.467,101.25
"26438","77177","2021",16,12,4,327900,3512.125,97.0625
"26439","77178","2021",10,10,0,225647,2349.5,103.4
"26440","77179","2021",10,10,0,278252,3422.3,92.9
"26441","77180","2021",8,8,0,481819.2,3094,161.5
"26442","77181","2021",68,36,32,340071.9,4459.456,82.05882
"26443","77182","2021",85,54,31,135376.4,1786.176,78.51765
"26444","77183","2021",195,121,74,185823.7,2450.944,80.62564
"26445","77184","2021",8,8,0,213525,2719.5,79
"26446","77185","2021",10,10,0,529460,5537.1,127
"26447","77186","2021",304,75,229,357748.7,4669.02,75.72368
"26448","77187","2021",13,13,0,147307.7,1798.538,89.61538
"26449","77188","2021",24,22,2,401712.5,3329.5,124.125
"26450","77190","2021",3,3,0,170000,1460.333,113
"26451","77191","2021",20,19,1,222063.5,2448.35,101.5
"26452","77192","2021",93,60,33,242659.1,3032.667,81.82796
"26453","77193","2021",3,3,0,396066.7,3387.333,120
"26454","77194","2021",4,4,0,189125,1940.25,99
"26455","77195","2021",11,10,1,274100,2675.545,109.4545
"26456","77196","2021",13,12,1,362510.2,3529.923,102.3846
"26457","77197","2021",5,5,0,275580,1831,155.8
"26458","77198","2021",5,5,0,281093.4,2436.2,116.4
"26459","77199","2021",17,17,0,268383.8,2807.059,103.5294
"26460","77200","2021",2,2,0,280500,2923,97
"26461","77201","2021",12,12,0,251318.3,2691.833,101.6667
"26462","77202","2021",9,9,0,222527.8,2515.889,89.66667
"26463","77203","2021",31,30,1,348116.6,3197.323,112.3871
"26464","77204","2021",6,6,0,220995.3,1679.667,141.3333
"26465","77205","2021",2,2,0,249475,2796,94
"26466","77206","2021",2,2,0,536900,3163.5,168
"26467","77207","2021",6,6,0,167754.3,1251.333,130.6667
"26468","77208","2021",16,14,2,154493.8,1570.75,102
"26469","77209","2021",16,11,5,447071.9,3568.562,127.8125
"26470","77210","2021",40,40,0,241688,2656.375,98.8
"26471","77211","2021",15,15,0,210133.3,2148.2,101.7333
"26472","77212","2021",7,7,0,144578.6,2150.286,67
"26473","77214","2021",13,9,4,372382.8,3643.231,104.3846
"26474","77215","2021",118,77,41,285848.6,3724.136,82.9661
"26475","77216","2021",26,26,0,250915.3,2599.269,100.0769
"26476","77217","2021",40,34,6,333891.3,3604.5,99
"26477","77218","2021",5,5,0,146970,2248.8,78
"26478","77219","2021",52,52,0,297373.6,3022.154,104.8077
"26479","77220","2021",5,5,0,226700,1437,163
"26480","77221","2021",19,14,5,494120.3,4226,120.3684
"26481","77222","2021",99,66,33,234739,3008.939,80.63636
"26482","77223","2021",9,9,0,189380,1729.333,109.5556
"26483","77224","2021",2,2,0,380495,3154.5,119.5
"26484","77225","2021",2,2,0,515000,3440.5,151.5
"26485","77226","2021",43,39,4,301401.2,3539.395,90.18605
"26486","77227","2021",15,15,0,172483.3,1621.667,107.3333
"26487","77228","2021",7,7,0,283885.7,2037.429,140.4286
"26488","77229","2021",29,20,9,291745.2,3161.483,95.41379
"26489","77230","2021",6,6,0,176041.7,1989,92.16667
"26490","77231","2021",11,11,0,270132.1,2421.455,119.0909
"26491","77232","2021",25,17,8,283914.2,3226.56,91.24
"26492","77233","2021",13,13,0,297586.8,2909.462,103.6923
"26493","77234","2021",9,9,0,374120.2,3492.111,118.3333
"26494","77235","2021",13,13,0,212288.5,2089.308,108.6154
"26495","77236","2021",9,9,0,172366.7,1902.111,94.77778
"26496","77237","2021",8,7,1,308536.2,3731.375,81.875
"26497","77238","2021",62,52,10,199793.1,2413.919,90.85484
"26498","77239","2021",35,20,15,194636.7,2412.514,88.62857
"26499","77240","2021",47,43,4,179821.3,1959.255,103.5745
"26500","77241","2021",24,22,2,295480.4,3044,97.75
"26501","77242","2021",15,15,0,153593.3,1719.6,93.33333
"26502","77243","2021",354,129,225,264756.4,3883.116,69.62147
"26503","77244","2021",15,14,1,255557.7,2968.133,90.53333
"26504","77245","2021",6,6,0,207533.3,1948.333,108.5
"26505","77246","2021",11,11,0,202366.8,1690.909,126.2727
"26506","77247","2021",14,14,0,178357.1,1802.5,107.7857
"26507","77248","2021",15,15,0,379455.6,3019.2,123.8667
"26508","77249","2021",128,121,7,400160.8,3655.273,110.3047
"26509","77250","2021",2,2,0,408950,2158.5,192
"26510","77251","2021",192,82,110,238516.1,3332.448,73.35417
"26511","77252","2021",12,12,0,358816.7,3144.667,126.6667
"26512","77253","2021",4,4,0,403250,2557,182
"26513","77254","2021",25,23,2,313862.4,2802.2,121.44
"26514","77255","2021",27,25,2,297544.6,2989.519,101.9259
"26515","77256","2021",2,2,0,182195,1403.5,131
"26516","77257","2021",39,25,14,174380,2287.462,81.28205
"26517","77258","2021",161,29,132,224920.9,3326.168,70.3913
"26518","77259","2021",49,24,25,217825.4,3413.041,69.32653
"26519","77260","2021",13,11,2,170707.7,1967.692,94.46154
"26520","77261","2021",19,19,0,211394.7,1857.895,118.1053
"26521","77262","2021",12,12,0,151991.7,1307.75,127.1667
"26522","77263","2021",7,7,0,228857.1,1978.286,120.1429
"26523","77264","2021",29,26,3,310097.2,2607.552,127.5862
"26524","77265","2021",13,11,2,166996.9,1990.769,85.61538
"26525","77266","2021",8,8,0,228959.4,2646.25,90.25
"26526","77267","2021",8,8,0,160637.5,1803.375,92
"26527","77268","2021",139,61,78,367847.2,4583.022,83.82734
"26528","77269","2021",33,30,3,269104.3,2685.697,113.2121
"26529","77270","2021",15,15,0,284636,2821.4,102.2667
"26530","77271","2021",6,6,0,217166.7,1955.667,113.5
"26531","77272","2021",14,12,2,208639.3,2106.143,106.7143
"26532","77273","2021",7,7,0,332162.9,2977.429,114.7143
"26533","77274","2021",10,8,2,230487.1,2591.3,93
"26534","77275","2021",2,2,0,269050.5,2329,116.5
"26535","77276","2021",47,36,11,287873.9,3305.957,92.08511
"26536","77277","2021",33,31,2,302766.7,3105,102.6667
"26537","77278","2021",5,5,0,289720,2730.4,109.6
"26538","77279","2021",22,20,2,172936.4,2002.682,88.27273
"26539","77280","2021",18,18,0,209060.6,2677.111,85.38889
"26540","77281","2021",16,15,1,294116.9,2476.062,121.8125
"26541","77282","2021",3,3,0,241000,3478,76.33333
"26542","77283","2021",13,13,0,176046.1,1818.385,99.23077
"26543","77284","2021",747,165,582,197202.8,3069.839,67.95448
"26544","77285","2021",232,81,151,173364,2157.845,80.54741
"26545","77286","2021",2,2,0,164750,1684.5,99.5
"26546","77287","2021",13,13,0,170629.2,1938.538,94.23077
"26547","77288","2021",657,138,519,158310.4,2769.633,60.4688
"26548","77289","2021",4,4,0,159151,1396,130
"26549","77290","2021",17,17,0,232088.2,2296.529,107.8824
"26550","77291","2021",3,3,0,193533.3,2386.333,83.66667
"26551","77292","2021",13,10,3,260417.9,3405.692,81.53846
"26552","77293","2021",23,23,0,177298.5,2219.174,83.34783
"26553","77294","2021",225,174,51,258272.1,3525.089,78.05333
"26554","77295","2021",26,26,0,303953.5,3261.385,103.6154
"26555","77296","2021",239,127,112,237427.3,3041.665,79.95397
"26556","77297","2021",5,5,0,247882,1840,134
"26557","77298","2021",6,6,0,195500,2164.833,91.5
"26558","77300","2021",7,7,0,247905.7,2063.286,118.1429
"26559","77301","2021",6,6,0,151141.8,1425.333,110.5
"26560","77302","2021",36,35,1,267033,2404.056,115.6111
"26561","77303","2021",1,1,0,180000,1538,117
"26562","77304","2021",1,1,0,178500,3500,51
"26563","77305","2021",210,90,120,139203.4,2124.114,69.00952
"26564","77306","2021",5,5,0,262000,2679.2,96
"26565","77307","2021",273,57,216,281767.7,4423.828,66.51648
"26566","77308","2021",21,21,0,292329.1,2699.667,118.4286
"26567","77309","2021",25,23,2,238802.3,3205.04,79.64
"26568","77310","2021",7,7,0,150428.6,1730.143,90.42857
"26569","77311","2021",22,22,0,205523.2,1686.318,135.2273
"26570","77312","2021",82,75,7,338939.6,3628.524,97.5122
"26571","77313","2021",3,3,0,274000,2362.667,117.3333
"26572","77314","2021",4,4,0,187525,1309.75,139.25
"26573","77315","2021",64,54,10,330692.3,3725.719,92.64062
"26574","77316","2021",221,182,39,248100.8,2944.086,89.33032
"26575","77317","2021",61,52,9,234735.3,2712.754,90.80328
"26576","77318","2021",29,23,6,268615.3,3043.138,92.34483
"26577","77319","2021",1,1,0,245000,2882,85
"26578","77320","2021",97,89,8,245222.6,2582.866,98.14433
"26579","77321","2021",13,11,2,160561.5,1847.769,91.07692
"26580","77322","2021",39,35,4,286631.3,3277.359,90.35897
"26581","77323","2021",22,13,9,272680.2,3272.455,86.36364
"26582","77325","2021",5,5,0,176300,1706.2,107.4
"26583","77326","2021",51,37,14,261337.8,3182.314,84.47059
"26584","77327","2021",94,68,26,181915.5,2401.66,79.57447
"26585","77328","2021",6,6,0,240283.3,2561.5,97.33333
"26586","77329","2021",6,6,0,215141.7,1910,119.3333
"26587","77330","2021",95,75,20,251718.1,2940.253,90.28421
"26588","77331","2021",13,11,2,191115.4,1989.077,97.53846
"26589","77332","2021",2,1,1,225000,3054.5,74
"26590","77333","2021",169,119,50,185253.7,2350.485,82.07692
"26591","77335","2021",28,24,4,306770,3163.857,99.78571
"26592","77336","2021",17,9,8,230006.5,3117.235,75.23529
"26593","77337","2021",139,38,101,243145.5,3320.576,75.65468
"26594","77338","2021",6,6,0,204116.7,1685.167,123.6667
"26595","77339","2021",52,50,2,424324.4,2939,143.0385
"26596","77340","2021",15,15,0,260299.7,3037.333,97.13333
"26597","77341","2021",10,10,0,153570,1481.5,100.2
"26598","77342","2021",1,1,0,274000,1405,195
"26599","77343","2021",11,11,0,182272.7,1935.455,93.09091
"26600","77344","2021",29,28,1,330387.2,2974.517,115.1379
"26601","77345","2021",21,21,0,235980.5,2135.381,112.4762
"26602","77347","2021",12,12,0,178416.7,2119.333,86.75
"26603","77348","2021",4,4,0,281750,2149.75,133
"26604","77349","2021",111,91,20,287166.5,3233.324,92.64865
"26605","77350","2021",295,190,105,340256.9,3921.966,89.69492
"26606","77352","2021",36,34,2,300442.4,2880.667,108.25
"26607","77353","2021",6,6,0,240049.2,1904.667,138.1667
"26608","77354","2021",14,14,0,260621.6,2899.286,95.28571
"26609","77355","2021",5,5,0,173000,2094.8,84.6
"26610","77356","2021",1,1,0,189000,2520,75
"26611","77357","2021",21,21,0,289476.2,2361,124.5238
"26612","77358","2021",21,21,0,312620.5,2910.143,113.8571
"26613","77359","2021",32,30,2,332809.2,3433.281,102.4688
"26614","77360","2021",4,4,0,302250,3071,101.75
"26615","77361","2021",9,9,0,236557.2,2705.444,93.11111
"26616","77363","2021",42,22,20,264761.6,3495.643,77.83333
"26617","77364","2021",5,5,0,276400,2511.2,115.6
"26618","77365","2021",5,5,0,266470,2421.4,113.2
"26619","77366","2021",2,2,0,301250,2342,130
"26620","77367","2021",5,5,0,233200,1516.6,174.6
"26621","77368","2021",4,4,0,195525,1952.25,98.75
"26622","77369","2021",9,9,0,303811.6,2843,112.4444
"26623","77370","2021",18,17,1,268686.1,2720.389,112.1111
"26624","77371","2021",52,48,4,240307.3,2487.692,100.1154
"26625","77372","2021",40,22,18,392302.6,4161.275,102.975
"26626","77373","2021",488,259,229,288253,4006.779,75.2623
"26627","77374","2021",51,37,14,286032.5,3543.333,83.66667
"26628","77376","2021",17,17,0,306804.2,3329.235,100.7059
"26629","77377","2021",48,38,10,281796.9,3422.583,87.4375
"26630","77378","2021",59,36,23,261184.3,3031.102,89.81356
"26631","77379","2021",170,80,90,165069.4,2336.959,78.88235
"26632","77380","2021",4,4,0,274725,2506,128
"26633","77381","2021",9,9,0,234972.2,2422.889,101.3333
"26634","77382","2021",97,81,16,280856.2,3149.33,97.20619
"26635","77383","2021",14,14,0,247957.1,2189.714,131.5
"26636","77384","2021",14,14,0,227737.1,3766.071,69.5
"26637","77385","2021",45,43,2,201626.2,2252.533,92.62222
"26638","77386","2021",8,8,0,272725.4,2552.875,116.5
"26639","77387","2021",12,12,0,207770.8,1811.917,120
"26640","77388","2021",16,16,0,196187.5,2507.812,95.5
"26641","77389","2021",51,25,26,249917.3,2887.451,87.21569
"26642","77390","2021",270,170,100,276610.5,3447.711,82.57407
"26643","77391","2021",6,6,0,195616.7,2290.5,87.66667
"26644","77392","2021",8,8,0,276062.5,3107.625,88.625
"26645","77393","2021",36,33,3,266445.6,2831,98.05556
"26646","77394","2021",18,17,1,322619.4,3031.611,108.1111
"26647","77395","2021",5,5,0,197289.6,1773.6,99.8
"26648","77396","2021",3,3,0,243333.3,1499,183.3333
"26649","77397","2021",38,36,2,195221.1,2448.605,85.86842
"26650","77398","2021",21,21,0,177039,1889.048,105.7619
"26651","77400","2021",41,38,3,275925.4,2546.098,111.6585
"26652","77401","2021",15,15,0,181886.7,2192.6,83.6
"26653","77402","2021",7,7,0,201928.6,2063.714,95.42857
"26654","77403","2021",9,9,0,295115.2,2158.222,143.1111
"26655","77404","2021",21,18,3,167357.1,2076.476,90.47619
"26656","77405","2021",43,43,0,204735.6,2004.093,108.7674
"26657","77406","2021",20,20,0,225117.5,2149.8,109.45
"26658","77407","2021",243,141,102,262975.6,3007.185,89.35802
"26659","77408","2021",6,6,0,307308.3,2925,107.3333
"26660","77409","2021",22,22,0,203839.7,1998.409,104.2273
"26661","77410","2021",8,7,1,321500,3040.375,112.75
"26662","77411","2021",8,8,0,256787.5,1920.75,127.125
"26663","77412","2021",13,13,0,385876.9,2992.692,138.2308
"26664","77413","2021",49,43,6,339646,3717.429,96.32653
"26665","77414","2021",5,5,0,165000,1843.4,104.6
"26666","77415","2021",25,25,0,227898.6,2766.92,90.48
"26667","77416","2021",5,5,0,220750,2138.2,113
"26668","77417","2021",4,4,0,221250,1540.25,149.75
"26669","77418","2021",15,15,0,172158,1541.667,108.6
"26670","77419","2021",71,51,20,198896.7,2437.479,85.92958
"26671","77420","2021",55,43,12,250163.5,3078.8,84.72727
"26672","77421","2021",6,6,0,163916.7,1563.5,113.1667
"26673","77423","2021",13,13,0,210447.7,1979.692,113.3846
"26674","77424","2021",9,9,0,195290,1770.889,111.5556
"26675","77425","2021",15,15,0,485484.7,3294.4,162.2667
"26676","77426","2021",10,10,0,257215,2446.4,103.8
"26677","77427","2021",7,7,0,341571.4,3057.571,110.7143
"26678","77428","2021",10,10,0,236265,2949.6,79.9
"26679","77429","2021",5,5,0,173700,2184.4,86.8
"26680","77430","2021",89,81,8,293746.2,2963.528,102.5281
"26681","77431","2021",94,81,13,200650.4,2187.723,91.7766
"26682","77432","2021",13,13,0,211192.3,1947.615,116.6154
"26683","77433","2021",45,42,3,265424.2,2657.911,104.5778
"26684","77434","2021",9,9,0,139166.7,1684.444,88.77778
"26685","77435","2021",20,20,0,404353.4,3288.05,133.65
"26686","77436","2021",24,23,1,214312.7,1984.292,113.2917
"26687","77437","2021",46,38,8,299952.1,3042.674,91.43478
"26688","77438","2021",95,61,34,339589.3,4010.874,87.46316
"26689","77439","2021",12,12,0,354530.8,2568.333,117.6667
"26690","77440","2021",25,24,1,217219.4,2385.72,95.72
"26691","77441","2021",36,34,2,417237.2,3543.5,123.5556
"26692","77442","2021",24,18,6,312522.9,3473.25,95.58333
"26693","77443","2021",5,5,0,313000,3120.2,104
"26694","77444","2021",9,9,0,143445.6,1510,96.88889
"26695","77445","2021",361,198,163,227059.4,2754.108,83.91136
"26696","77446","2021",12,12,0,200633.3,1946.833,107.8333
"26697","77447","2021",29,27,2,369065,3069.345,128.5517
"26698","77448","2021",8,7,1,218312.5,2475.75,89
"26699","77449","2021",123,25,98,301622.4,4651.171,67.43902
"26700","77450","2021",57,50,7,411026.2,3820.965,116.193
"26701","77451","2021",16,16,0,216008.2,2766.812,91.75
"26702","77453","2021",13,12,1,318073.9,3395.077,104
"26703","77454","2021",5,5,0,254000,1986.2,135
"26704","77455","2021",30,24,6,287101.3,2893.367,100.4
"26705","77456","2021",16,16,0,176340,1905.062,98.25
"26706","77457","2021",29,21,8,261401.9,3053.414,90.55172
"26707","77458","2021",82,74,8,172780.1,1938.427,92.07317
"26708","77459","2021",16,16,0,153737.5,1545.875,102.3125
"26709","77460","2021",2,2,0,193500,1915,100.5
"26710","77461","2021",3,3,0,133000,1177.333,93.33333
"26711","77462","2021",14,7,7,173142.9,2843.714,63.64286
"26712","77463","2021",66,64,2,321050.9,3273.985,101.3333
"26713","77464","2021",150,81,69,264029.7,3760.833,74.76667
"26714","77465","2021",8,8,0,179175,1838.75,99.5
"26715","77466","2021",10,10,0,323600,3686.5,99
"26716","77467","2021",4,4,0,186182.5,1989.75,102.75
"26717","77468","2021",277,70,207,238895.4,3480.863,72.66787
"26718","77469","2021",15,14,1,315816.7,2330.333,142.6
"26719","77470","2021",100,56,44,284639.9,3823.68,82.93
"26720","77471","2021",10,8,2,200063,2519.9,91.4
"26721","77472","2021",10,10,0,175319,1751.2,99.2
"26722","77473","2021",15,15,0,246573.3,2239.467,110.8
"26723","77474","2021",15,14,1,252441.3,3063.667,90.2
"26724","77475","2021",92,73,19,225329.9,2949.902,81.76087
"26725","77476","2021",2,2,0,190000,2176.5,86
"26726","77477","2021",12,12,0,301872.5,2714.25,133
"26727","77478","2021",9,9,0,228577.8,2224.667,103
"26728","77479","2021",141,80,61,341983.7,4122.766,85.64539
"26729","77480","2021",19,17,2,204936.8,2374.526,95.84211
"26730","77481","2021",4,4,0,277225,2626.5,112.5
"26731","77482","2021",35,32,3,219241.3,2642.314,83.34286
"26732","77483","2021",42,37,5,242761.2,2931.69,85.19048
"26733","77484","2021",2,2,0,390000,3424,114
"26734","77485","2021",14,13,1,401666.1,3249.857,121.5714
"26735","77486","2021",13,13,0,250030.8,2751.308,100.6923
"26736","77487","2021",168,101,67,265457.9,2925.345,92.25
"26737","77489","2021",5,5,0,178066.6,1136.4,158.6
"26738","77490","2021",10,10,0,180250,1804.6,97.8
"26739","77492","2021",16,16,0,164812.5,1541.125,107.125
"26740","77493","2021",39,34,5,282659.2,3068.231,97.28205
"26741","77494","2021",49,44,5,247342,2418.755,107.5306
"26742","77495","2021",103,86,17,260303,3104.291,88.02913
"26743","77496","2021",3,3,0,294666.7,1853.667,183.3333
"26744","77498","2021",9,9,0,300311.1,2784.667,117.3333
"26745","77500","2021",6,6,0,276491.7,1874.833,150.5
"26746","77501","2021",16,16,0,262990.6,2444.5,110
"26747","77504","2021",26,25,1,193156.7,1941.077,108.5385
"26748","77505","2021",8,8,0,270075,3387.75,87.375
"26749","77506","2021",9,9,0,222833.3,1823,109.2222
"26750","77507","2021",11,11,0,155663.6,1657.455,112.3636
"26751","77508","2021",22,20,2,369468.6,3541.636,111.6364
"26752","77509","2021",10,10,0,210318,1997.8,107.7
"26753","77510","2021",29,17,12,325444.7,3830.379,93.37931
"26754","77511","2021",10,5,5,235110,2751.5,86.2
"26755","77512","2021",27,26,1,145141.9,1594.741,98.18519
"26756","77513","2021",81,40,41,231041.3,3391.568,70.67901
"26757","77514","2021",419,199,220,230870.8,3397.974,71.0716
"26758","77515","2021",10,10,0,300368.8,2947.9,104.1
"26759","77516","2021",15,15,0,219957.4,2465.533,95.66667
"26760","77517","2021",31,26,5,303636.8,3356.484,99.93548
"26761","77518","2021",3,3,0,618000,6201,107
"26762","77519","2021",10,9,1,152120,1408.4,111.5
"26763","77520","2021",15,15,0,408126.7,2850.533,142.3333
"26764","77521","2021",24,21,3,278364.2,3375.5,93.20833
"26765","77522","2021",6,6,0,179816.7,1718.833,102.3333
"26766","77523","2021",6,6,0,148758.3,1410.833,117.3333
"26767","77524","2021",10,10,0,202920,2384.8,92.6
"26768","77525","2021",3,3,0,272300,2708.667,109.3333
"26769","77526","2021",4,4,0,192500,2372.75,82.5
"26770","77527","2021",13,13,0,401553,3552.538,117.4615
"26771","77528","2021",15,15,0,317525.9,2852.8,112.9333
"26772","77529","2021",34,34,0,333498.8,3474.559,103.6176
"26773","77530","2021",4,4,0,231500,1438.5,162.75
"26774","77531","2021",30,29,1,169193.3,1870.5,93.2
"26775","77532","2021",3,3,0,186566.7,1681.667,117.6667
"26776","77533","2021",37,37,0,387871.8,3266.595,124.6486
"26777","77534","2021",14,12,2,260544.6,3311.786,80.85714
"26778","78003","2021",47,43,4,250331.9,2728.362,94.31915
"26779","78005","2021",223,95,128,276685.6,3734.265,75.9417
"26780","78006","2021",15,15,0,455405.1,3685.4,128.6667
"26781","78007","2021",21,20,1,658779.9,4926.19,141.4762
"26782","78009","2021",3,3,0,287900,1664.333,171.3333
"26783","78010","2021",12,12,0,514368.6,4024.667,127.9167
"26784","78013","2021",7,7,0,352828.6,3196.286,118
"26785","78015","2021",256,103,153,302609.4,3699.898,82.26562
"26786","78020","2021",22,22,0,328366.8,2724.909,126.5
"26787","78029","2021",192,86,106,207060.8,2808.901,75.64583
"26788","78030","2021",23,19,4,352272,3757.348,99.78261
"26789","78031","2021",11,11,0,406809.1,3156.636,140.0909
"26790","78033","2021",24,21,3,324108.4,3058.458,111.0417
"26791","78034","2021",11,11,0,381308.2,2546.545,157
"26792","78036","2021",8,8,0,331504.4,3036.875,118.25
"26793","78043","2021",70,28,42,459540.8,4683.186,95.61429
"26794","78048","2021",25,24,1,355284.4,3092.44,130.84
"26795","78049","2021",31,30,1,403446.6,4092.677,105.9677
"26796","78050","2021",10,10,0,531968,4374.3,127.4
"26797","78053","2021",8,8,0,447678.8,3674.5,135
"26798","78057","2021",35,32,3,223086.7,2419.943,99.25714
"26799","78062","2021",134,87,47,300508.6,3507.754,85.75373
"26800","78068","2021",9,9,0,226033.2,1923.556,120.2222
"26801","78070","2021",6,6,0,225300,3156.833,76.5
"26802","78071","2021",5,5,0,194346,2008.2,95.4
"26803","78072","2021",2,2,0,328142,2598.5,124
"26804","78073","2021",314,63,251,249343.6,3606.048,69.6879
"26805","78076","2021",5,5,0,271448,2929.4,99.4
"26806","78077","2021",15,14,1,412246.7,3191.667,134.5333
"26807","78082","2021",13,13,0,308597.3,2545.923,139.3846
"26808","78084","2021",10,10,0,422357,3073,143.4
"26809","78087","2021",29,24,5,301762.1,3762.517,87.68966
"26810","78089","2021",67,46,21,194144.1,2420.09,82.97015
"26811","78090","2021",37,31,6,327697,3810.027,97.21622
"26812","78092","2021",150,41,109,484198.1,5423.88,84.9
"26813","78096","2021",7,5,2,421114.3,2922.429,149.4286
"26814","78104","2021",16,16,0,288832.1,2629.062,115.625
"26815","78107","2021",25,23,2,300305.6,2634.88,115.56
"26816","78108","2021",18,15,3,494485.7,3515.889,136.3889
"26817","78113","2021",8,8,0,258636.6,2964.75,90.125
"26818","78117","2021",66,25,41,414558.1,5562.652,75.56061
"26819","78118","2021",54,37,17,232492.5,2967.593,82.16667
"26820","78120","2021",32,32,0,405759,3283.531,127.6875
"26821","78123","2021",262,79,183,243121.9,3710.981,68.08779
"26822","78124","2021",178,82,96,486792,5608.247,86.23034
"26823","78125","2021",14,14,0,385132,3059.214,136
"26824","78126","2021",307,104,203,544262.7,5127.564,101.4625
"26825","78128","2021",22,18,4,328839.1,3414.091,100.8636
"26826","78133","2021",82,31,51,523744.8,4410.854,112.878
"26827","78138","2021",107,63,44,223014,3202.598,72.1028
"26828","78140","2021",15,15,0,390463.3,2910.333,163.1333
"26829","78143","2021",24,18,6,422269.6,4508.542,96.5
"26830","78146","2021",481,148,333,476743.4,5699.948,80.7817
"26831","78147","2021",5,5,0,306487.2,1874.6,166.6
"26832","78152","2021",26,25,1,575604.6,4238.846,145.7692
"26833","78158","2021",307,80,227,579145.3,6341.355,87.62215
"26834","78160","2021",76,54,22,451133.5,4205.092,114.1447
"26835","78162","2021",3,3,0,416333.3,4083.333,103.6667
"26836","78163","2021",5,5,0,347072,3053.8,118.6
"26837","78164","2021",20,17,3,576790.1,3655.55,147.3
"26838","78165","2021",273,114,159,287578.9,3498.396,81.99267
"26839","78168","2021",30,14,16,235777.3,3720.133,65.1
"26840","78171","2021",20,18,2,428280.1,3503.6,116.1
"26841","78172","2021",608,344,264,303729.1,4107.817,75.98355
"26842","78185","2021",8,8,0,441967.8,2885.75,157.5
"26843","78188","2021",5,5,0,319636.6,2564.8,129.6
"26844","78189","2021",26,25,1,745154.3,4462.385,160.0769
"26845","78190","2021",136,51,85,676897.9,6673.919,99.72059
"26846","78192","2021",30,29,1,289212.4,2716.8,114.2
"26847","78193","2021",17,11,6,428794.7,4088.294,106.1765
"26848","78194","2021",3,3,0,394000,3272,120.3333
"26849","78196","2021",8,7,1,660002.8,4277.75,179.75
"26850","78202","2021",6,6,0,323966.7,2145.167,168.1667
"26851","78206","2021",64,42,22,273103.8,3267.891,86.14062
"26852","78208","2021",493,158,335,236660.3,3053.726,79.3854
"26853","78209","2021",10,9,1,376845,3220.3,123.7
"26854","78217","2021",103,86,17,285056.5,3146.495,93.54369
"26855","78220","2021",106,73,33,323241.5,3236.396,103.8962
"26856","78224","2021",76,51,25,595471.6,5302.342,113.3289
"26857","78227","2021",14,12,2,375221.4,3691.929,102.5
"26858","78230","2021",7,6,1,325328.6,2999.714,119.1429
"26859","78231","2021",1,1,0,187462,1589,118
"26860","78233","2021",40,39,1,630933.9,4723.975,136.075
"26861","78234","2021",6,6,0,236325,2488.667,101.5
"26862","78236","2021",14,13,1,369813.6,3150.429,131.5714
"26863","78237","2021",3,3,0,252333.3,2488.333,101.6667
"26864","78238","2021",33,30,3,271988.4,3262,86.60606
"26865","78239","2021",27,19,8,187055.7,2558.037,77.11111
"26866","78242","2021",152,43,109,264947.6,3677.112,72.30263
"26867","78245","2021",5,5,0,336460,2671.8,125.4
"26868","78246","2021",12,12,0,433550,3048.5,145.25
"26869","78255","2021",50,50,0,223353.6,2649.06,86.56
"26870","78261","2021",15,13,2,255330,3042.867,87.4
"26871","78262","2021",20,18,2,365207.4,3829.55,96.85
"26872","78263","2021",56,54,2,441800.3,3410.875,133.375
"26873","78265","2021",46,41,5,353176.8,3630.522,105.1087
"26874","78267","2021",110,94,16,246857.1,2988.145,85.79091
"26875","78269","2021",17,15,2,377072.1,3304.529,119.4706
"26876","78276","2021",14,14,0,217292.1,1772.857,124.6429
"26877","78278","2021",12,12,0,419431.7,3728.583,117.3333
"26878","78281","2021",7,7,0,377033.3,2921.571,133.5714
"26879","78283","2021",3,3,0,347333.3,2126,144
"26880","78285","2021",14,10,4,408099.6,3093,126.9286
"26881","78289","2021",19,19,0,803958.8,4690.632,178.5789
"26882","78290","2021",17,17,0,236941.2,2368.412,106.2941
"26883","78291","2021",25,23,2,309260.6,2791.04,118.92
"26884","78296","2021",9,9,0,300050,3129.444,95.33333
"26885","78297","2021",299,77,222,306749.9,4008.104,77.36455
"26886","78299","2021",51,43,8,290707.5,2895.961,103.2549
"26887","78300","2021",8,7,1,279962.5,3101.125,92.625
"26888","78302","2021",7,7,0,630465.7,4322.143,126.2857
"26889","78305","2021",6,6,0,512000,4367.333,123.3333
"26890","78307","2021",21,21,0,376185.7,2923.429,138.0952
"26891","78310","2021",72,35,37,222240.6,3187.944,73.625
"26892","78311","2021",536,277,259,396879.1,5483.437,74.29664
"26893","78314","2021",64,58,6,255832.4,2793.281,93.82812
"26894","78317","2021",14,12,2,323749.9,2781.429,122.5714
"26895","78320","2021",10,10,0,270617,2625.5,114.6
"26896","78321","2021",71,64,7,451880.2,3774.859,125.7465
"26897","78322","2021",100,46,54,471730.9,5175.58,89.44
"26898","78324","2021",10,10,0,344110,3138,112.1
"26899","78325","2021",7,7,0,273710.9,3269.571,91.28571
"26900","78327","2021",72,60,12,256121.6,2898.389,90.90278
"26901","78329","2021",11,11,0,306688.2,3220.182,103.8182
"26902","78334","2021",22,22,0,429507.1,3661.682,123.1818
"26903","78335","2021",183,118,65,201321.5,2527.645,81.48087
"26904","78337","2021",27,26,1,196690.3,2500.741,85.77778
"26905","78343","2021",14,9,5,475695.6,4518.429,108.7143
"26906","78344","2021",9,9,0,314777.8,2499.333,138.2222
"26907","78346","2021",24,24,0,295833.3,2498.542,128.6667
"26908","78349","2021",10,10,0,416320,2642.7,147
"26909","78350","2021",124,32,92,569245.1,5293.565,107.7984
"26910","78354","2021",82,74,8,259434.7,2778.598,95.36585
"26911","78356","2021",139,96,43,364360.7,3675.827,99.52518
"26912","78358","2021",419,130,289,577218.9,6579.134,83.42005
"26913","78361","2021",452,121,331,178062.9,2767.717,66.60619
"26914","78362","2021",236,142,94,205183.9,2680.987,79.30508
"26915","78364","2021",12,12,0,392750,3178.917,129.5833
"26916","78366","2021",8,8,0,375900,3227.875,112.75
"26917","78367","2021",58,40,18,663374.8,5460.862,124.2586
"26918","78368","2021",25,25,0,431188.3,3192.44,142.4
"26919","78372","2021",303,75,228,398350.9,4452.106,84.94719
"26920","78380","2021",107,94,13,359977.7,3614.402,104.0748
"26921","78381","2021",20,20,0,290635.1,3236.4,99.9
"26922","78382","2021",55,47,8,406595.2,3955.382,104.9273
"26923","78383","2021",282,126,156,256123.1,3165.628,83.05319
"26924","78384","2021",27,27,0,645373.9,4680.148,146.4074
"26925","78389","2021",36,33,3,577085.5,4133.139,145.7778
"26926","78391","2021",12,12,0,190462.5,2638.917,79
"26927","78396","2021",95,52,43,593007.9,5891.895,101.9158
"26928","78397","2021",110,83,27,394404.9,3783.673,107.8273
"26929","78398","2021",24,24,0,596035.2,4360.208,141.625
"26930","78401","2021",181,51,130,168033.8,2619.37,65.37569
"26931","78402","2021",60,51,9,312399,3240.1,98.61667
"26932","78403","2021",38,33,5,359510.1,2854.395,126.9211
"26933","78404","2021",6,6,0,339121.7,3979.5,95.16667
"26934","78406","2021",1,1,0,732740,3145,233
"26935","78407","2021",11,11,0,381359.4,2758.818,141.7273
"26936","78410","2021",17,17,0,216241.8,2487.882,93.23529
"26937","78413","2021",7,7,0,290735.7,2461.857,118.8571
"26938","78415","2021",13,13,0,492792.3,3739.077,129.6923
"26939","78416","2021",10,9,1,312612,2679.5,121.3
"26940","78417","2021",8,8,0,546997.8,3925.5,142.125
"26941","78418","2021",212,102,110,435446.9,5270.736,83.39623
"26942","78420","2021",51,34,17,540247.9,4492.667,116.6863
"26943","78423","2021",452,134,318,327751.3,4070.785,80.67035
"26944","78431","2021",39,38,1,519488.3,4085.615,134.2564
"26945","78437","2021",11,11,0,246906.8,2577.818,99.09091
"26946","78439","2021",2,2,0,295000,2157.5,171
"26947","78440","2021",256,116,140,180604.5,2470.23,74.89844
"26948","78442","2021",74,39,35,379696.4,4054.054,93.37838
"26949","78443","2021",14,12,2,440463.2,3677.643,124.7857
"26950","78444","2021",12,12,0,276034.2,2293.167,124.8333
"26951","78451","2021",20,20,0,293937.5,2806,108
"26952","78455","2021",81,52,29,621400.6,5272.938,120.4444
"26953","78460","2021",10,10,0,301430,2952.9,121.2
"26954","78464","2021",13,13,0,340994.5,2818.077,124.7692
"26955","78465","2021",39,34,5,326313.7,3299.231,101.4615
"26956","78466","2021",141,117,24,631687.4,4879.539,132.3475
"26957","78470","2021",20,17,3,317466.6,2647.2,123.45
"26958","78472","2021",4,4,0,233750,2213.75,108
"26959","78474","2021",21,19,2,253321.4,2748.857,95.85714
"26960","78475","2021",5,5,0,281920,2816.8,105.2
"26961","78478","2021",2,2,0,353700,2665,132.5
"26962","78481","2021",235,56,179,416550.2,5197.63,78.41702
"26963","78484","2021",11,10,1,316858.2,2643.273,121.8182
"26964","78486","2021",111,76,35,303446.9,3654.784,88.67568
"26965","78490","2021",433,166,267,256892.9,3264.958,79.83834
"26966","78497","2021",24,24,0,477324.9,3601.25,139
"26967","78498","2021",517,125,392,290800.4,4101.267,70.87427
"26968","78499","2021",6,6,0,366483.3,2810.667,138
"26969","78501","2021",39,37,2,241851.8,2946.385,85.28205
"26970","78502","2021",92,7,85,299983.5,4575.652,65.31522
"26971","78505","2021",10,10,0,383899.5,2491.3,155.1
"26972","78506","2021",12,12,0,243891,2490.667,98.33333
"26973","78513","2021",29,16,13,324610.5,3117.69,111.9655
"26974","78516","2021",17,17,0,352920.6,2865.235,127.9412
"26975","78517","2021",452,156,296,294270.3,3857.237,78.16593
"26976","78518","2021",1,1,0,2e+05,1739,115
"26977","78520","2021",22,21,1,369464.1,3035.409,131.9545
"26978","78522","2021",26,20,6,413400.5,2906.462,151.1923
"26979","78528","2021",5,5,0,292850,2374.2,122
"26980","78530","2021",9,9,0,288559.8,2770.444,105.7778
"26981","78531","2021",90,79,11,239457.1,2724.778,92.43333
"26982","78536","2021",7,6,1,258939.9,3246.571,89.42857
"26983","78537","2021",94,79,15,293068.3,2940.287,104.2872
"26984","78545","2021",289,62,227,308772.7,4451.851,69.85467
"26985","78548","2021",5,5,0,543720,3815.8,148.4
"26986","78550","2021",26,24,2,408209,3950.154,107.9231
"26987","78551","2021",672,140,532,535024,6502.775,81.49851
"26988","78557","2021",18,16,2,280967.9,2899.667,94.38889
"26989","78558","2021",6,6,0,269616.7,1882.333,143.3333
"26990","78559","2021",8,8,0,295772.5,2430.125,128.5
"26991","78561","2021",3,3,0,692300,3937.667,176.6667
"26992","78562","2021",20,16,4,441508.2,3519.45,128
"26993","78564","2021",14,14,0,242775,2419.143,105.0714
"26994","78565","2021",4,4,0,349425,2998.5,117.25
"26995","78567","2021",21,18,3,281260.5,2795.333,107.8095
"26996","78569","2021",23,20,3,340237,3072.913,124.3478
"26997","78571","2021",83,76,7,771677.2,5152.964,159.4096
"26998","78575","2021",121,95,26,496930.3,4596.347,113.686
"26999","78576","2021",36,30,6,489507.1,3855.806,133.1389
"27000","78586","2021",729,304,425,331930.7,4683.465,72.81756
"27001","78588","2021",8,8,0,441421.2,3520.625,128.125
"27002","78590","2021",15,14,1,459192.8,3443.467,133.6667
"27003","78591","2021",59,49,10,268820.6,2946.068,97.16949
"27004","78597","2021",12,10,2,290183.3,2849.75,102.0833
"27005","78601","2021",28,26,2,326105.3,3014.286,117.6786
"27006","78605","2021",19,19,0,300397.3,2859.474,114.1579
"27007","78608","2021",1,1,0,299000,3181,94
"27008","78609","2021",15,15,0,312817.7,2943.8,107.5333
"27009","78615","2021",15,11,4,345247.1,3677.867,106
"27010","78616","2021",25,23,2,404449.6,3702.84,119.72
"27011","78618","2021",13,13,0,278403.8,2317.308,128.7692
"27012","78620","2021",15,8,7,492619,4986.667,102.1333
"27013","78621","2021",269,56,213,188991.8,3010.216,65.17472
"27014","78623","2021",17,13,4,365331.8,3498.824,101.9412
"27015","78624","2021",239,180,59,344459.1,3679.833,97.17155
"27016","78638","2021",97,77,20,333853.5,3441.464,99.31959
"27017","78640","2021",223,40,183,364418,4921.834,73.82063
"27018","78642","2021",206,90,116,325156.9,3620.291,89.76214
"27019","78643","2021",144,108,36,388019.9,3961.653,99.76389
"27020","78644","2021",23,18,5,295123.6,3786.739,80
"27021","78646","2021",1176,123,1053,566709.1,7341.335,76.89116
"27022","78647","2021",13,12,1,298804.2,2552.231,117.2308
"27023","78650","2021",248,103,145,786053.4,7121.786,102.5363
"27024","78653","2021",3,3,0,283700,2608,110.3333
"27025","78655","2021",11,11,0,334365.5,3333.545,105.5455
"27026","78668","2021",6,6,0,329920.7,2659.5,128
"27027","78672","2021",106,68,38,551571.2,5064.198,111.6604
"27028","78674","2021",151,110,41,350737,4053.483,86.98013
"27029","78677","2021",7,7,0,290364.3,2766.143,110.2857
"27030","78681","2021",5,5,0,261352,2897.8,92.2
"27031","78683","2021",46,44,2,460481.1,3932.761,126.1087
"27032","78686","2021",287,78,209,479045.4,6520.544,71.24739
"27033","78688","2021",160,102,58,442835.8,4472.219,100.6937
"27034","79001","2021",23,23,0,93658.26,1016.261,99.52174
"27035","79002","2021",7,7,0,127928.6,1175.143,107.2857
"27036","79003","2021",78,78,0,178771.2,1833.936,97.46154
"27037","79005","2021",58,58,0,88940.55,1031.069,96.39655
"27038","79007","2021",13,13,0,107038.5,860.6154,121.6923
"27039","79008","2021",12,12,0,113233.3,1187.917,105.0833
"27040","79009","2021",6,6,0,158766.7,1206.167,140
"27041","79010","2021",21,21,0,121285.7,1526.143,90
"27042","79012","2021",32,32,0,142880.8,1167.688,120.9688
"27043","79013","2021",72,71,1,114593.8,1056.611,110.0556
"27044","79014","2021",67,67,0,101862.2,927.4776,109.0299
"27045","79015","2021",4,4,0,106000,940.5,121
"27046","79016","2021",12,12,0,88875,815.5833,109.5
"27047","79018","2021",6,6,0,95277.83,822.1667,108.5
"27048","79019","2021",4,4,0,82325,696.75,122.75
"27049","79020","2021",16,16,0,127386.9,1043.75,123.375
"27050","79022","2021",4,4,0,85750,1052.5,80
"27051","79023","2021",1,1,0,58500,731,80
"27052","79024","2021",22,22,0,163864.1,1426.909,113.3636
"27053","79025","2021",19,19,0,104787.7,1100.474,97
"27054","79029","2021",9,9,0,101166.6,1010.222,101.7778
"27055","79030","2021",9,9,0,107500,1009.222,104.2222
"27056","79031","2021",40,38,2,161877,1500.425,104.45
"27057","79032","2021",8,8,0,152250,1358,112.375
"27058","79034","2021",26,25,1,234691.9,2216.538,110.4231
"27059","79038","2021",26,26,0,103707.3,1042.077,97.42308
"27060","79040","2021",5,5,0,116770,1148.8,99.8
"27061","79042","2021",3,3,0,134333.3,1215.333,115.6667
"27062","79046","2021",11,11,0,158998.6,1314.364,118.8182
"27063","79047","2021",13,13,0,117892.3,1079.385,106.4615
"27064","79048","2021",90,90,0,181790.7,1723.9,110.1222
"27065","79049","2021",287,256,31,130608.9,1380.787,97.34843
"27066","79050","2021",7,6,1,111428.6,1093,102.4286
"27067","79055","2021",2,2,0,104000,1234.5,83.5
"27068","79056","2021",12,12,0,124707.5,1250.083,98.58333
"27069","79057","2021",30,30,0,103444.3,1049.367,105
"27070","79058","2021",13,13,0,136460.4,1070.692,141.2308
"27071","79059","2021",18,18,0,95025.67,1142.833,91.55556
"27072","79060","2021",4,4,0,117625,1044,109.5
"27073","79061","2021",47,47,0,136035.2,1283.489,106.5957
"27074","79062","2021",63,62,1,123651.7,1222.587,102.1111
"27075","79063","2021",37,37,0,88831.76,891.5405,101.2703
"27076","79064","2021",11,11,0,120233.8,963.6364,129.6364
"27077","79066","2021",38,38,0,122130.6,1158.237,104.1053
"27078","79069","2021",20,20,0,110057.5,1023.65,99.65
"27079","79070","2021",12,12,0,128223.3,1099.25,104.9167
"27080","79071","2021",8,8,0,134750,1277,108.875
"27081","79074","2021",5,5,0,147480,892.4,152.2
"27082","79076","2021",24,24,0,100070.8,1006.5,101.6667
"27083","79077","2021",21,21,0,98731.9,930.2857,113.5238
"27084","79078","2021",20,20,0,156066.2,1331.7,119
"27085","79079","2021",120,120,0,144419.3,1348.642,110.3167
"27086","79080","2021",41,41,0,131775.3,1261.22,104.2683
"27087","79081","2021",140,118,22,198519.9,1995.364,97.42857
"27088","79083","2021",37,37,0,97965.51,962.973,106.3784
"27089","79084","2021",11,11,0,101997.3,767.8182,138.2727
"27090","79085","2021",2,2,0,224000,1514,157.5
"27091","79086","2021",25,25,0,210357.9,1637.32,127.12
"27092","79087","2021",10,10,0,94940,1041.1,97.3
"27093","79088","2021",26,26,0,137347.6,1253,108.7692
"27094","79089","2021",6,6,0,72333.33,1043.167,71.83333
"27095","79090","2021",13,13,0,101346.2,1099.385,99.46154
"27096","79091","2021",21,21,0,103945.2,1154.095,91.90476
"27097","79092","2021",12,12,0,108748.9,934.5,118.25
"27098","79094","2021",21,21,0,103142.9,999,109
"27099","79095","2021",10,10,0,122628.8,859.6,141.9
"27100","79096","2021",16,16,0,103363.8,1006.312,105.75
"27101","79100","2021",49,48,1,188280.2,1633.551,110.9388
"27102","79101","2021",67,67,0,123873,1272.478,99.32836
"27103","79102","2021",8,8,0,101275,852.5,114.875
"27104","79103","2021",58,58,0,109529.7,1076.466,99.43103
"27105","79104","2021",5,5,0,154400,1221.4,129.2
"27106","79105","2021",9,9,0,105322.2,1135.889,93.88889
"27107","79106","2021",12,12,0,81606.5,934.8333,82.58333
"27108","79108","2021",5,5,0,99400,1078.8,88.8
"27109","79109","2021",38,38,0,220536.1,1814.868,122.6316
"27110","79111","2021",6,6,0,108000,1270.833,92.66667
"27111","79112","2021",13,13,0,136907.7,1457.615,97.07692
"27112","79114","2021",25,22,3,133658.3,1339.88,98
"27113","79115","2021",10,10,0,121003,1128,101.1
"27114","79116","2021",14,14,0,119063.1,1043.714,117.4286
"27115","79117","2021",13,13,0,135828.3,1487.462,99.76923
"27116","79118","2021",6,6,0,106916.7,846.1667,126
"27117","79119","2021",12,12,0,115673.3,861.1667,129.5833
"27118","79120","2021",13,13,0,113538.5,984.4615,108.0769
"27119","79121","2021",5,5,0,127480,1079.6,120
"27120","79122","2021",14,14,0,120536.1,1037.714,116.8571
"27121","79123","2021",41,41,0,110547.1,1003.756,108.122
"27122","79124","2021",15,13,2,130976.5,1358.133,98
"27123","79125","2021",25,25,0,161863.9,1387.04,116.28
"27124","79126","2021",12,12,0,129541.7,1258,105
"27125","79127","2021",21,21,0,130123.8,1172.048,115.381
"27126","79128","2021",16,16,0,181643.8,1748.312,104.5625
"27127","79129","2021",22,22,0,204179.1,1745.364,116.8636
"27128","79130","2021",41,40,1,151739.8,1246.927,124.6585
"27129","79131","2021",4,4,0,71375,994.25,75.25
"27130","79132","2021",5,5,0,129000,906,142.8
"27131","79133","2021",21,21,0,191267.8,1464.381,135.3333
"27132","79134","2021",8,8,0,120875,1113.875,108.5
"27133","79135","2021",24,24,0,147234.2,1325.042,107.875
"27134","79136","2021",19,19,0,81965.79,851.1053,97.42105
"27135","79137","2021",10,10,0,151650,1568.1,98.1
"27136","79139","2021",1,1,0,2e+05,1667,120
"27137","79140","2021",22,22,0,144049.5,998.5909,142.3182
"27138","79141","2021",3,3,0,68533.33,614.6667,111.3333
"27139","79142","2021",3,3,0,94466.67,842.6667,100.6667
"27140","79144","2021",6,6,0,186183.3,1559.5,128.1667
"27141","79145","2021",7,7,0,99628.57,1019.143,95.42857
"27142","79147","2021",16,16,0,81712.5,850.4375,93.875
"27143","79148","2021",27,27,0,112580,921.5926,124.0741
"27144","79149","2021",4,4,0,94625,1171.75,78.25
"27145","79150","2021",18,18,0,98928.5,973.4444,104.8333
"27146","79152","2021",10,10,0,106480,1058.3,100.6
"27147","79153","2021",4,4,0,71537.5,720,104.25
"27148","79154","2021",7,7,0,98963.57,1069.571,94.57143
"27149","79156","2021",15,15,0,76973.33,879.8,89.13333
"27150","79157","2021",15,15,0,108126.7,1075.667,102.5333
"27151","79158","2021",2,2,0,119000,1077,99.5
"27152","79159","2021",2,2,0,126300,1307.5,96.5
"27153","79160","2021",1,1,0,157000,1570,100
"27154","79161","2021",8,8,0,159068.8,1177,132.5
"27155","79162","2021",57,57,0,221902.4,1892.719,119.3333
"27156","79163","2021",10,10,0,94780,756.3,116.1
"27157","79164","2021",4,4,0,68902,548.75,133.75
"27158","79165","2021",4,4,0,129125,952.5,118
"27159","79166","2021",16,16,0,146406.2,1441.75,106.3125
"27160","79167","2021",10,10,0,91800,892.1,103.5
"27161","79170","2021",58,57,1,140557.4,1425.293,99.2069
"27162","79172","2021",14,14,0,123268.6,1150.286,105.4286
"27163","79174","2021",92,92,0,113225.6,1102.587,107.25
"27164","79175","2021",7,7,0,136157.1,768.7143,196.1429
"27165","79176","2021",12,12,0,134761.7,1304.5,104.6667
"27166","79177","2021",3,3,0,89000,583.6667,159.3333
"27167","79179","2021",66,66,0,113408.2,1124.758,101.8333
"27168","79180","2021",10,10,0,98900,931.3,125.8
"27169","79183","2021",7,7,0,116214.3,1070.857,99.28571
"27170","79184","2021",41,41,0,116319.5,971.3659,120.1707
"27171","79185","2021",59,59,0,160112.7,1362.322,118.1186
"27172","79189","2021",27,27,0,158227.8,1232.852,127.1111
"27173","79190","2021",9,9,0,151817.4,1482.556,113.2222
"27174","79191","2021",1311,859,452,149715.5,1890.851,80.81236
"27175","79195","2021",72,72,0,121371.7,1192.125,104.1389
"27176","79196","2021",53,53,0,101101.9,904.5849,112.2453
"27177","79198","2021",4,4,0,119850,1103.75,122.5
"27178","79200","2021",9,9,0,136779.4,1293.556,111.8889
"27179","79201","2021",35,34,1,128704.6,1073.229,119.9429
"27180","79202","2021",248,207,41,102922.6,1200.327,87.15323
"27181","79203","2021",12,11,1,100338.8,1008.417,98
"27182","79204","2021",13,13,0,171211.5,1113.231,149.4615
"27183","79205","2021",2,2,0,76000,745.5,102
"27184","79207","2021",8,8,0,120550,1101.5,110.75
"27185","79208","2021",12,12,0,124975,996.9167,123
"27186","79209","2021",5,5,0,92320,807.2,109.6
"27187","79210","2021",10,10,0,133100,1370.5,93.8
"27188","79212","2021",11,11,0,98581.82,961.5455,104.9091
"27189","79213","2021",32,32,0,135862.5,1289.125,105.2188
"27190","79215","2021",8,8,0,96262.5,1014.5,93.75
"27191","79216","2021",23,23,0,167169.6,1524.304,109.3043
"27192","79217","2021",13,13,0,169053.8,1282,142.3846
"27193","79218","2021",5,5,0,75458.2,815.6,91
"27194","79220","2021",11,11,0,145090.9,1141.545,133.0909
"27195","79225","2021",5,5,0,99410,907.4,110.8
"27196","79226","2021",8,8,0,103155,1114.5,97.125
"27197","79229","2021",11,11,0,181473.6,1563.636,119.5455
"27198","79230","2021",19,19,0,129496,1001.684,126.4737
"27199","79231","2021",10,10,0,199750,1697.4,121.3
"27200","79235","2021",24,24,0,109578.6,1152.208,99.5
"27201","79236","2021",11,11,0,84904.55,732.4545,108
"27202","79238","2021",8,8,0,120000,1088.125,109
"27203","79239","2021",32,32,0,125982.8,1204.25,109.0938
"27204","79241","2021",8,8,0,136085,954.5,138.875
"27205","79242","2021",20,20,0,102810.3,1063.7,98.75
"27206","79243","2021",5,5,0,89751.4,776.8,100.8
"27207","79244","2021",3,3,0,113333.3,1035.333,105.6667
"27208","79246","2021",9,9,0,133850,1311.111,103.2222
"27209","79249","2021",32,32,0,203509.5,1857.781,117.7188
"27210","79250","2021",6,6,0,126166.7,1218.333,101.8333
"27211","79251","2021",11,11,0,113413.6,1012.273,120.6364
"27212","79252","2021",3,3,0,52666.67,636.3333,81.33333
"27213","79253","2021",17,17,0,113670.6,971.1765,117.1765
"27214","79254","2021",7,7,0,167841.4,1436.286,118.7143
"27215","79255","2021",12,12,0,76150,862.75,88.58333
"27216","79256","2021",5,5,0,113114.8,900.4,123
"27217","79257","2021",48,48,0,126474.7,1262.875,109.4792
"27218","79258","2021",9,9,0,86000,816.8889,96.88889
"27219","79259","2021",26,26,0,121467.3,1164.769,99.07692
"27220","79263","2021",18,18,0,123763.9,1150.056,110.7222
"27221","79265","2021",19,19,0,128021.1,1241.421,108.4737
"27222","79267","2021",8,8,0,81312.5,784.75,100.875
"27223","79268","2021",19,19,0,96368.42,1052,92.42105
"27224","79269","2021",3,3,0,133666.7,1062,120.3333
"27225","79270","2021",109,100,9,118651.9,1142.835,107.1284
"27226","79271","2021",3,3,0,129500,904.6667,132
"27227","79273","2021",7,7,0,158185.7,1383.143,123.2857
"27228","79274","2021",4,4,0,128500,1118.75,97.75
"27229","79276","2021",20,20,0,161170.5,1411.45,118.65
"27230","79277","2021",19,19,0,147919.5,1433.632,102.5263
"27231","79278","2021",4,4,0,69875,684.5,106.5
"27232","79280","2021",18,18,0,91655.56,823.3333,110.7778
"27233","79281","2021",21,21,0,164072.4,1529.238,107.6667
"27234","79283","2021",30,30,0,151043.8,1404.6,104.4333
"27235","79284","2021",18,18,0,136985.3,1345.056,99.77778
"27236","79285","2021",32,31,1,112343.6,1065.188,109.7188
"27237","79286","2021",13,13,0,98103.85,1008.231,104.3077
"27238","79289","2021",26,26,0,145788.5,1427.615,104.5769
"27239","79290","2021",29,29,0,132902,1254.931,106
"27240","79293","2021",9,9,0,211866.7,1483.111,142.5556
"27241","79294","2021",3,3,0,174591.3,1848.667,92.66667
"27242","79295","2021",15,15,0,165326.7,1423.133,113
"27243","79297","2021",13,13,0,104884.6,883.7692,120.2308
"27244","79298","2021",32,32,0,203506.9,1880.75,113.9375
"27245","79299","2021",44,44,0,112900.6,1132.705,98.29545
"27246","79300","2021",22,22,0,124257.3,1203.091,104.0909
"27247","79301","2021",12,12,0,108667.9,1009.25,107.8333
"27248","79302","2021",20,19,1,128006.2,1228.4,109.25
"27249","79303","2021",4,4,0,70750,663.75,106.75
"27250","79304","2021",14,13,1,173075,1705.214,113.5714
"27251","79306","2021",4,4,0,141250,1186.25,126.25
"27252","79307","2021",40,40,0,86384,847.5,104.875
"27253","79308","2021",7,7,0,198242.7,1637.143,126
"27254","79309","2021",7,7,0,104965.7,1080,103.1429
"27255","79310","2021",6,6,0,121066.7,864.5,135.6667
"27256","79311","2021",28,28,0,102947.5,1015.893,97.64286
"27257","79312","2021",3,3,0,100605,789.3333,126
"27258","79313","2021",6,6,0,101087,966.3333,107.8333
"27259","79316","2021",8,8,0,117937.5,981,127.5
"27260","79319","2021",16,16,0,147193.8,1107.25,132.8125
"27261","79320","2021",15,15,0,156680,1201.2,133.1333
"27262","79322","2021",27,27,0,127436.3,1258.296,100
"27263","79326","2021",24,24,0,85674.92,788.5,108.4167
"27264","79329","2021",366,344,22,95238.99,1062.724,88.86612
"27265","79331","2021",1,1,0,45000,542,83
"27266","79334","2021",27,27,0,125541.4,1267.481,105.0741
"27267","79335","2021",16,16,0,223182.5,1747.688,128.875
"27268","79336","2021",6,6,0,138426.7,1188.167,133
"27269","79337","2021",23,23,0,145778.7,1494.696,98.3913
"27270","79338","2021",2,2,0,83710,621,121.5
"27271","79339","2021",30,30,0,93666.5,993.8333,96.2
"27272","79340","2021",7,7,0,123000,824.2857,139.5714
"27273","79341","2021",5,5,0,93528,671.2,137.8
"27274","79342","2021",11,11,0,133568.2,1129.818,115.0909
"27275","79343","2021",8,8,0,161900,1146.375,139.125
"27276","79345","2021",23,23,0,102313.3,1078.261,105.3478
"27277","79346","2021",5,5,0,120000,898.6,158.2
"27278","79347","2021",14,14,0,108601.4,1027.929,105.2857
"27279","79348","2021",3,3,0,96200,1336.667,73.66667
"27280","79349","2021",7,7,0,82971.43,780.7143,95.14286
"27281","79350","2021",4,4,0,169375,1246.75,129.25
"27282","79351","2021",24,24,0,130395.8,1318.625,101.3333
"27283","79352","2021",1,1,0,65000,378,172
"27284","79354","2021",9,9,0,93794.44,936,97
"27285","79355","2021",56,56,0,211753.2,1825.982,118.1607
"27286","79357","2021",5,5,0,161400,1232.8,120.2
"27287","80001","2021",346,250,96,128548.6,1556.353,84.57225
"27288","80002","2021",2,2,0,80000,1238.5,85.5
"27289","80003","2021",7,7,0,201376.4,1373.714,149.5714
"27290","80004","2021",4,4,0,161900,1385.25,127.25
"27291","80006","2021",4,4,0,137125,1344.25,100.5
"27292","80008","2021",12,12,0,163208.3,1602.833,92.5
"27293","80009","2021",14,14,0,136445.6,1587.929,96.57143
"27294","80010","2021",42,42,0,176411.3,1819.048,101.9048
"27295","80011","2021",41,40,1,146401.2,1700.659,88.2439
"27296","80013","2021",30,30,0,98044.9,1151.267,84.76667
"27297","80014","2021",1,1,0,120000,1395,86
"27298","80015","2021",1,1,0,95000,1173,81
"27299","80016","2021",175,150,25,105122.6,1345.44,80.32571
"27300","80017","2021",4,4,0,88250,1164,75.25
"27301","80018","2021",3,3,0,218368.3,2122.333,105.3333
"27302","80019","2021",14,14,0,117392.9,1203.5,101.2857
"27303","80020","2021",8,8,0,272202.9,2484.625,112
"27304","80021","2021",1953,1029,924,164460.7,2381.202,71.37686
"27305","80022","2021",1,1,0,1e+05,730,137
"27306","80023","2021",8,8,0,142000,1576.375,95.75
"27307","80024","2021",4,4,0,264095.8,2605.5,101
"27308","80025","2021",8,8,0,145700,1707.875,94.375
"27309","80027","2021",1,1,0,230000,1533,150
"27310","80028","2021",3,3,0,88500,909.3333,90.66667
"27311","80029","2021",7,7,0,132024,1548,87.28571
"27312","80031","2021",13,13,0,138233.8,1424.385,100.8462
"27313","80033","2021",2,2,0,83000,816,92.5
"27314","80034","2021",14,14,0,89641.43,1069.071,78.92857
"27315","80036","2021",5,5,0,144556,1598.8,88.4
"27316","80039","2021",101,59,42,114558.6,1977.871,62.48515
"27317","80040","2021",6,6,0,111166.7,1115.167,95.66667
"27318","80041","2021",1,1,0,115000,2500,46
"27319","80042","2021",2,2,0,101720,1204.5,83.5
"27320","80044","2021",3,3,0,119333.3,1024.667,121
"27321","80045","2021",3,3,0,70500,1251,55.33333
"27322","80047","2021",10,10,0,128500,1489.6,81.7
"27323","80048","2021",1,1,0,98000,1273,77
"27324","80049","2021",1,1,0,210000,1927,109
"27325","80050","2021",9,9,0,271633.3,2408.222,116.6667
"27326","80051","2021",2,2,0,121500,1226.5,101
"27327","80052","2021",5,5,0,137000,1837,77.8
"27328","80053","2021",1,1,0,109000,790,138
"27329","80054","2021",5,5,0,107160,1146.4,94.6
"27330","80055","2021",1,1,0,40000,533,75
"27331","80056","2021",1,1,0,160000,2025,79
"27332","80057","2021",2,2,0,136000,1524,97.5
"27333","80058","2021",8,7,1,104862.5,1337.875,86.375
"27334","80059","2021",4,4,0,108129.8,891,107
"27335","80060","2021",4,4,0,104875,994.5,106.75
"27336","80061","2021",7,7,0,91714.29,953.4286,95.28571
"27337","80062","2021",23,23,0,101370,1179.261,90.34783
"27338","80063","2021",15,15,0,152042,1491.533,102.5333
"27339","80064","2021",2,2,0,129750,1496,92.5
"27340","80065","2021",1,1,0,71000,1145,62
"27341","80066","2021",1,1,0,155725,1923,81
"27342","80067","2021",2,2,0,150505,1514.5,106.5
"27343","80068","2021",1,1,0,131000,2472,53
"27344","80069","2021",5,5,0,129880,1552.6,83.2
"27345","80070","2021",19,19,0,132287.4,1134.316,117.2632
"27346","80071","2021",23,23,0,97157.39,1254.87,82.73913
"27347","80073","2021",2,2,0,146500,1106.5,130.5
"27348","80074","2021",3,3,0,158666.7,1197,150.3333
"27349","80076","2021",3,3,0,214800,2430.667,87.33333
"27350","80077","2021",1,1,0,120000,2400,50
"27351","80078","2021",8,8,0,240797.5,1567,147.5
"27352","80079","2021",4,4,0,132375,1043.5,128.5
"27353","80080","2021",1,1,0,187000,1889,99
"27354","80081","2021",1,1,0,145000,1208,120
"27355","80082","2021",15,15,0,168656.7,1761.467,104.8
"27356","80083","2021",2,2,0,196250,1984,98
"27357","80084","2021",3,3,0,116166.7,963.6667,124.6667
"27358","80085","2021",1,1,0,140000,952,147
"27359","80086","2021",13,13,0,145445,1247.231,116
"27360","80087","2021",2,2,0,80000,822.5,89
"27361","80088","2021",4,4,0,116176.2,751,163.75
"27362","80089","2021",3,3,0,121500,1017.333,123.3333
"27363","80090","2021",3,3,0,94333.33,1017.667,92.33333
"27364","80092","2021",8,8,0,215495.9,1888.875,113
"27365","80093","2021",19,19,0,115357.7,1292.368,90.21053
"27366","80094","2021",7,7,0,231842.9,2720.857,98.57143
"27367","80095","2021",6,6,0,102666.7,972.8333,102.8333
"27368","80096","2021",9,9,0,127005.6,1521.222,79.44444
"27369","80097","2021",3,3,0,67000,1083.333,61.33333
"27370","80098","2021",2,2,0,90000,812.5,97.5
"27371","80099","2021",1,1,0,33000,550,60
"27372","80100","2021",9,9,0,132277.8,1260.333,104.8889
"27373","80101","2021",17,17,0,116735.3,1346.059,90.58824
"27374","80102","2021",7,7,0,108486.9,1174.143,90
"27375","80103","2021",2,2,0,77500,1139.5,68
"27376","80104","2021",2,2,0,167500,1408.5,118.5
"27377","80105","2021",5,5,0,107800,2232,57
"27378","80106","2021",3,3,0,166333.3,1788.333,97
"27379","80107","2021",3,3,0,254916.7,2413.333,102
"27380","80108","2021",1,1,0,175000,1346,130
"27381","80109","2021",10,10,0,101125,1029.5,97.1
"27382","80110","2021",3,3,0,254333.3,2460.667,116
"27383","80112","2021",5,5,0,81400,1150.4,70.2
"27384","80113","2021",5,5,0,186400,1439,140.6
"27385","80114","2021",4,4,0,197500,1653.75,114.25
"27386","80115","2021",1,1,0,25000,893,28
"27387","80116","2021",5,5,0,141100,1200.6,135.6
"27388","80117","2021",3,3,0,52000,909.3333,59.33333
"27389","80119","2021",6,6,0,142072.3,1390.5,105.8333
"27390","80120","2021",6,6,0,94833.33,1289.5,74
"27391","80121","2021",2,2,0,104000,1081.5,100.5
"27392","80122","2021",8,8,0,134375,1012.125,133.125
"27393","80123","2021",5,5,0,155400,1415.6,117
"27394","80124","2021",10,10,0,100190,1274.6,77.5
"27395","80125","2021",3,3,0,140333.3,1565,92
"27396","80126","2021",16,16,0,107903.1,1150.375,90.625
"27397","80127","2021",18,18,0,144566.7,1590.278,92.5
"27398","80128","2021",1,1,0,97000,1115,87
"27399","80129","2021",10,10,0,119233,1203.3,101.4
"27400","80130","2021",3,3,0,276951,1838.333,145.6667
"27401","80131","2021",38,36,2,202117.8,2216,95.89474
"27402","80132","2021",2,2,0,151500,1571.5,101.5
"27403","80133","2021",7,7,0,140750,1346.286,107.8571
"27404","80134","2021",2,2,0,194500,1626,123
"27405","80135","2021",2,2,0,138250,965.5,118.5
"27406","80136","2021",17,17,0,123235.3,1390.882,85.05882
"27407","80137","2021",12,12,0,147175,1767.833,87.25
"27408","80138","2021",3,3,0,210200,2191,95.33333
"27409","80140","2021",1,1,0,165000,1813,91
"27410","80141","2021",4,4,0,59812.5,764.75,75
"27411","80142","2021",4,4,0,227416.2,2084,110
"27412","80143","2021",3,3,0,175333.3,1676.667,110
"27413","80144","2021",6,6,0,123416.7,1097.667,117.1667
"27414","80145","2021",4,4,0,151000,1124.5,147
"27415","80146","2021",3,3,0,119316.7,1490,73.66667
"27416","80147","2021",3,3,0,86000,1097,82.66667
"27417","80148","2021",8,8,0,102218.8,1453.25,77.875
"27418","80149","2021",5,5,0,192380,1576.8,121
"27419","80150","2021",3,3,0,83733.33,943,87.33333
"27420","80151","2021",1,1,0,148000,771,192
"27421","80152","2021",3,3,0,109400,1841.333,64.66667
"27422","80153","2021",2,2,0,71000,648.5,108
"27423","80155","2021",4,4,0,185150,1717.25,109.5
"27424","80156","2021",3,3,0,251733.3,2166.333,120.6667
"27425","80157","2021",1,1,0,462000,1901,243
"27426","80159","2021",1,1,0,308800,2595,119
"27427","80160","2021",12,12,0,203529.2,2050.167,98.16667
"27428","80161","2021",2,2,0,67000,1117,60
"27429","80162","2021",12,12,0,96201.67,1346.25,73
"27430","80163","2021",10,10,0,161340,1565.8,102.8
"27431","80164","2021",40,37,3,194268.8,2103.95,96.775
"27432","80165","2021",3,3,0,159200,1219.333,130.3333
"27433","80166","2021",7,7,0,162596.4,1452.143,109
"27434","80167","2021",6,6,0,146933.3,1401.833,109
"27435","80168","2021",14,14,0,144983.1,1245.571,116.4286
"27436","80169","2021",2,2,0,96250,1956.5,48
"27437","80170","2021",4,4,0,111700,1111.25,105.75
"27438","80171","2021",5,5,0,150500,1339.2,112.8
"27439","80172","2021",8,8,0,143256.2,1582.75,100.375
"27440","80173","2021",7,7,0,233799.9,1860.429,134.7143
"27441","80176","2021",3,3,0,157333.3,1251.667,126
"27442","80177","2021",15,15,0,128747.3,1129.733,114.2667
"27443","80179","2021",4,4,0,168750,1385.25,124.5
"27444","80182","2021",142,95,47,135302.3,2305.127,62.25352
"27445","80183","2021",3,3,0,139166.7,1165.333,119.3333
"27446","80184","2021",4,4,0,121918,1386,86.75
"27447","80185","2021",11,11,0,124063.6,1221.636,100.9091
"27448","80186","2021",27,27,0,128495.7,1457.148,92.81481
"27449","80187","2021",7,7,0,210642.9,1624.143,131.5714
"27450","80188","2021",6,6,0,143616.7,1164.667,126
"27451","80190","2021",11,10,1,112727.3,1172.091,97
"27452","80191","2021",4,4,0,136500,1576.25,86.75
"27453","80192","2021",3,3,0,162233.3,1321,129
"27454","80193","2021",3,3,0,119000,1509.667,71.66667
"27455","80194","2021",4,4,0,77350,1089.5,84
"27456","80195","2021",3,3,0,94666.67,1057.667,94
"27457","80196","2021",1,1,0,170000,2237,76
"27458","80197","2021",1,1,0,70000,3889,18
"27459","80198","2021",8,8,0,237865,2018.625,130.75
"27460","80199","2021",10,10,0,108243.1,1358.2,89.4
"27461","80200","2021",5,5,0,94415,1409.2,75.6
"27462","80202","2021",4,4,0,171500,1835,111.5
"27463","80204","2021",15,15,0,84067.33,1177.4,80.93333
"27464","80205","2021",14,14,0,121021.4,1590.071,81.85714
"27465","80206","2021",1,1,0,1e+05,769,130
"27466","80207","2021",4,4,0,151650,1712.5,88
"27467","80208","2021",4,4,0,153146.2,1600,97.5
"27468","80211","2021",28,27,1,148232.9,1473.679,99.53571
"27469","80212","2021",91,84,7,163836.8,1753.648,91.53846
"27470","80213","2021",3,3,0,219333.3,1952.333,110.6667
"27471","80214","2021",4,4,0,176300,1578,108.5
"27472","80215","2021",4,4,0,98592.5,1150.5,89.75
"27473","80216","2021",3,3,0,81500,810.6667,106
"27474","80217","2021",4,4,0,118125,1027.25,114.25
"27475","80218","2021",1,1,0,130000,1512,86
"27476","80220","2021",1,1,0,60000,517,116
"27477","80221","2021",4,4,0,131096.2,1338,98
"27478","80222","2021",30,30,0,102288.3,1033.867,101.8667
"27479","80223","2021",2,2,0,122565,1347,88.5
"27480","80224","2021",3,3,0,229130,1438.333,157.6667
"27481","80225","2021",1,1,0,319380,2314,138
"27482","80226","2021",4,4,0,92000,1016.25,89
"27483","80227","2021",7,7,0,124607.1,1379.143,92.57143
"27484","80228","2021",109,81,28,257711.2,3731.165,75.84404
"27485","80229","2021",9,6,3,209656.3,1914.667,112.1111
"27486","80230","2021",6,6,0,98666.67,1343.667,73.5
"27487","80231","2021",2,2,0,152050,1396,110
"27488","80233","2021",1,1,0,175000,1232,142
"27489","80234","2021",5,5,0,172640,1903.6,93
"27490","80235","2021",14,14,0,130787.5,1299.5,104.8571
"27491","80236","2021",10,10,0,92366,1428.3,65.5
"27492","80237","2021",9,9,0,187945.6,1614.556,119.7778
"27493","80238","2021",6,6,0,119666.7,1390.833,79.16667
"27494","80239","2021",2,2,0,157500,2363,67
"27495","80240","2021",14,14,0,118941.4,1340.571,94.5
"27496","80241","2021",27,27,0,124272.2,1116.519,114.5556
"27497","80242","2021",5,5,0,169300,1427.8,113.4
"27498","80243","2021",2,2,0,124900,1414.5,87.5
"27499","80244","2021",8,8,0,172351.2,1574.625,120
"27500","80245","2021",5,5,0,119130,1176,108.8
"27501","80246","2021",5,5,0,159162,1652.2,93
"27502","80247","2021",10,10,0,100342,1057.5,97.5
"27503","80248","2021",12,12,0,113083.3,1624.667,74.25
"27504","80249","2021",5,5,0,110125.6,1103.2,101.2
"27505","80250","2021",6,6,0,188816.7,1484.333,122.1667
"27506","80251","2021",7,7,0,140196.4,1339.429,104
"27507","80252","2021",1,1,0,62000,899,69
"27508","80253","2021",89,74,15,92160.73,1155.517,81.19101
"27509","80256","2021",23,19,4,164747.4,1943.304,85.47826
"27510","80258","2021",2,2,0,163500,1072.5,152.5
"27511","80259","2021",2,2,0,127350,1360.5,97.5
"27512","80260","2021",18,18,0,207223.3,1799.278,117.0556
"27513","80261","2021",15,12,3,301618,2796.067,110.9333
"27514","80262","2021",5,5,0,233972.8,1774,119.4
"27515","80263","2021",1,1,0,120000,1250,96
"27516","80264","2021",4,4,0,72815,741.25,88.25
"27517","80265","2021",14,14,0,117264.3,1060.5,110.0714
"27518","80266","2021",1,1,0,181000,1207,150
"27519","80267","2021",3,3,0,123333.3,1303,109
"27520","80268","2021",9,9,0,207111.1,1840.889,110.3333
"27521","80269","2021",2,2,0,157500,968.5,163.5
"27522","80271","2021",13,13,0,76200,775.2308,98.15385
"27523","80272","2021",3,3,0,111910,955.3333,135
"27524","80273","2021",3,3,0,137000,1221.667,108.3333
"27525","80274","2021",32,31,1,96550.44,1233.844,83.03125
"27526","80275","2021",6,6,0,99300,1105,89.83333
"27527","80276","2021",3,3,0,154000,1780.667,101.3333
"27528","80278","2021",5,5,0,136200,1447,96.4
"27529","80279","2021",10,10,0,103060,988.6,120.3
"27530","80280","2021",1,1,0,170000,1889,90
"27531","80281","2021",2,2,0,206000,1353.5,154.5
"27532","80282","2021",4,4,0,162887.5,1834.75,96.25
"27533","80283","2021",2,2,0,47500,550.5,78.5
"27534","80284","2021",13,13,0,78190.62,899.5385,83.30769
"27535","80285","2021",8,8,0,223408.8,1612.25,142.875
"27536","80287","2021",4,4,0,251000,2200,112.75
"27537","80288","2021",3,3,0,124833.3,1332.667,94.33333
"27538","80290","2021",8,8,0,125518.8,1375.25,92.375
"27539","80291","2021",1,1,0,299000,1881,159
"27540","80292","2021",2,2,0,55000,930,59.5
"27541","80293","2021",3,3,0,116800,1327,91.66667
"27542","80294","2021",2,2,0,155250,1726,88.5
"27543","80295","2021",12,12,0,105454.2,1334.25,77.91667
"27544","80296","2021",18,18,0,91952.78,1127.611,83.05556
"27545","80298","2021",10,10,0,93672.5,963.4,107.5
"27546","80299","2021",6,6,0,174516.7,1754.167,97.16667
"27547","80300","2021",3,3,0,159466.7,1143,136.3333
"27548","80301","2021",3,3,0,166670,1395.333,125.3333
"27549","80302","2021",2,2,0,150000,1265.5,118
"27550","80303","2021",10,10,0,219890,1982.5,113.3
"27551","80304","2021",1,1,0,92500,495,187
"27552","80305","2021",4,4,0,223825,1985.5,112.25
"27553","80306","2021",6,6,0,144083.3,1386,106.8333
"27554","80307","2021",1,1,0,260000,1793,145
"27555","80308","2021",34,34,0,116394.4,1545.294,76.70588
"27556","80310","2021",8,8,0,118389.4,1359.125,89.375
"27557","80312","2021",8,8,0,120125,1110.375,112.625
"27558","80313","2021",2,2,0,111550,1475,73.5
"27559","80314","2021",7,7,0,94111.43,958.1429,96
"27560","80315","2021",7,6,1,201942.9,1690.286,118.5714
"27561","80316","2021",32,32,0,169605,1911.344,96
"27562","80317","2021",2,2,0,136900,2292.5,68.5
"27563","80318","2021",42,41,1,105314.2,1359.31,79.28571
"27564","80319","2021",3,2,1,113333.3,1923,58.66667
"27565","80320","2021",2,2,0,170925,1285,133
"27566","80321","2021",3,3,0,174433.3,1499,121.6667
"27567","80322","2021",2,2,0,117500,1555,75.5
"27568","80327","2021",1,1,0,162500,1321,123
"27569","80328","2021",14,14,0,109642.9,1380.643,79.5
"27570","80329","2021",1,1,0,30000,435,69
"27571","80330","2021",3,3,0,1e+05,958.6667,105
"27572","80331","2021",7,7,0,169695.9,1552,109.5714
"27573","80332","2021",4,4,0,121000,1617.25,75.75
"27574","80333","2021",155,71,84,165771.3,3527.948,50.97419
"27575","80334","2021",1,1,0,312000,2137,146
"27576","80335","2021",1,1,0,109000,879,124
"27577","80336","2021",1,1,0,60000,938,64
"27578","80337","2021",4,4,0,178712.5,1928,96.5
"27579","80338","2021",30,26,4,144957,1735.267,82.6
"27580","80339","2021",1,1,0,79860,3803,21
"27581","80340","2021",5,5,0,129800,1335.4,96.6
"27582","80341","2021",6,6,0,123633.3,1697.167,87.33333
"27583","80342","2021",4,4,0,167787.5,1671.5,97.25
"27584","80343","2021",2,2,0,138900,1056,127
"27585","80344","2021",2,2,0,120000,958,124.5
"27586","80345","2021",3,3,0,189966.7,1739.667,122.3333
"27587","80346","2021",4,4,0,165795,1553.25,118.75
"27588","80347","2021",3,3,0,146666.7,1922,82.66667
"27589","80348","2021",2,2,0,225500,1379,163.5
"27590","80350","2021",7,7,0,155471.4,1602,100.2857
"27591","80351","2021",2,2,0,142800,1304,109
"27592","80352","2021",5,5,0,157500,1802.4,88
"27593","80353","2021",2,2,0,132500,1155.5,114
"27594","80354","2021",1,1,0,160000,1649,97
"27595","80355","2021",1,1,0,75000,1316,57
"27596","80356","2021",1,1,0,70000,1000,70
"27597","80357","2021",6,6,0,266120,2303,123.5
"27598","80358","2021",1,1,0,1e+05,1111,90
"27599","80359","2021",5,5,0,83160,982.6,77.4
"27600","80360","2021",29,29,0,101008.8,1353.483,77.27586
"27601","80362","2021",6,6,0,142500,1650.167,96.83333
"27602","80364","2021",7,7,0,138521.4,1493,95
"27603","80365","2021",4,4,0,198204.8,1787.75,111.75
"27604","80366","2021",7,7,0,126134.3,1431.857,85.57143
"27605","80367","2021",3,3,0,40333.33,844,48.33333
"27606","80368","2021",65,55,10,102478.5,1275.785,78.56923
"27607","80369","2021",2,2,0,45000,388,116
"27608","80371","2021",2,2,0,171500,1428.5,119
"27609","80372","2021",1,1,0,150000,2885,52
"27610","80373","2021",49,49,0,98247.96,1187.286,86.06122
"27611","80374","2021",1,1,0,130000,1646,79
"27612","80375","2021",2,2,0,161500,1541,106.5
"27613","80376","2021",9,9,0,162722.2,1681.556,105.3333
"27614","80377","2021",3,3,0,203000,1472,141.3333
"27615","80378","2021",2,2,0,26500,633.5,50
"27616","80379","2021",7,7,0,233285.7,2290.857,101.4286
"27617","80381","2021",1,1,0,40000,571,70
"27618","80383","2021",2,2,0,227500,2244.5,100
"27619","80385","2021",4,4,0,144500,1818,78.75
"27620","80386","2021",3,3,0,248105,1921.667,133.3333
"27621","80387","2021",3,3,0,175666.7,1999.667,103.6667
"27622","80390","2021",7,7,0,169285.7,1290.714,156.2857
"27623","80391","2021",1,1,0,144000,1674,86
"27624","80392","2021",6,6,0,126239,1185.5,106.6667
"27625","80393","2021",4,4,0,152775,1135.25,137
"27626","80395","2021",4,4,0,128000,1696.75,74.5
"27627","80396","2021",7,7,0,105505.7,1323.571,83.42857
"27628","80399","2021",6,6,0,295844.5,2326.667,128.5
"27629","80400","2021",9,9,0,146661.1,1636.889,94.22222
"27630","80401","2021",3,3,0,94333.33,952.6667,96.66667
"27631","80402","2021",2,2,0,114281,1067,104
"27632","80403","2021",1,1,0,270000,2231,121
"27633","80404","2021",3,3,0,84933.33,1173,68
"27634","80405","2021",3,3,0,174800,1313,148.6667
"27635","80406","2021",29,29,0,106971,1213.966,87.2069
"27636","80407","2021",2,2,0,112000,2046.5,56
"27637","80408","2021",2,2,0,232421,2143,104
"27638","80409","2021",3,3,0,119500,1824.333,69.66667
"27639","80410","2021",60,58,2,87837.67,1203.517,80.38333
"27640","80411","2021",5,5,0,114960,1450,81.4
"27641","80412","2021",8,8,0,182648.1,1853.125,98.75
"27642","80413","2021",2,2,0,56750,619.5,92
"27643","80414","2021",1,1,0,46500,750,62
"27644","80415","2021",11,11,0,182086.8,1573.818,115.7273
"27645","80416","2021",8,8,0,174308.8,1952.5,90.75
"27646","80417","2021",16,16,0,118366.9,1403.375,86.8125
"27647","80418","2021",2,2,0,110500,1279,84.5
"27648","80420","2021",5,5,0,164800,1761.4,98.6
"27649","80421","2021",4,4,0,141000,1460.5,96
"27650","80422","2021",4,4,0,207050,1881.25,114
"27651","80423","2021",6,6,0,167205.2,1495.5,111.5
"27652","80424","2021",7,7,0,331521.3,2705.571,134
"27653","80425","2021",2,2,0,98500,1078.5,86.5
"27654","80426","2021",4,4,0,172712.5,1630.75,104
"27655","80427","2021",3,3,0,108833.3,1078.333,88
"27656","80428","2021",3,3,0,91400,1232.333,70
"27657","80429","2021",2,2,0,74875,1076,69
"27658","80431","2021",14,14,0,197619.3,1978.286,105
"27659","80432","2021",2,2,0,146000,1678.5,94
"27660","80433","2021",1,1,0,124500,1383,90
"27661","80436","2021",10,10,0,107350,1127.4,91.3
"27662","80437","2021",3,3,0,90000,1304.667,66.33333
"27663","80438","2021",14,14,0,93499.29,950.9286,108.5
"27664","80440","2021",2,2,0,144250,1291,116
"27665","80442","2021",13,13,0,105661.5,1055,112.1538
"27666","80443","2021",22,22,0,107640.5,1316.273,87.13636
"27667","80444","2021",5,5,0,227840,1384.8,161.4
"27668","80445","2021",4,4,0,81277.5,700.5,111.25
"27669","80446","2021",13,13,0,131967.8,1549.846,89.07692
"27670","80449","2021",2,2,0,133500,1175.5,113.5
"27671","80450","2021",2,2,0,123500,1302,94
"27672","80452","2021",9,9,0,249577.8,2081.556,128.1111
"27673","80453","2021",3,3,0,126666.7,1471.333,121
"27674","80455","2021",1,1,0,231600,1362,170
"27675","80456","2021",13,13,0,132265.4,1433.769,94.07692
"27676","80458","2021",3,3,0,210333.3,2146.333,99
"27677","80460","2021",2,2,0,125000,1025.5,110.5
"27678","80461","2021",3,3,0,158033.3,1284.667,123
"27679","80462","2021",9,9,0,136046.7,1477.556,92.11111
"27680","80463","2021",10,10,0,129511.9,1616.7,89.1
"27681","80464","2021",13,13,0,149698.1,1820.538,81.61538
"27682","80465","2021",2,2,0,67500,794,85
"27683","80466","2021",2,2,0,44250,567.5,79.5
"27684","80467","2021",4,4,0,81750,882,93.75
"27685","80468","2021",3,3,0,176666.7,1570,108.6667
"27686","80469","2021",5,5,0,97300,1051.4,91.4
"27687","80470","2021",1,1,0,187500,1218,154
"27688","80472","2021",3,3,0,78100,1182,65
"27689","80473","2021",7,7,0,95428.57,1209.571,79.28571
"27690","80474","2021",5,5,0,107530,1113.8,97.2
"27691","80475","2021",5,5,0,130060,1117.4,114.2
"27692","80476","2021",3,3,0,122000,1117,111
"27693","80477","2021",6,6,0,120416.7,1574.167,81.16667
"27694","80479","2021",1,1,0,80000,611,131
"27695","80481","2021",6,6,0,119550.8,1323.667,99.66667
"27696","80482","2021",4,4,0,103500,1108,94.75
"27697","80484","2021",4,4,0,152657.5,1191.75,117.5
"27698","80485","2021",12,12,0,159933.3,1843.167,91.08333
"27699","80486","2021",23,23,0,97115.22,1285.348,74.52174
"27700","80487","2021",1,1,0,95000,1056,90
"27701","80488","2021",30,30,0,103879.7,1514.7,75.7
"27702","80489","2021",61,51,10,175937.1,2082.082,85.36066
"27703","80490","2021",6,6,0,96750,1044,93.66667
"27704","80493","2021",5,5,0,123384.6,1204.4,109.8
"27705","80494","2021",1,1,0,95000,1284,74
"27706","80495","2021",8,8,0,153550,1167.25,134.75
"27707","80496","2021",3,3,0,133433.3,1651,79.33333
"27708","80497","2021",2,2,0,99000,1792,54
"27709","80498","2021",11,11,0,135198.1,1396.545,94.90909
"27710","80499","2021",3,3,0,194833.3,1089,154.6667
"27711","80500","2021",8,8,0,90700,1451.875,67
"27712","80501","2021",7,7,0,109197.1,1013.571,103.7143
"27713","80502","2021",2,2,0,55000,753,71.5
"27714","80503","2021",5,5,0,218457.8,1698.4,131.4
"27715","80504","2021",2,2,0,137500,1941.5,71
"27716","80505","2021",8,8,0,192393.8,1417.5,132
"27717","80507","2021",18,18,0,160542.9,1878.111,84.66667
"27718","80509","2021",7,7,0,119917.9,1469.143,82.14286
"27719","80511","2021",1,1,0,211000,1954,108
"27720","80512","2021",11,11,0,154872.4,1680.818,96.45455
"27721","80513","2021",5,5,0,127080,1287,93.2
"27722","80514","2021",2,2,0,121250,1103.5,119.5
"27723","80515","2021",1,1,0,98000,1054,93
"27724","80516","2021",1,1,0,118000,1710,69
"27725","80517","2021",3,3,0,185524.3,1541.333,117.3333
"27726","80518","2021",7,7,0,132492.9,1259.857,100.4286
"27727","80519","2021",9,9,0,72724.11,961.8889,69.22222
"27728","80520","2021",1,1,0,109000,1253,87
"27729","80521","2021",5,5,0,139400,1483.2,98.6
"27730","80522","2021",1,1,0,45000,738,61
"27731","80523","2021",23,23,0,150894.7,1437.435,106.4783
"27732","80524","2021",7,7,0,167728.6,1126.857,146.7143
"27733","80525","2021",2,2,0,77500,1447.5,54
"27734","80526","2021",1,1,0,77000,1242,62
"27735","80527","2021",3,3,0,83470,1164,70
"27736","80529","2021",1,1,0,160000,1951,82
"27737","80530","2021",3,3,0,216520,1960,111.3333
"27738","80533","2021",139,77,62,117867.3,1947.41,63.69784
"27739","80535","2021",3,3,0,106666.7,1228.333,94.66667
"27740","80536","2021",4,4,0,54375,648,81.75
"27741","80537","2021",1,1,0,257000,1760,146
"27742","80538","2021",3,3,0,80333.33,1301.333,79.33333
"27743","80540","2021",4,4,0,61500,707.25,83
"27744","80542","2021",12,12,0,102817.7,1128.583,88.75
"27745","80543","2021",1,1,0,65000,1354,48
"27746","80544","2021",1,1,0,170000,1062,160
"27747","80545","2021",10,10,0,150000,1401.9,108.6
"27748","80546","2021",7,7,0,140571.4,1446.286,95.42857
"27749","80547","2021",6,6,0,151150,1190.833,121.3333
"27750","80548","2021",4,4,0,108175.5,1222,77.25
"27751","80549","2021",15,15,0,104933.3,1249.667,84
"27752","80552","2021",21,21,0,107152.6,1165,94.38095
"27753","80553","2021",2,2,0,238900,1828.5,143
"27754","80554","2021",14,12,2,151216.4,1238.143,122.7143
"27755","80555","2021",11,11,0,153957.7,1023.455,139
"27756","80556","2021",4,4,0,147400,1634.5,89.25
"27757","80557","2021",7,7,0,103693.1,1151,85.42857
"27758","80558","2021",6,6,0,142082.5,1536.5,100
"27759","80559","2021",1,1,0,80000,1081,74
"27760","80560","2021",3,3,0,134400,1437.667,85.33333
"27761","80561","2021",67,64,3,134187.6,1580.522,87.76119
"27762","80562","2021",2,2,0,148000,1254.5,115
"27763","80563","2021",2,2,0,96700,872.5,105.5
"27764","80565","2021",1,1,0,75000,872,86
"27765","80566","2021",3,3,0,135306,1243.667,105.6667
"27766","80568","2021",2,2,0,154250,1224,123.5
"27767","80569","2021",1,1,0,63000,583,108
"27768","80570","2021",62,61,1,145694.9,1602.21,94.29032
"27769","80571","2021",3,3,0,211813.3,1129.333,224.6667
"27770","80572","2021",8,8,0,119590,1205.5,100.875
"27771","80573","2021",9,9,0,112738.9,1026.222,108.1111
"27772","80574","2021",2,2,0,178375,1425.5,125.5
"27773","80576","2021",6,6,0,76083.33,958.3333,76
"27774","80577","2021",1,1,0,150000,1339,112
"27775","80578","2021",2,2,0,87500,942.5,80.5
"27776","80579","2021",18,18,0,118485.8,1256.556,99.66667
"27777","80580","2021",7,7,0,196447.9,1892.714,105.4286
"27778","80582","2021",9,9,0,145092.8,1707.333,86
"27779","80583","2021",4,4,0,220400,2473,89.5
"27780","80584","2021",18,18,0,197067.2,1707.556,117.8333
"27781","80585","2021",38,37,1,107831.6,1333.868,94.52632
"27782","80586","2021",3,3,0,62666.67,1039.333,69.33333
"27783","80588","2021",4,4,0,142215,1155,123.5
"27784","80589","2021",1,1,0,119151,1268,94
"27785","80590","2021",7,7,0,130752,1615.286,80.57143
"27786","80591","2021",2,2,0,109696.5,1346.5,84
"27787","80592","2021",7,7,0,74294.29,883.7143,83.85714
"27788","80593","2021",3,3,0,211666.7,1709.667,119.3333
"27789","80596","2021",2,2,0,117125,1180,100
"27790","80597","2021",5,5,0,147279.8,1589.6,96
"27791","80598","2021",22,22,0,149332.7,1455.364,102.2727
"27792","80599","2021",4,4,0,133500,1241.5,111.75
"27793","80600","2021",18,18,0,145946.7,1780.944,93.05556
"27794","80601","2021",4,4,0,72000,710.5,108.25
"27795","80602","2021",1,1,0,140000,1972,71
"27796","80603","2021",3,3,0,165500,1686.333,103.3333
"27797","80605","2021",3,3,0,87966.67,1186,71.66667
"27798","80606","2021",9,9,0,78111.11,959.2222,88.33333
"27799","80607","2021",3,3,0,109666.7,1467,73
"27800","80609","2021",1,1,0,126500,1072,118
"27801","80611","2021",13,13,0,224067.5,1882.231,116.6154
"27802","80613","2021",6,6,0,92566.67,1336.167,64.5
"27803","80614","2021",2,2,0,180300,1346.5,142
"27804","80615","2021",5,5,0,142292,1590.2,87.4
"27805","80616","2021",4,4,0,85250,1023.25,79.75
"27806","80617","2021",4,4,0,160500,2860.5,89
"27807","80618","2021",13,13,0,182061.5,2024.231,87.84615
"27808","80619","2021",12,12,0,139273,1259.583,108.8333
"27809","80620","2021",104,93,11,121345.6,1386.221,88.47115
"27810","80621","2021",7,7,0,173967.1,1353.143,122.2857
"27811","80622","2021",28,28,0,104282.8,1198.214,87.5
"27812","80623","2021",7,7,0,189817.1,1305,146
"27813","80624","2021",2,2,0,296000,1924,158
"27814","80625","2021",19,19,0,135578.9,1693.211,86.26316
"27815","80626","2021",8,8,0,225340,1815.375,144.25
"27816","80627","2021",17,17,0,254576.5,2279.353,114.4706
"27817","80628","2021",16,16,0,137078.8,1447.5,94.875
"27818","80630","2021",20,20,0,128726.2,1202.15,98.25
"27819","80631","2021",5,5,0,90300,1643.4,58
"27820","80632","2021",31,24,7,233828.7,2544.194,92.45161
"27821","80633","2021",9,9,0,289733.3,2062.667,143.5556
"27822","80634","2021",9,9,0,237052.8,2087.111,111.7778
"27823","80635","2021",25,25,0,100587.8,1239.8,82.16
"27824","80637","2021",5,5,0,182270,2222.2,90
"27825","80638","2021",3,3,0,109833.3,1466.667,74.33333
"27826","80639","2021",14,14,0,200663.4,1828.429,112.5714
"27827","80640","2021",8,8,0,173927.8,1404.625,133.75
"27828","80642","2021",5,5,0,128499.6,1383.6,91.4
"27829","80643","2021",7,7,0,199358.6,2391.857,84.57143
"27830","80644","2021",8,8,0,89927.5,1145.75,80.375
"27831","80645","2021",2,2,0,115500,1144,92
"27832","80646","2021",1,1,0,105000,1721,61
"27833","80647","2021",2,2,0,166400,1624,102.5
"27834","80649","2021",93,53,40,154428.3,2810.548,61.21505
"27835","80650","2021",7,7,0,196571.4,1903.286,101.4286
"27836","80651","2021",4,4,0,120100,1027,112.75
"27837","80652","2021",11,11,0,144272.7,2121.273,77.90909
"27838","80654","2021",5,5,0,176100,1824.6,98.4
"27839","80655","2021",6,6,0,102500,1006.167,99.16667
"27840","80656","2021",12,11,1,199600.8,1922.167,104.8333
"27841","80657","2021",3,3,0,101666.7,906.6667,115.3333
"27842","80658","2021",2,2,0,104450,1042.5,100
"27843","80659","2021",4,4,0,119250,822,139.75
"27844","80661","2021",9,9,0,252533.3,2079.556,126.4444
"27845","80662","2021",1,1,0,51796,639,81
"27846","80663","2021",2,2,0,86000,1192,69.5
"27847","80664","2021",1,1,0,150000,1304,115
"27848","80665","2021",1,1,0,185000,1101,168
"27849","80666","2021",1,1,0,205000,1830,112
"27850","80667","2021",3,3,0,147500,1509.667,104.3333
"27851","80668","2021",1,1,0,230000,1901,121
"27852","80669","2021",4,4,0,110575,1202.75,91
"27853","80670","2021",5,5,0,176900,1797.4,102.8
"27854","80671","2021",3,3,0,111666.7,1168.667,99.66667
"27855","80672","2021",9,9,0,162937.2,1463.667,114.2222
"27856","80673","2021",4,4,0,131250,1044.25,110
"27857","80674","2021",71,61,10,180617.4,2318.423,81.30986
"27858","80675","2021",2,2,0,180000,1964.5,89
"27859","80676","2021",1,1,0,255000,3072,83
"27860","80677","2021",35,35,0,81336,969.7714,83.08571
"27861","80678","2021",9,9,0,130138.9,1427.222,98
"27862","80679","2021",13,13,0,115407.7,1176,105.3077
"27863","80680","2021",44,43,1,128438.4,1539.023,91.22727
"27864","80681","2021",2,2,0,232000,1852,136
"27865","80682","2021",8,8,0,131937.5,1248.625,100.75
"27866","80683","2021",1,1,0,1e+05,500,200
"27867","80684","2021",1,1,0,259500,1285,202
"27868","80685","2021",95,90,5,125932.6,1345.853,94.32632
"27869","80686","2021",13,13,0,204423.8,1708.462,130.0769
"27870","80687","2021",2,2,0,123500,2412,54
"27871","80688","2021",54,50,4,174287.5,2150.87,83.87037
"27872","80690","2021",5,5,0,230116,2205.4,111.8
"27873","80691","2021",2,2,0,117500,1431.5,83
"27874","80692","2021",14,14,0,133792.9,1662,78.28571
"27875","80693","2021",4,4,0,148750,1562,93
"27876","80694","2021",4,4,0,158462.5,1642.5,96.25
"27877","80695","2021",8,8,0,75625,948.125,76.5
"27878","80696","2021",21,21,0,275947.6,2242.476,127.4762
"27879","80700","2021",10,10,0,111935,1313.9,84
"27880","80701","2021",9,9,0,144955.6,1352.667,104.6667
"27881","80702","2021",22,21,1,413076.5,2989.318,143.1364
"27882","80703","2021",4,4,0,152012.5,1454.75,111.25
"27883","80704","2021",5,5,0,231780,2358.6,110.2
"27884","80705","2021",1,1,0,124000,1319,94
"27885","80706","2021",21,21,0,80380.95,1024.476,78.90476
"27886","80707","2021",2,2,0,269750,2250,114
"27887","80708","2021",2,2,0,99000,701,127
"27888","80709","2021",4,4,0,116600,1475.5,85.5
"27889","80710","2021",3,3,0,111865,1050.667,96.66667
"27890","80711","2021",49,49,0,79441.06,1017.449,79.30612
"27891","80713","2021",6,6,0,276541.7,2573.333,107.6667
"27892","80714","2021",24,24,0,127123.4,1597.833,79.79167
"27893","80716","2021",19,19,0,161405.3,1505.158,108.2105
"27894","80717","2021",9,8,1,183424.4,2072.778,88.11111
"27895","80718","2021",17,17,0,176783.5,1984.176,92.58824
"27896","80721","2021",61,53,8,250186.7,3565.639,76.18033
"27897","80722","2021",7,7,0,187800,2023.857,93.14286
"27898","80723","2021",6,6,0,210733.3,1806,113.6667
"27899","80724","2021",42,39,3,209620.1,2326.476,89.21429
"27900","80725","2021",51,44,7,249402,2402.765,102.1373
"27901","80726","2021",2,2,0,106500,1260.5,83.5
"27902","80728","2021",1,1,0,92400,674,137
"27903","80729","2021",2,2,0,159645,1543.5,103.5
"27904","80730","2021",18,16,2,276078.9,2501.333,116.8889
"27905","80732","2021",13,13,0,91115.38,1026.462,90.69231
"27906","80733","2021",3,3,0,190666.7,1262.667,185.6667
"27907","80734","2021",2,1,1,114000,1571.5,74
"27908","80735","2021",2,2,0,173500,1710.5,85.5
"27909","80736","2021",4,4,0,110412.5,1408.75,71.25
"27910","80737","2021",2,2,0,52000,689.5,72
"27911","80740","2021",2,2,0,280005,2385.5,112.5
"27912","80741","2021",1,1,0,65000,812,80
"27913","80743","2021",5,5,0,151988.4,1830.2,88.2
"27914","80746","2021",10,10,0,144935,1452.2,93.1
"27915","80747","2021",2,2,0,119050,829.5,145.5
"27916","80748","2021",1,1,0,270000,1195,226
"27917","80749","2021",4,4,0,167250,1103,151
"27918","80750","2021",4,4,0,90565,978.5,93.25
"27919","80751","2021",8,8,0,265150,1955.25,135.75
"27920","80752","2021",8,8,0,212911.2,1917.625,110.625
"27921","80754","2021",6,6,0,144083.3,1659.667,84
"27922","80755","2021",3,3,0,253333.3,1888,140
"27923","80757","2021",2,2,0,127500,1211,103.5
"27924","80758","2021",1,1,0,220000,1760,125
"27925","80759","2021",6,6,0,85250,967.3333,91.16667
"27926","80760","2021",4,4,0,102375,1376.75,82.5
"27927","80762","2021",7,7,0,93728.57,945.1429,91.71429
"27928","80763","2021",5,5,0,140260,1463.4,93.4
"27929","80764","2021",4,4,0,89325,1045.75,84.25
"27930","80765","2021",11,11,0,130546.4,1586.636,84.81818
"27931","80766","2021",5,5,0,135935,1208.2,120
"27932","80767","2021",3,3,0,98500,1086,87.33333
"27933","80769","2021",2,2,0,186500,1379.5,134
"27934","80770","2021",8,8,0,135511.2,1396.25,99.625
"27935","80771","2021",1,1,0,55000,859,64
"27936","80774","2021",3,3,0,195066.7,1592.667,124
"27937","80775","2021",11,11,0,164854.5,1688.636,105.6364
"27938","80776","2021",2,2,0,163150,1252.5,130.5
"27939","80777","2021",1,1,0,48000,490,98
"27940","80778","2021",1,1,0,108000,1317,82
"27941","80779","2021",9,9,0,157955.6,1656.556,102.8889
"27942","80780","2021",6,6,0,157766.7,1406,106
"27943","80781","2021",4,4,0,125000,1269.5,99.25
"27944","80782","2021",3,3,0,191666.7,1702.667,111.3333
"27945","80783","2021",1,1,0,133300,1201,111
"27946","80784","2021",2,2,0,138725,1347.5,96
"27947","80785","2021",8,8,0,199382.5,1615.5,115.75
"27948","80787","2021",2,2,0,186500,2247,83
"27949","80788","2021",1,1,0,134140,2064,65
"27950","80789","2021",4,4,0,79740,1126.5,82.75
"27951","80790","2021",1,1,0,215000,1792,120
"27952","80791","2021",11,11,0,214561.5,2176.455,99.90909
"27953","80792","2021",4,4,0,125782.5,1410.25,90.5
"27954","80793","2021",31,30,1,134847.4,1569.129,94.09677
"27955","80794","2021",1,1,0,71500,1192,60
"27956","80795","2021",6,6,0,146083.3,1526.5,100.1667
"27957","80796","2021",1,1,0,1e+05,962,104
"27958","80798","2021",9,9,0,226602.9,1921.556,117.1111
"27959","80799","2021",60,59,1,174337.2,1868.9,95.26667
"27960","80801","2021",6,6,0,139843.3,1567,105
"27961","80802","2021",4,4,0,106250,957.25,102.25
"27962","80803","2021",1,1,0,78000,1054,74
"27963","80804","2021",2,2,0,105000,1569.5,65
"27964","80805","2021",1,1,0,95000,1583,60
"27965","80806","2021",6,6,0,175263.3,1945.667,88.33333
"27966","80807","2021",7,7,0,126357.1,2651.714,72.57143
"27967","80808","2021",3,3,0,239283.3,1554.667,132.3333
"27968","80809","2021",5,5,0,126240,1269.4,93
"27969","80810","2021",1,1,0,175000,2059,85
"27970","80811","2021",6,6,0,113766.7,1091.167,108.1667
"27971","80812","2021",1,1,0,40000,741,54
"27972","80813","2021",2,2,0,52000,518.5,100.5
"27973","80814","2021",9,9,0,119131.1,1318,89.11111
"27974","80815","2021",11,11,0,130481.8,1365.636,94.45455
"27975","80819","2021",1,1,0,212000,2078,102
"27976","80820","2021",10,10,0,109264,1215,88
"27977","80821","2021",3,3,0,96500,1359,68.66667
"27978","80822","2021",2,2,0,164000,1439,117.5
"27979","80823","2021",1,1,0,90000,1324,68
"27980","80824","2021",6,6,0,134333.3,1473.667,99
"27981","80825","2021",1,1,0,25000,1042,24
"27982","80826","2021",16,15,1,120541.9,2277.062,75.4375
"27983","80827","2021",14,14,0,107730,1509.571,74.28571
"27984","80828","2021",1,1,0,60000,1071,56
"27985","80829","2021",2,2,0,95050,691,147.5
"27986","80830","2021",4,4,0,141662.5,1492.25,105.25
"27987","80832","2021",1,1,0,415000,1504,276
"27988","80833","2021",2,2,0,180050,1622,112
"27989","80834","2021",4,4,0,71015,879.25,104.25
"27990","80835","2021",3,3,0,158666.7,1579.667,92.33333
"27991","80836","2021",4,4,0,167750,1573.5,107
"27992","81001","2021",1,1,0,55000,611,90
"27993","81002","2021",33,33,0,119085.5,1129.97,99.69697
"27994","81003","2021",9,9,0,125318.9,1090.889,114.5556
"27995","81004","2021",627,372,255,182603.2,2136.128,87.73684
"27996","81005","2021",6,6,0,149500,1699.167,98.5
"27997","81007","2021",3,3,0,205166.7,1471.333,141
"27998","81008","2021",3,3,0,161566.7,1177,138.3333
"27999","81009","2021",1,1,0,721154,2522,286
"28000","81010","2021",8,8,0,121795,1721.875,81.625
"28001","81011","2021",12,12,0,286369.6,2530.75,119.3333
"28002","81012","2021",1,1,0,230189,1705,135
"28003","81013","2021",2,2,0,124755,1164,102.5
"28004","81014","2021",17,14,3,96886.82,1336.588,90.17647
"28005","81015","2021",1,1,0,204950,1281,160
"28006","81016","2021",8,8,0,45015.25,844.75,54
"28007","81018","2021",23,22,1,189076.6,1816.652,102.7826
"28008","81019","2021",4,4,0,155250,1228.25,128.25
"28009","81020","2021",2,2,0,221500,1604,139
"28010","81021","2021",70,69,1,121099.6,1168.329,102.2429
"28011","81023","2021",3,2,1,66080.33,549,119
"28012","81024","2021",3,3,0,271666.7,2411.333,113.6667
"28013","81025","2021",2,2,0,367450,3122.5,126
"28014","81026","2021",1,1,0,210000,1296,162
"28015","81027","2021",1,1,0,2e+05,1527,131
"28016","81028","2021",3,3,0,37500,691.6667,55.66667
"28017","81029","2021",2,2,0,196500,1894,102.5
"28018","81030","2021",2,2,0,145225,1328.5,108.5
"28019","81031","2021",8,8,0,73911.62,1161.375,70.125
"28020","81032","2021",6,6,0,363600,2385.5,150.3333
"28021","81033","2021",32,30,2,108167.5,1182.719,94.4375
"28022","81034","2021",7,7,0,97671.43,959.4286,96.14286
"28023","81036","2021",9,8,1,152477.8,1454,100.6667
"28024","81037","2021",15,15,0,115585.9,1255.2,95.6
"28025","81038","2021",23,23,0,181871,1736.217,106.087
"28026","81039","2021",30,30,0,162392.2,1376.367,117.1
"28027","81040","2021",1,1,0,146300,1143,128
"28028","81041","2021",1,1,0,190950,1929,99
"28029","81042","2021",22,22,0,148770.2,1429.5,108.4091
"28030","81043","2021",11,11,0,206995.5,1914.636,110.8182
"28031","81044","2021",2,2,0,138600,1101,124
"28032","81045","2021",8,7,1,137296.9,1671.25,89.625
"28033","81046","2021",10,10,0,248374,2186.5,119.2
"28034","81047","2021",2,2,0,47000,541,97
"28035","81048","2021",31,30,1,162108.4,1543.29,104.2581
"28036","81049","2021",2,2,0,193650,2135,89.5
"28037","81050","2021",1,1,0,315112,2060,153
"28038","81051","2021",11,10,1,168281.8,1388.909,121.7273
"28039","81052","2021",6,6,0,235335,1678.5,158.3333
"28040","81053","2021",8,8,0,83743.75,1092.75,82.5
"28041","81054","2021",8,8,0,220981.6,1944.875,114.625
"28042","81055","2021",11,11,0,117502.5,1225.182,97
"28043","81056","2021",2,2,0,290000,2040,137.5
"28044","81059","2021",6,6,0,259661.7,1757.167,142.6667
"28045","81060","2021",126,120,6,117860.6,1156.175,107.9841
"28046","81061","2021",1,1,0,305000,2243,136
"28047","81062","2021",22,21,1,91374.95,972.5,98.63636
"28048","81063","2021",11,11,0,287712.7,1945.909,149.2727
"28049","81064","2021",13,13,0,253783.1,1881.231,135.2308
"28050","81065","2021",551,391,160,145253.4,1582.577,93.02359
"28051","81066","2021",1,1,0,92000,773,119
"28052","81067","2021",7,7,0,333292.9,2672.857,135.2857
"28053","81069","2021",21,19,2,171726.7,1666.143,113.5238
"28054","81070","2021",19,19,0,261867.6,2440.421,111.5263
"28055","81072","2021",1,1,0,265800,2953,90
"28056","81073","2021",1,1,0,170000,1417,120
"28057","81074","2021",10,10,0,200782.5,1923.3,106
"28058","81075","2021",6,6,0,226466.7,1901.167,125.3333
"28059","81076","2021",4,4,0,239192.5,2174,106.5
"28060","81077","2021",12,12,0,125862.5,1554.917,93.5
"28061","81078","2021",12,12,0,159144.6,1360.583,125.8333
"28062","81079","2021",6,6,0,154850,1669.333,99.83333
"28063","81081","2021",18,16,2,168924.5,1572.278,116.8333
"28064","81082","2021",1,1,0,99520,1244,80
"28065","81083","2021",6,6,0,172899,1781.667,100
"28066","81084","2021",11,11,0,152085.5,1377.727,110.6364
"28067","81085","2021",2,2,0,36000,437,83
"28068","81086","2021",5,5,0,84051,1274.4,74.6
"28069","81087","2021",4,4,0,265116.2,2346.75,114
"28070","81088","2021",9,9,0,149788.9,1622.556,99.11111
"28071","81089","2021",1,1,0,160000,1667,96
"28072","81090","2021",1,1,0,173000,1193,145
"28073","81092","2021",16,16,0,217574.4,2004.625,108.3125
"28074","81093","2021",11,11,0,244430.5,2266.636,105.2727
"28075","81094","2021",2,2,0,44250,553.5,80.5
"28076","81095","2021",3,3,0,326743.3,2698.667,109.3333
"28077","81096","2021",8,8,0,124086.9,1315.5,96.875
"28078","81097","2021",8,8,0,265497.5,2416.5,111
"28079","81098","2021",2,2,0,260900,1788,150
"28080","81099","2021",215,165,50,170173.4,1775.112,96.94884
"28081","81100","2021",4,4,0,201375,1653,118.25
"28082","81101","2021",11,11,0,152636.4,1553.545,100.5455
"28083","81102","2021",4,4,0,276537.5,2370.75,116.5
"28084","81103","2021",1,1,0,35000,333,105
"28085","81104","2021",10,10,0,249516.5,1823.1,135
"28086","81105","2021",180,166,14,129633.7,1324.656,100.2444
"28087","81106","2021",6,6,0,329991.7,2034.167,167.1667
"28088","81108","2021",2,2,0,115550,1511.5,87
"28089","81109","2021",1,1,0,71000,1340,53
"28090","81110","2021",3,3,0,134333.3,1759,84
"28091","81111","2021",2,2,0,193425,1757,104.5
"28092","81112","2021",8,8,0,173106.2,1908.625,99.625
"28093","81114","2021",5,5,0,118000,1306.8,100
"28094","81115","2021",28,28,0,76509.64,994,79.71429
"28095","81116","2021",9,9,0,263460,2127.111,129.6667
"28096","81117","2021",10,10,0,184662,1742.8,115
"28097","81118","2021",1,1,0,192500,2265,85
"28098","81119","2021",6,6,0,91450,1147.5,75
"28099","81120","2021",81,75,6,133263.5,1385.099,97.18519
"28100","81121","2021",5,5,0,72700,897.4,77.6
"28101","81123","2021",1,1,0,60000,750,80
"28102","81124","2021",27,25,2,117384.1,1168.481,103.2593
"28103","81125","2021",7,6,1,88509,1779.714,74
"28104","81126","2021",1,1,0,227750,2449,93
"28105","81127","2021",1,1,0,126000,875,144
"28106","81128","2021",7,7,0,85857.14,990.5714,88.28571
"28107","81129","2021",2,2,0,200400,1375.5,142
"28108","81130","2021",26,23,3,141344.2,1567.385,95.5
"28109","81131","2021",16,16,0,242518.2,2038.062,121.0625
"28110","81132","2021",12,12,0,135492.8,1429.25,95.75
"28111","81133","2021",5,5,0,297376,2002.8,163.6
"28112","81134","2021",2,2,0,197500,1831,115
"28113","81135","2021",1,1,0,53250,807,66
"28114","81136","2021",4,4,0,87125,1438.5,88.75
"28115","81138","2021",7,7,0,178507.1,1888.571,99.28571
"28116","81139","2021",15,15,0,173352,1634.133,110.4
"28117","81140","2021",133,99,34,198288.8,1998.571,97.35338
"28118","81141","2021",1,1,0,110000,1294,85
"28119","81142","2021",9,9,0,189194.4,1708.222,112.3333
"28120","81143","2021",5,5,0,145381,1505.6,97.4
"28121","81144","2021",51,50,1,191288.7,1866.078,104.8627
"28122","81145","2021",60,56,4,194102.9,1805.283,107.6167
"28123","81147","2021",8,7,1,223627.5,1611.25,137.75
"28124","81148","2021",1,1,0,295000,3041,97
"28125","81149","2021",7,7,0,216142.9,2205.143,98.71429
"28126","81150","2021",5,5,0,288986.2,2280.4,124.2
"28127","81151","2021",3,3,0,199000,1911.667,102.6667
"28128","81152","2021",4,4,0,451500,2374.5,203.25
"28129","81156","2021",45,44,1,231772.8,2081.444,112.9333
"28130","81157","2021",3,3,0,263933.3,2220.667,118
"28131","81158","2021",5,5,0,91610,1127.2,74.2
"28132","81159","2021",4,3,1,235474.8,2347,111
"28133","81160","2021",4,4,0,97100,1043,98.75
"28134","81163","2021",162,132,30,101998,1025.642,104.4568
"28135","81164","2021",7,7,0,212702.9,2061.143,108.8571
"28136","81167","2021",2,2,0,126900,1804,77.5
"28137","81168","2021",15,14,1,135698,1288.267,111.8
"28138","81169","2021",1,1,0,152000,1689,90
"28139","81170","2021",17,17,0,151507.9,1469.647,102.2353
"28140","81171","2021",14,14,0,208645.7,2049.5,113.5714
"28141","81172","2021",3,3,0,183333.3,1152.333,167
"28142","81173","2021",2,2,0,269500,2692.5,100
"28143","81174","2021",4,4,0,215344,1524.75,150.75
"28144","81175","2021",3,3,0,224166.7,2184.333,102.3333
"28145","81176","2021",1,1,0,44000,489,90
"28146","81177","2021",2,2,0,227600,2294,100.5
"28147","81178","2021",2,2,0,144750,1354,107
"28148","81179","2021",3,3,0,156800,1312.333,119.3333
"28149","81180","2021",6,6,0,263140.8,1542.667,163.3333
"28150","81181","2021",1,1,0,96000,1116,86
"28151","81182","2021",24,24,0,133591.1,1282.417,103.7083
"28152","81185","2021",3,3,0,354393.3,3277.667,111
"28153","81186","2021",5,5,0,71200,704,119.8
"28154","81188","2021",4,4,0,60875,770.75,77.25
"28155","81189","2021",1,1,0,202500,2201,92
"28156","81190","2021",4,4,0,201075,1771.25,117.25
"28157","81191","2021",5,5,0,260400,1826,142.4
"28158","81192","2021",13,12,1,93255.38,1309.308,83.15385
"28159","81193","2021",14,14,0,109125,1431.5,77.64286
"28160","81195","2021",6,6,0,208063.2,1673.333,124.6667
"28161","81196","2021",6,6,0,155309.5,1469.833,104.5
"28162","81197","2021",4,4,0,202003.2,1760.5,116
"28163","81198","2021",2,2,0,257500,2870,95.5
"28164","81199","2021",2,2,0,126200,939.5,126
"28165","81200","2021",4,4,0,209400,1461.75,136.5
"28166","81201","2021",15,15,0,141465.5,1435.4,104.0667
"28167","81202","2021",11,11,0,260531.8,2107.909,129
"28168","81203","2021",8,8,0,107343.8,1031.625,101.375
"28169","81204","2021",12,11,1,122116.7,1392.167,85.25
"28170","81205","2021",1,1,0,110000,1358,81
"28171","81206","2021",13,13,0,149923.1,2227.077,69.07692
"28172","81207","2021",1,1,0,170000,1118,152
"28173","81208","2021",8,8,0,243312.8,2084.625,119.125
"28174","81209","2021",29,29,0,163040,1497.172,109.7586
"28175","81210","2021",4,4,0,259116.2,1714.5,166.25
"28176","81211","2021",2,2,0,239870,2176,111.5
"28177","81213","2021",1,1,0,270000,1837,147
"28178","81214","2021",4,4,0,239265,1838.75,130
"28179","81215","2021",11,11,0,261607,2871.909,110.4545
"28180","81216","2021",1,1,0,272500,1612,169
"28181","81217","2021",8,8,0,189905,1981.5,99.25
"28182","81218","2021",29,29,0,251707.8,2120.69,121.7241
"28183","81219","2021",28,26,2,145747.9,1268.286,119.25
"28184","81220","2021",75,70,5,230925.9,2127.267,111.8533
"28185","81221","2021",2,2,0,103500,835.5,130
"28186","81222","2021",31,29,2,151276.4,1479.355,105.9032
"28187","81223","2021",2,2,0,93000,736,112.5
"28188","81224","2021",3,3,0,200750,1646.667,120
"28189","81225","2021",12,10,2,151331.2,1531.083,100
"28190","81227","2021",18,17,1,103761.3,1114.667,99.38889
"28191","81228","2021",3,3,0,388900,2018.333,199
"28192","81229","2021",1,1,0,283150,1618,175
"28193","81230","2021",8,8,0,158515.8,1259,126.25
"28194","81231","2021",7,7,0,96822.86,1095.429,89.14286
"28195","81232","2021",4,4,0,334049,2280.5,144.5
"28196","81233","2021",22,22,0,137438.6,1331.409,107.6818
"28197","81235","2021",3,3,0,190000,1441,121.3333
"28198","81236","2021",1,1,0,239100,2517,95
"28199","81237","2021",1,1,0,123140,880,140
"28200","81238","2021",11,9,2,90852.73,1141.273,84.45455
"28201","81239","2021",12,12,0,81055,973.6667,76.75
"28202","81240","2021",2,2,0,83000,1201.5,69
"28203","81244","2021",33,33,0,106627.3,1131.03,95.75758
"28204","81245","2021",1,1,0,165000,1650,100
"28205","81246","2021",1,1,0,65000,1585,41
"28206","81247","2021",1,1,0,251800,1259,200
"28207","81248","2021",4,4,0,243775,2412.5,101.75
"28208","81249","2021",8,8,0,164625,1264.5,126.625
"28209","81250","2021",1,1,0,55000,500,110
"28210","81251","2021",10,10,0,186262,1584.5,112.2
"28211","81252","2021",1,1,0,250000,2451,102
"28212","81253","2021",3,3,0,219743.3,3918.333,115.3333
"28213","81254","2021",6,6,0,208135.5,1483.667,143
"28214","81255","2021",4,4,0,217942.5,1956.5,112.25
"28215","81256","2021",1,1,0,186850,2009,93
"28216","81257","2021",78,64,14,158884.9,1722.449,94.57692
"28217","81258","2021",1,1,0,55000,1410,39
"28218","81259","2021",2,2,0,65000,1586,41.5
"28219","81261","2021",8,8,0,297741.2,2313.375,130.25
"28220","81262","2021",2,2,0,380625,2107,185
"28221","81263","2021",6,6,0,138470,1128.167,114.6667
"28222","81264","2021",1,1,0,175000,1750,100
"28223","81265","2021",1,1,0,181450,2110,86
"28224","81266","2021",13,11,2,144474.3,1519.077,91.15385
"28225","81267","2021",15,15,0,98433.33,1032.467,95.66667
"28226","81268","2021",4,4,0,69250,872.5,84.5
"28227","81269","2021",8,8,0,79891.12,1035.375,81
"28228","81270","2021",1,1,0,545625,1700,321
"28229","81271","2021",108,87,21,225220.5,2329.556,97.40741
"28230","81273","2021",38,38,0,187659.1,1799.079,109.8947
"28231","81274","2021",5,5,0,235541.8,2048.2,117.2
"28232","81275","2021",2,1,1,231403,1883,125
"28233","81276","2021",16,16,0,231104.2,1976.812,116.8125
"28234","81277","2021",5,5,0,248344,1627.6,151.6
"28235","81278","2021",2,2,0,112105,1095.5,94
"28236","81279","2021",6,6,0,142840,1310.5,109.6667
"28237","81280","2021",1,1,0,1e+05,1429,70
"28238","81281","2021",18,18,0,161254.6,1765.722,95.55556
"28239","81283","2021",12,12,0,295029.2,2208.083,132.4167
"28240","81284","2021",22,20,2,198086.3,2457.409,84.81818
"28241","81285","2021",1,1,0,60000,632,95
"28242","81286","2021",4,4,0,163562.5,1633.75,100.75
"28243","81288","2021",30,28,2,161441.5,1467.4,108.8
"28244","81289","2021",38,38,0,202010.7,2004.395,103.8421
"28245","81290","2021",4,4,0,341812.5,2066,168.75
"28246","81291","2021",4,4,0,185617.5,1725,108.5
"28247","81292","2021",2,2,0,162500,936,172.5
"28248","81293","2021",2,2,0,238575,1775.5,142.5
"28249","81294","2021",5,5,0,294530,2006.8,158.8
"28250","81295","2021",3,3,0,87666.67,1164.667,76.33333
"28251","81297","2021",14,14,0,263250,2106,128.1429
"28252","81298","2021",1,1,0,4e+05,2051,195
"28253","81299","2021",3,3,0,271330.3,2179.667,121.3333
"28254","81300","2021",1,1,0,540300,3002,180
"28255","81303","2021",4,3,1,87250,1361.75,66.25
"28256","81304","2021",3,3,0,136000,1212.667,115.3333
"28257","81305","2021",12,12,0,96040,944.3333,96.91667
"28258","81306","2021",5,5,0,186750,1780.4,106.6
"28259","81307","2021",8,8,0,202500,2112,97.5
"28260","81308","2021",7,7,0,135714.3,1196.857,119.1429
"28261","81309","2021",6,6,0,226241.7,1630.667,143.6667
"28262","81310","2021",1,1,0,285675,2621,109
"28263","81311","2021",4,4,0,187521.2,1135.75,173.25
"28264","81312","2021",11,11,0,165450,1526.364,108.4545
"28265","81313","2021",4,4,0,140375,1275,110
"28266","81314","2021",11,11,0,87051.73,905,97.81818
"28267","81315","2021",16,16,0,159708.9,1745.312,95.4375
"28268","81316","2021",1,1,0,240000,2243,107
"28269","81317","2021",16,16,0,171370,1617,106.5
"28270","81319","2021",2,2,0,171350,1787,96.5
"28271","81320","2021",1,1,0,40015,445,90
"28272","81321","2021",1,1,0,1e+05,1667,60
"28273","81322","2021",5,5,0,187711.2,1491,125
"28274","81323","2021",6,6,0,179133.3,2523.667,71.33333
"28275","81324","2021",2,2,0,244875,2221,112.5
"28276","81325","2021",15,15,0,203174.3,1741.333,122.3333
"28277","81326","2021",2,2,0,193947,2106.5,92.5
"28278","82001","2021",7,7,0,226528.1,1880.857,114
"28279","82002","2021",35,24,11,136640,1614.657,82.62857
"28280","82003","2021",3,3,0,249678.7,1805.667,160.3333
"28281","82005","2021",22,22,0,214933.9,2085.136,103
"28282","82006","2021",2,2,0,292000,3158,114.5
"28283","82007","2021",1,1,0,83645,1046,80
"28284","82008","2021",18,17,1,151722.2,1191.611,128.7778
"28285","82009","2021",2,2,0,82525,583,140
"28286","82010","2021",4,4,0,181700,1428,133
"28287","82011","2021",8,8,0,209925,1806.75,118.125
"28288","82012","2021",11,11,0,153706.4,1582.909,98.09091
"28289","82013","2021",59,58,1,130631.6,1277.915,111.0847
"28290","82014","2021",2,2,0,275000,1672,195
"28291","82015","2021",1,1,0,184600,1634,113
"28292","82016","2021",4,4,0,256607.8,2299.25,118
"28293","82017","2021",24,22,2,184549.6,1830.5,102.2083
"28294","82018","2021",25,24,1,202566.2,1531.6,132.12
"28295","82019","2021",12,12,0,158907.5,1494.083,110.8333
"28296","82020","2021",13,13,0,231041.2,1496.385,154.5385
"28297","82021","2021",1,1,0,233000,2479,94
"28298","82022","2021",5,5,0,105400,1057.6,93.8
"28299","82023","2021",14,13,1,169657.3,1445.214,119.7143
"28300","82024","2021",2,2,0,120500,968,137.5
"28301","82025","2021",39,37,2,226036.9,1995.462,113.3077
"28302","82026","2021",18,18,0,238108.3,1797.722,138.9444
"28303","82027","2021",19,19,0,211402.4,2035.895,106.4737
"28304","82028","2021",11,11,0,194713.6,2264.091,103.2727
"28305","82029","2021",8,8,0,141635.5,1925,78
"28306","82030","2021",12,12,0,143695.8,1377.167,108.9167
"28307","82031","2021",13,13,0,166600,1589.462,103.4615
"28308","82032","2021",9,9,0,139294.4,1236.556,114.7778
"28309","82033","2021",199,138,61,144928.6,1513.834,95.61307
"28310","82034","2021",2,2,0,114500,1287.5,92.5
"28311","82035","2021",8,8,0,167200,1493,121.5
"28312","82037","2021",117,87,30,138104.6,1550.308,88.53846
"28313","82038","2021",36,33,3,122780.9,1396.833,93.36111
"28314","82039","2021",5,5,0,224640,2037.6,111.4
"28315","82040","2021",5,5,0,197506,1640,113.4
"28316","82041","2021",5,5,0,113061,1313.8,95.4
"28317","82042","2021",19,18,1,150137.6,1387.211,115.6842
"28318","82043","2021",6,6,0,140000,1121.5,125.6667
"28319","82044","2021",27,22,5,182293.3,1907.481,92.07407
"28320","82045","2021",10,10,0,236039.2,1575.2,152.5
"28321","82048","2021",34,28,6,185139.1,1902.882,97.5
"28322","82049","2021",16,16,0,139762.5,1411.75,96.625
"28323","82050","2021",16,16,0,130410.6,1264.125,105.125
"28324","82051","2021",10,10,0,155364.7,1064.9,148.6
"28325","82052","2021",16,16,0,201484.4,2037.875,101.4375
"28326","82053","2021",6,6,0,145666.7,1360.667,106.6667
"28327","82054","2021",8,8,0,133975,1310.625,108.75
"28328","82055","2021",3,3,0,215420,1097.333,162.6667
"28329","82056","2021",1,1,0,185500,2061,90
"28330","82057","2021",10,10,0,311587,2257.4,140.6
"28331","82058","2021",3,3,0,181666.7,1802,100.3333
"28332","82059","2021",4,4,0,120165,1038.25,121.25
"28333","82060","2021",3,3,0,355487,1234.333,245.3333
"28334","82061","2021",7,7,0,136205.3,1679.571,92.28571
"28335","82062","2021",22,21,1,171477.3,1691.955,107.4545
"28336","82063","2021",11,10,1,176286.4,1553.545,109.7273
"28337","82064","2021",1,1,0,86000,1132,76
"28338","82065","2021",2,2,0,250000,1713,144
"28339","82066","2021",6,6,0,287166.7,2127,132
"28340","82067","2021",3,3,0,133530,1505.333,86.66667
"28341","82068","2021",4,4,0,195500,1562,124.75
"28342","82069","2021",8,8,0,193512.5,1742.5,114.25
"28343","82070","2021",3,3,0,193716.7,1826.667,114.3333
"28344","82072","2021",6,6,0,157433.3,1412.667,118.8333
"28345","82073","2021",13,13,0,173610.8,1556,114.7692
"28346","82074","2021",4,4,0,193000,1351.5,143.25
"28347","82075","2021",58,50,8,200104.9,2127.069,94.46552
"28348","82076","2021",18,18,0,180409.2,1892.222,95.61111
"28349","82077","2021",4,4,0,224074.8,1899.75,117.75
"28350","82078","2021",2,2,0,171500,1402,120
"28351","82079","2021",47,42,5,204273.9,1943.702,106.8085
"28352","82080","2021",14,14,0,155792.9,1695.786,91.28571
"28353","82081","2021",4,4,0,145425,1159.5,130.75
"28354","82082","2021",2,2,0,193500,2901.5,70.5
"28355","82083","2021",4,4,0,206375,1383.25,148.25
"28356","82084","2021",3,3,0,136310,1073.667,150
"28357","82085","2021",10,10,0,272250,1513.3,190.7
"28358","82086","2021",2,2,0,170150,1315.5,174.5
"28359","82087","2021",43,42,1,188261.6,1854.674,108.8837
"28360","82088","2021",19,18,1,118225.8,1432.474,94.10526
"28361","82089","2021",25,23,2,127720.4,976.6,141.04
"28362","82090","2021",12,12,0,203670.8,1837.417,117.0833
"28363","82091","2021",1,1,0,185000,1480,125
"28364","82092","2021",2,2,0,160000,2129.5,79.5
"28365","82093","2021",7,7,0,148500,1378.429,138.4286
"28366","82094","2021",33,32,1,151896.8,1565.061,97.51515
"28367","82095","2021",7,7,0,190461.1,1331.429,137.8571
"28368","82096","2021",70,59,11,165024,1745.057,97.77143
"28369","82097","2021",18,18,0,133471.1,1210.722,115.0556
"28370","82098","2021",17,17,0,256855.8,2125.294,125
"28371","82099","2021",14,14,0,208543.9,1925.5,116.4286
"28372","82100","2021",7,7,0,202693.1,1627.714,114.5714
"28373","82101","2021",17,17,0,122780.5,1067.706,120.7647
"28374","82102","2021",5,5,0,183837,977.2,153.6
"28375","82104","2021",1,1,0,146200,1624,90
"28376","82105","2021",19,19,0,150149.7,1534.263,102
"28377","82106","2021",3,3,0,100333.3,870.6667,115
"28378","82107","2021",1,1,0,270000,1875,144
"28379","82108","2021",21,20,1,184337.6,1738.238,110.0476
"28380","82109","2021",2,2,0,108750,916,118
"28381","82110","2021",10,10,0,196385,1901.7,106.1
"28382","82111","2021",3,3,0,131900,1506,91.66667
"28383","82112","2021",201,167,34,124406,1390.955,96.60697
"28384","82113","2021",22,20,2,162429.1,1432.591,113.9091
"28385","82114","2021",12,12,0,256591.7,1918.083,140
"28386","82115","2021",45,45,0,124027.4,1301.978,92.73333
"28387","82116","2021",2,2,0,257500,1300.5,195
"28388","82117","2021",28,27,1,185433.1,1703.643,110.9643
"28389","82119","2021",4,4,0,181520,1709,101.75
"28390","82120","2021",1,1,0,184500,1153,160
"28391","82121","2021",1123,601,522,177449.7,2000.396,87.73019
"28392","82123","2021",27,19,8,200894.4,1910.37,98.66667
"28393","82124","2021",72,56,16,174764.8,1771.139,98.875
"28394","82125","2021",95,88,7,193446.1,1875.947,106.3684
"28395","82126","2021",15,15,0,176414,1818.333,101.8
"28396","82127","2021",6,6,0,121016.7,1266.5,93.5
"28397","82129","2021",1,1,0,125000,1190,105
"28398","82130","2021",5,5,0,247300,1838.4,134.8
"28399","82131","2021",31,30,1,134745.6,1378.065,103.4839
"28400","82132","2021",15,15,0,132855.3,1298.133,103.8667
"28401","82133","2021",2,2,0,177000,2216.5,80
"28402","82134","2021",78,66,12,191427.2,1851.128,101.359
"28403","82135","2021",17,17,0,221880.6,2136,109.8235
"28404","82136","2021",33,32,1,210500.6,1982.758,104.9091
"28405","82137","2021",10,9,1,174782.8,1728.1,97
"28406","82138","2021",3,3,0,139666.7,1768.667,95
"28407","82139","2021",1,1,0,148000,2000,74
"28408","82140","2021",4,4,0,117785.8,1363.25,85.5
"28409","82141","2021",10,8,2,118320,1076.5,125.7
"28410","82142","2021",26,26,0,222975.3,2342.077,98.38462
"28411","82143","2021",5,4,1,244682,1890.8,137.2
"28412","82144","2021",9,9,0,189805.6,1721,115.8889
"28413","82145","2021",4,4,0,319194,1495.5,202.75
"28414","82146","2021",2,2,0,237400,1374.5,171.5
"28415","82147","2021",8,8,0,164731.1,2099.5,85.375
"28416","82148","2021",25,25,0,141869.8,1486.96,94.64
"28417","82149","2021",20,19,1,155475,1570.2,99.95
"28418","82150","2021",9,9,0,193877.8,1735.111,126.3333
"28419","82151","2021",11,11,0,212485.5,2008.727,111.7273
"28420","82152","2021",4,4,0,80802,1014,90.5
"28421","82153","2021",5,5,0,219510,1807.8,119.8
"28422","82154","2021",4,4,0,310760,2607.5,121.25
"28423","82155","2021",45,42,3,192011.5,2254.6,90.06667
"28424","82156","2021",1,1,0,90000,1047,86
"28425","82157","2021",4,4,0,279964.5,1997,172.5
"28426","82158","2021",1,1,0,660000,4099,161
"28427","82159","2021",6,6,0,197845,1776.5,108.8333
"28428","82160","2021",6,6,0,144250,1427.5,96.66667
"28429","82161","2021",43,37,6,194321.9,1945.767,101.3023
"28430","82162","2021",4,4,0,202250,1872,108.25
"28431","82164","2021",1,1,0,499000,2376,210
"28432","82165","2021",12,12,0,164207.4,1257.583,119.5833
"28433","82166","2021",5,5,0,101600,1089.4,89.6
"28434","82167","2021",16,16,0,244243.3,2249.75,107.9375
"28435","82168","2021",7,7,0,201045,1444.571,143.1429
"28436","82169","2021",28,26,2,176473.6,1508.607,115.7857
"28437","82170","2021",7,7,0,164142.9,1856.857,96.28571
"28438","82171","2021",20,20,0,185442.6,1881.1,124.65
"28439","82172","2021",8,8,0,166647.5,1461,106.125
"28440","82173","2021",35,24,11,132482,1367.257,94.25714
"28441","82174","2021",1,1,0,216000,2400,90
"28442","82176","2021",11,11,0,295760.5,2099.182,150.2727
"28443","82177","2021",2,2,0,145903,849.5,172.5
"28444","82178","2021",9,9,0,278558.9,2194.111,128.8889
"28445","82179","2021",36,35,1,137326,1579.944,90.33333
"28446","82180","2021",3,3,0,186833.3,906,205.6667
"28447","82181","2021",3,3,0,162156.7,1084,128.6667
"28448","82182","2021",11,11,0,163349.2,1646.091,94.63636
"28449","82183","2021",4,4,0,156662.5,1818.75,92
"28450","82184","2021",11,11,0,220218,1681.727,130.2727
"28451","82186","2021",73,64,9,120201.9,1386.918,89.87671
"28452","82187","2021",25,24,1,149981.6,1464.28,104.44
"28453","82188","2021",10,10,0,185180,1526.3,124.4
"28454","82189","2021",5,5,0,109420,1145,95.6
"28455","82190","2021",106,71,35,151248.3,1840.368,83.0566
"28456","82191","2021",13,13,0,159344.6,1646.308,88.15385
"28457","82192","2021",14,14,0,187184.4,1910.357,110
"28458","82193","2021",1,1,0,234600,2234,105
"28459","82194","2021",16,15,1,161044.4,1860.688,91.4375
"28460","82195","2021",11,11,0,224063.6,1860.545,125.1818
"28461","83001","2021",33,30,3,498677.6,3944.303,128.9091
"28462","83002","2021",4,3,1,164250,2761.75,53.25
"28463","83003","2021",12,9,3,198140.8,2199.167,80.16667
"28464","83004","2021",123,69,54,255803.9,2938.016,86.15447
"28465","83005","2021",5,4,1,231834,2170.6,104
"28466","83006","2021",3,3,0,266153.3,2320,115.6667
"28467","83007","2021",48,37,11,226222.3,2321.271,96.5
"28468","83008","2021",56,45,11,325541.2,3351.571,98.30357
"28469","83009","2021",501,78,423,350443,5969.723,59.13772
"28470","83010","2021",3,1,2,219333.3,2443.667,87.66667
"28471","83011","2021",41,23,18,223502.7,2275.22,91.29268
"28472","83012","2021",50,37,13,226020.9,2490.86,93.64
"28473","83013","2021",5,5,0,123948,1747.8,77.4
"28474","83014","2021",5,5,0,249190,1902.2,134.4
"28475","83015","2021",3,2,1,168333.3,4006,40
"28476","83016","2021",193,114,79,360966.8,4057.026,86.46114
"28477","83017","2021",46,31,15,262640.9,3312.891,83.47826
"28478","83018","2021",47,44,3,277154.2,3052.745,97.70213
"28479","83019","2021",450,140,310,311393.2,4968.778,60.52
"28480","83021","2021",47,43,4,305537,3120.213,100.0638
"28481","83023","2021",218,126,92,202638,2381.362,84.94495
"28482","83025","2021",11,6,5,144308.2,2214.455,59.63636
"28483","83026","2021",32,30,2,241510.6,2611,98.40625
"28484","83027","2021",100,87,13,610069.1,5229.14,111.76
"28485","83028","2021",33,25,8,236775.3,2761.909,91
"28486","83029","2021",63,51,12,396236.3,3721.937,104.8571
"28487","83030","2021",23,21,2,303359.6,2852.783,107.0435
"28488","83031","2021",53,39,14,235805,2880.245,83.79245
"28489","83032","2021",63,48,15,221094.8,2435.794,89.47619
"28490","83033","2021",72,53,19,240913,2777.986,90.66667
"28491","83034","2021",229,87,142,463380.9,5357.651,81.9738
"28492","83035","2021",98,75,23,409036.2,4518.643,86.52041
"28493","83036","2021",367,105,262,354486.9,5060.856,66.6703
"28494","83037","2021",15,14,1,302489.6,3196.067,102.4
"28495","83038","2021",3,2,1,197166.7,1954.333,93.66667
"28496","83040","2021",3,3,0,153333.3,2292.333,65.33333
"28497","83041","2021",18,15,3,184817.6,2102,88.38889
"28498","83042","2021",195,72,123,258045.9,3919.482,68.22564
"28499","83043","2021",57,37,20,199096.8,2675.211,76.01754
"28500","83044","2021",9,6,3,127880.6,2004.222,73.33333
"28501","83045","2021",20,19,1,254828.8,2538.7,97.45
"28502","83046","2021",49,38,11,390182.5,3177.49,117.4694
"28503","83047","2021",221,169,52,355554.8,3952.181,90.30317
"28504","83048","2021",167,74,93,583535.3,6468.503,79.73054
"28505","83049","2021",246,164,82,277204,3297.947,82.74797
"28506","83050","2021",556,191,365,196309.4,2280.633,81.16906
"28507","83051","2021",21,17,4,217473,2427.381,88.38095
"28508","83052","2021",6,6,0,79133.33,1434.667,68
"28509","83053","2021",30,21,9,371752,3675.167,100.2667
"28510","83054","2021",133,87,46,341930.8,3810.098,91.88722
"28511","83055","2021",112,85,27,325110.3,3530.973,98.34821
"28512","83056","2021",34,32,2,307698.6,2902.559,113.5882
"28513","83057","2021",42,38,4,298981.2,2724.31,113.0476
"28514","83058","2021",85,67,18,383684,3088.824,119.9647
"28515","83059","2021",61,42,19,240495.7,3010.197,82.31148
"28516","83060","2021",10,10,0,271360,2347.5,123.9
"28517","83061","2021",1176,257,919,255340.7,3854.786,67.08418
"28518","83062","2021",371,116,255,274815.6,3519.833,76.57143
"28519","83063","2021",41,31,10,476578.7,3843.366,109.0244
"28520","83064","2021",81,79,2,313112.3,3199.16,102.0617
"28521","83065","2021",89,53,36,616580.4,6436.921,81.77528
"28522","83066","2021",20,18,2,240191,2443.3,102.3
"28523","83067","2021",62,55,7,208356.9,2504.71,89.24194
"28524","83068","2021",218,102,116,587211.8,6368.986,87.99541
"28525","83069","2021",1336,305,1031,277739.6,4048.85,67.83458
"28526","83070","2021",484,76,408,315603.5,5478.607,54.24587
"28527","83071","2021",435,187,248,298183.8,4991.676,62.3908
"28528","83072","2021",162,127,35,300103.2,2949.636,100.5062
"28529","83073","2021",135,91,44,205480.9,2548.074,82.38519
"28530","83074","2021",5,5,0,170720,2284,80.2
"28531","83075","2021",13,12,1,246026.9,2612.231,91.76923
"28532","83076","2021",14,13,1,187985.1,2624.286,71.35714
"28533","83077","2021",29,28,1,321899.8,3159,106.5517
"28534","83078","2021",11,11,0,337269.4,3104.909,108.8182
"28535","83079","2021",30,22,8,457147.4,4308.633,102.1
"28536","83080","2021",37,36,1,309340.8,2919.568,108.9189
"28537","83081","2021",105,74,31,399995.5,3700.762,109.4952
"28538","83082","2021",4,3,1,214855,3783,60.75
"28539","83083","2021",30,25,5,235281,2527.233,95.26667
"28540","83084","2021",15,14,1,195716.7,2047.733,107.0667
"28541","83085","2021",64,54,10,346725.7,3708.281,96.57812
"28542","83086","2021",107,72,35,252349,2684.112,89.73832
"28543","83087","2021",70,57,13,308446,3383.614,96.75714
"28544","83088","2021",33,32,1,288182.7,2626.333,112.5152
"28545","83089","2021",5,5,0,355060,3016.8,125
"28546","83090","2021",196,97,99,333733.4,3717.418,87.41837
"28547","83091","2021",48,37,11,377179.3,3427.312,102.5
"28548","83092","2021",74,59,15,224083.4,2587,86.5
"28549","83093","2021",31,25,6,295460.1,3317.71,97.03226
"28550","83094","2021",65,53,12,559808,4501.2,109.7692
"28551","83095","2021",14,14,0,203548.6,2656.5,76.35714
"28552","83096","2021",20,17,3,281584.5,3643.55,86.35
"28553","83097","2021",51,46,5,401688.5,3727.902,107.2157
"28554","83098","2021",200,74,126,330197,4326.96,75.575
"28555","83099","2021",114,62,52,309382.6,3211.421,93.39474
"28556","83100","2021",70,51,19,237842.9,2717.357,88.3
"28557","83101","2021",22,17,5,1476825,9423.636,140.2273
"28558","83102","2021",50,48,2,254828.1,2648,98.68
"28559","83103","2021",51,48,3,407858.4,4001.412,103.7255
"28560","83104","2021",75,67,8,231209.5,2626.053,88.81333
"28561","83106","2021",79,77,2,291717.5,2928.57,103.4557
"28562","83107","2021",460,272,188,376664.8,4292.185,86.1
"28563","83108","2021",34,31,3,251673.1,2764.235,95.85294
"28564","83109","2021",4,4,0,177490,2467.75,69
"28565","83110","2021",12,10,2,237135.5,2768.667,85.91667
"28566","83111","2021",30,25,5,261180.6,2671.4,99.73333
"28567","83112","2021",370,146,224,420824.7,5495.427,77.47297
"28568","83113","2021",48,48,0,280440.9,2607.292,98.33333
"28569","83114","2021",6,6,0,212889.2,2502.833,83.5
"28570","83115","2021",492,153,339,406549.3,5445.508,67.94919
"28571","83116","2021",186,143,43,304383.3,3306.022,91.92473
"28572","83117","2021",38,34,4,368860.1,3440.316,110.8158
"28573","83118","2021",1140,286,854,342619,4428.602,74.31667
"28574","83119","2021",98,11,87,529882.2,8103.439,64.71429
"28575","83120","2021",62,42,20,317385.3,3365.306,94.70968
"28576","83121","2021",70,59,11,306252.5,2702.714,112.4
"28577","83122","2021",8,2,6,114184.4,2636.125,60
"28578","83123","2021",609,191,418,379236.5,5637.714,67.73235
"28579","83124","2021",55,41,14,406634.3,3468.927,111.3636
"28580","83125","2021",39,36,3,280942.8,3067.974,92.71795
"28581","83126","2021",1415,357,1058,218283.2,3353.566,65.14276
"28582","83127","2021",50,38,12,279614.5,3227.98,87.16
"28583","83128","2021",16,16,0,234212.5,2194.875,107.9375
"28584","83129","2021",1077,344,733,302321.9,4730.287,65.93593
"28585","83130","2021",177,116,61,284376.9,3430.249,83.63842
"28586","83131","2021",79,67,12,353453.4,3643.38,98.22785
"28587","83132","2021",25,21,4,382831.6,3480.84,113.52
"28588","83133","2021",11,9,2,418713.6,4063.545,110.5455
"28589","83134","2021",27,26,1,318291.6,2962.37,108.4815
"28590","83135","2021",17,17,0,201452.9,2449.118,84
"28591","83136","2021",50,48,2,302204.5,2972.68,106.8
"28592","83137","2021",3522,545,2977,193926.2,2888.52,65.57836
"28593","83138","2021",64,55,9,363531,3865.812,98.70312
"28594","83139","2021",17,14,3,376123.9,2966.118,118.0588
"28595","83140","2021",57,47,10,264712.4,3081.947,89.96491
"28596","83141","2021",73,59,14,278602.3,2815.37,99.32877
"28597","83142","2021",3,2,1,153333.3,2975.333,50.33333
"28598","83143","2021",70,66,4,258438,2622.071,104.9286
"28599","83144","2021",422,95,327,231191.6,3301.815,71.31043
"28600","83145","2021",23,17,6,152452.2,2293.522,73.30435
"28601","83146","2021",41,38,3,215641.4,2344.22,90.07317
"28602","83148","2021",188,134,54,230907.1,2857.761,81.00532
"28603","83149","2021",24,19,5,357952.3,3214.75,118.7083
"28604","83150","2021",40,30,10,223504.4,2628.975,85.45
"28605","83151","2021",10,8,2,151000,1830.8,83.3
"28606","83152","2021",21,12,9,554255.6,6323.714,91.7619
"28607","83153","2021",188,35,153,228349.6,4350.138,50.80851
"28608","83154","2021",20,20,0,290993.5,2800.75,108.15
"28609","84001","2021",24,15,9,298420.1,2746.625,110.7917
"28610","84002","2021",14,14,0,397428.6,3852.714,94.21429
"28611","84003","2021",218,126,92,200711.9,2187.913,85.5
"28612","84004","2021",106,95,11,254594.5,2646.094,92.5
"28613","84005","2021",6,6,0,205384.8,2245.667,96
"28614","84006","2021",1,1,0,975000,4432,220
"28615","84007","2021",1762,510,1252,161714.7,2449.155,67.95403
"28616","84008","2021",15,14,1,372033.3,3034,122.6
"28617","84009","2021",33,30,3,231143.2,2707.364,82.66667
"28618","84010","2021",14,13,1,399630.7,3808.357,101.7143
"28619","84011","2021",9,5,4,282156.7,2783.444,88.66667
"28620","84012","2021",43,36,7,253226.3,2828.209,95.18605
"28621","84013","2021",9,5,4,707903.7,5965.444,132.5556
"28622","84014","2021",22,19,3,307119.4,2818.909,95.68182
"28623","84015","2021",4,4,0,216220,2428.25,87
"28624","84016","2021",63,61,2,273320.3,2603.603,106.5714
"28625","84017","2021",70,64,6,270936.6,2885.471,96.47143
"28626","84018","2021",6,6,0,402566.7,3271,111.6667
"28627","84019","2021",187,154,33,180337.4,1870.465,94.13904
"28628","84020","2021",48,43,5,785492.5,5492.583,129.0417
"28629","84021","2021",4,4,0,215062.5,1857.75,92.5
"28630","84022","2021",10,10,0,298343.9,2953.9,106.7
"28631","84024","2021",15,15,0,396670.6,3093.867,113.3333
"28632","84025","2021",38,33,5,641534.9,4831.974,122.7105
"28633","84026","2021",70,55,15,281717.8,3413.843,85.07143
"28634","84027","2021",30,29,1,260300.7,2653.733,102.0667
"28635","84028","2021",17,16,1,258574.4,2052.118,122.4118
"28636","84029","2021",51,49,2,232392.4,2477.804,97.37255
"28637","84030","2021",50,45,5,265761.9,2858,95.96
"28638","84031","2021",487,283,204,193947.9,2204.066,86.44148
"28639","84032","2021",7,7,0,294018.6,2576.286,116.5714
"28640","84033","2021",5,5,0,335800,2852,99.4
"28641","84034","2021",63,52,11,247243.5,2541,95.01587
"28642","84035","2021",435,233,202,206994.4,2388.294,83.93333
"28643","84036","2021",40,36,4,301375,2818.85,111.45
"28644","84037","2021",17,12,5,243705.9,2280.412,107.2353
"28645","84038","2021",37,37,0,364955.3,3481.351,106.973
"28646","84039","2021",92,74,18,223549.8,2317,95.90217
"28647","84040","2021",7,7,0,528044.3,3688.714,136.2857
"28648","84041","2021",15,15,0,455323.3,4122.267,111.2
"28649","84042","2021",37,34,3,516983.1,4056.135,114.027
"28650","84043","2021",111,90,21,234506.5,2641.541,88.14414
"28651","84044","2021",16,16,0,316403.4,3576.25,103.3125
"28652","84045","2021",9,9,0,394039,3308.222,124.7778
"28653","84046","2021",7,7,0,316185.7,3469.143,107.4286
"28654","84047","2021",40,40,0,335715.5,3061.775,106.9
"28655","84048","2021",3,3,0,199183.3,3145.667,61.66667
"28656","84049","2021",4,4,0,532500,3993.75,137.75
"28657","84050","2021",67,63,4,915201.4,6048.881,147.7463
"28658","84051","2021",29,29,0,760775.8,4686.448,145.6207
"28659","84052","2021",24,23,1,381875.5,3157.208,116.125
"28660","84053","2021",17,16,1,200671.2,2149.118,93.23529
"28661","84054","2021",360,238,122,295597.5,3328.942,87.63889
"28662","84055","2021",24,24,0,383636.4,3370.917,114.7083
"28663","84056","2021",61,51,10,207312.5,2437.738,87.01639
"28664","84057","2021",7,5,2,678452.1,5781,106.8571
"28665","84058","2021",12,12,0,571425,5070.75,119.5
"28666","84059","2021",1,1,0,735000,6562,112
"28667","84061","2021",3,3,0,579550,3395,164
"28668","84062","2021",28,26,2,447955.7,3597.75,125.6429
"28669","84063","2021",5,5,0,444369,2983,159.8
"28670","84064","2021",56,44,12,174369.8,1917.589,94.375
"28671","84065","2021",68,61,7,335448.2,3539.426,98.01471
"28672","84066","2021",6,6,0,390406.7,3677.5,112.3333
"28673","84067","2021",18,17,1,400231.2,3074.444,130.9444
"28674","84068","2021",45,35,10,623390.4,5233.844,109.7333
"28675","84069","2021",55,47,8,244604.9,2508.873,101
"28676","84070","2021",32,30,2,228280.7,2086.75,108.4688
"28677","84071","2021",32,27,5,435407,3744.906,120.2188
"28678","84072","2021",98,88,10,332972.4,3175.408,98.62245
"28679","84073","2021",31,28,3,626126.5,5023.452,121.9355
"28680","84074","2021",41,38,3,387720,3442.122,111.6098
"28681","84075","2021",10,10,0,358945.7,3309.4,105.6
"28682","84076","2021",21,19,2,299125.8,2917.143,101.8095
"28683","84077","2021",11,11,0,294210,2633.091,111
"28684","84078","2021",40,29,11,195816.8,2079.175,92.775
"28685","84079","2021",5,5,0,241000,1876.6,128.6
"28686","84080","2021",169,120,49,228140.9,2546.337,89.32544
"28687","84081","2021",135,111,24,263567,2734.815,98.59259
"28688","84082","2021",30,26,4,246006.7,2436.267,99.93333
"28689","84083","2021",41,41,0,256956.1,2426.171,109.7317
"28690","84084","2021",26,25,1,365328.5,4157.769,89.42308
"28691","84085","2021",12,12,0,457483.3,3500.583,131.0833
"28692","84086","2021",32,30,2,791251.2,5399.75,146.7812
"28693","84087","2021",390,224,166,184978.8,2208.833,82.6641
"28694","84088","2021",117,108,9,398275.1,3348.983,116.812
"28695","84089","2021",372,185,187,228808.9,3064.519,74.68548
"28696","84090","2021",15,13,2,391965,2980.733,125.6667
"28697","84091","2021",66,61,5,232476.4,2326.561,98.95455
"28698","84092","2021",306,158,148,156325.1,2055.837,75.56209
"28699","84093","2021",18,17,1,500575.5,3942.222,132.2222
"28700","84094","2021",8,8,0,554895.6,4658,136.75
"28701","84095","2021",15,15,0,521240.3,3644.867,134.1333
"28702","84096","2021",7,7,0,350017.1,2758.571,129.2857
"28703","84097","2021",7,6,1,243414.3,2169,103
"28704","84098","2021",9,7,2,305223.3,2628,105.2222
"28705","84099","2021",60,56,4,318988.3,3311.15,98.78333
"28706","84100","2021",1,1,0,198000,1356,146
"28707","84101","2021",7,7,0,616420,3977,145.7143
"28708","84102","2021",35,34,1,494532.2,3661.2,136
"28709","84103","2021",17,12,5,328410,3186.941,97.52941
"28710","84104","2021",24,19,5,259398.5,2455.75,101
"28711","84105","2021",25,23,2,315075.6,3338.24,103.2
"28712","84106","2021",44,27,17,181449.8,2242.159,81.68182
"28713","84107","2021",8,8,0,148090,2073.125,73.5
"28714","84108","2021",42,35,7,392069.2,3234.738,115.3333
"28715","84109","2021",3,3,0,722465,5352.333,173.3333
"28716","84110","2021",1,1,0,82000,1464,56
"28717","84111","2021",4,4,0,452962.5,3566.25,125.5
"28718","84112","2021",25,24,1,213083.2,2362.24,89.4
"28719","84113","2021",19,17,2,317257.1,2917.632,105.7368
"28720","84114","2021",4,4,0,668250,3000.5,231
"28721","84115","2021",7,7,0,397857.1,3098.429,135.7143
"28722","84116","2021",12,12,0,312171.7,3024.5,105.1667
"28723","84117","2021",6,6,0,252993.3,2154.833,116.8333
"28724","84118","2021",71,68,3,400968.6,3535.563,116.1408
"28725","84119","2021",55,45,10,277033.9,2735.291,101.1273
"28726","84120","2021",5,5,0,169095.8,1709,96.6
"28727","84121","2021",7,6,1,295635.7,2957.571,135.2857
"28728","84122","2021",63,58,5,253440.3,2407.19,106
"28729","84123","2021",24,22,2,283338.2,2175.708,121.875
"28730","84124","2021",31,15,16,420096.5,4075,97.51613
"28731","84126","2021",12,12,0,459101.2,3373.25,134.8333
"28732","84127","2021",33,33,0,296212.6,2912.394,108.3333
"28733","84128","2021",1,1,0,350000,2917,120
"28734","84129","2021",268,180,88,195689.1,2221.284,86.79104
"28735","84130","2021",4,4,0,607130,4038.75,148.5
"28736","84131","2021",25,24,1,395560.8,3535.8,113.24
"28737","84132","2021",117,106,11,314265.4,3224.145,100.2564
"28738","84133","2021",52,44,8,259545.7,2886.942,91.32692
"28739","84134","2021",7,7,0,322722.9,2448.429,133.4286
"28740","84135","2021",27,27,0,460429.1,3583.741,142.3704
"28741","84136","2021",15,14,1,273574.7,2679.333,105.6
"28742","84137","2021",109,78,31,307128.6,3076.697,97.61468
"28743","84138","2021",154,127,27,170411.5,1818.325,92.97403
"28744","84139","2021",11,7,4,203851.8,2798.636,73.90909
"28745","84140","2021",14,12,2,567780.7,5419.857,105.7143
"28746","84141","2021",136,116,20,248086.6,2811.493,90.05882
"28747","84142","2021",43,38,5,310952.1,3203.953,99.04651
"28748","84143","2021",19,19,0,518497.4,3813,136.5263
"28749","84144","2021",16,13,3,350659.4,3334,97.875
"28750","84145","2021",10,10,0,288624,2726.3,102.6
"28751","84146","2021",5,5,0,244532,2646.6,99.6
"28752","84147","2021",43,36,7,324610.2,3317.209,103.0465
"28753","84148","2021",36,36,0,182002.1,2324.306,84.16667
"28754","84149","2021",12,12,0,221211.4,2222.5,98.33333
"28755","84150","2021",17,17,0,236908.8,2337.294,99.17647
"28756","84151","2021",6,4,2,238965.7,2826.5,83.66667
"28757","85001","2021",174,164,10,181658.9,2594.046,76.07471
"28758","85002","2021",53,53,0,175662.2,2266.623,76.13208
"28759","85003","2021",134,128,6,222329.8,2324.022,97.74627
"28760","85004","2021",106,105,1,212411.4,2387.698,90.90566
"28761","85005","2021",16,16,0,158482.7,1530.75,109.125
"28762","85006","2021",49,49,0,178889.7,1890.49,97.95918
"28763","85008","2021",89,89,0,206367.8,2068.978,101.8539
"28764","85009","2021",25,25,0,157588,1284.48,117.96
"28765","85010","2021",34,33,1,199444.1,2158.059,93.38235
"28766","85011","2021",75,71,4,280050.6,3514.893,81.62667
"28767","85012","2021",95,71,24,178322.4,2547.347,72.66316
"28768","85013","2021",18,17,1,151999.7,1686.833,91.72222
"28769","85014","2021",22,22,0,148140,1293.182,117.2727
"28770","85015","2021",25,25,0,204382,1865.36,110.6
"28771","85016","2021",23,23,0,178865.2,1988.261,93.78261
"28772","85017","2021",23,23,0,194633,1818.913,107.4783
"28773","85018","2021",78,76,2,197865.5,2266.551,90.60256
"28774","85019","2021",83,83,0,211375.9,2116.771,103.4819
"28775","85020","2021",71,69,2,164126.3,1426.563,123
"28776","85021","2021",30,30,0,195759.3,2095.933,96.26667
"28777","85022","2021",44,44,0,187443.9,2035.136,95.27273
"28778","85023","2021",6,6,0,114000,925.3333,112.5
"28779","85024","2021",38,38,0,199383.3,1980.316,104.6842
"28780","85025","2021",25,25,0,141585.9,1463.44,95.44
"28781","85026","2021",13,13,0,176138.5,1680.692,101.6154
"28782","85028","2021",10,10,0,148450,1257.2,130.7
"28783","85029","2021",52,52,0,160576.6,1948.442,89.75
"28784","85031","2021",43,42,1,148611.7,1453.767,102.1163
"28785","85033","2021",9,9,0,123977.8,1209.778,96.77778
"28786","85034","2021",37,37,0,150860.8,1552.297,100.8108
"28787","85035","2021",253,197,56,242391,3623.411,70.53755
"28788","85036","2021",12,12,0,173993.8,1578.5,102.3333
"28789","85037","2021",14,14,0,110242.9,964,114.9286
"28790","85038","2021",43,43,0,193838.7,1908.256,108.6279
"28791","85039","2021",65,64,1,164373.8,1751.846,97.21538
"28792","85040","2021",25,25,0,150910.9,1134.84,125.08
"28793","85041","2021",6,6,0,161084.5,1228.333,145.1667
"28794","85042","2021",38,37,1,157972.8,1425.211,112.2105
"28795","85045","2021",25,25,0,193284.8,2662.68,73.88
"28796","85046","2021",45,45,0,160970.8,1768.867,94.97778
"28797","85047","2021",423,338,85,224797.4,2519.946,92.68558
"28798","85049","2021",33,33,0,186921.3,1872.303,103.0909
"28799","85050","2021",58,58,0,174402.2,1683.741,107.2241
"28800","85051","2021",140,126,14,145375.5,1516.114,96.95714
"28801","85053","2021",9,9,0,125915,1068.556,106.6667
"28802","85054","2021",19,19,0,163343.7,1868.526,89.63158
"28803","85055","2021",10,10,0,164713,1837.1,93.7
"28804","85056","2021",11,11,0,170772.7,1469.182,116.5455
"28805","85058","2021",15,15,0,220337.3,1966.133,118.4667
"28806","85059","2021",62,61,1,111092.6,1137.258,102.0645
"28807","85061","2021",24,24,0,152520.3,1768.667,91.58333
"28808","85062","2021",11,11,0,194631.8,1813,113.6364
"28809","85064","2021",36,36,0,169245.5,1578.75,106.9722
"28810","85065","2021",49,49,0,167358,1613.714,106.1429
"28811","85066","2021",7,7,0,123563.3,1239.429,103.8571
"28812","85067","2021",9,9,0,80922.22,809.7778,102.4444
"28813","85070","2021",64,62,2,208137.9,2251.875,93.04688
"28814","85071","2021",70,69,1,203547,2361.029,87.77143
"28815","85072","2021",21,21,0,153542.4,1544.667,102.1429
"28816","85073","2021",10,10,0,165224.6,1589.8,104.9
"28817","85074","2021",10,10,0,135667.5,1362,94.8
"28818","85076","2021",51,51,0,227376.8,2403.627,95.58824
"28819","85077","2021",6,6,0,136791.7,1162.833,117
"28820","85078","2021",20,19,1,139951.4,1574.85,100.6
"28821","85080","2021",33,33,0,150135.5,1294.212,115.697
"28822","85081","2021",56,55,1,225168.6,2106.536,108.3214
"28823","85082","2021",30,30,0,183249.3,2149.367,93.03333
"28824","85083","2021",52,52,0,331081.3,4245.212,85.51923
"28825","85084","2021",110,107,3,185937.9,1815.573,103.5636
"28826","85086","2021",28,28,0,152195.9,1700.929,92.89286
"28827","85087","2021",7,7,0,108942.9,1071.714,114.4286
"28828","85088","2021",106,101,5,284673.9,2961.915,97.72642
"28829","85089","2021",72,69,3,197093.8,2072.667,97.40278
"28830","85090","2021",81,78,3,140589.5,1486.099,97.34568
"28831","85092","2021",256,212,44,132948.3,1363.422,97.51562
"28832","85093","2021",29,29,0,207492.2,1771.379,108.3448
"28833","85094","2021",26,26,0,132731.2,1479.962,101.1923
"28834","85095","2021",39,39,0,173691.4,1889.538,94.51282
"28835","85096","2021",78,78,0,223122.4,2075.859,110.7051
"28836","85097","2021",42,41,1,195348.8,1853.381,106.2381
"28837","85098","2021",27,27,0,207350,1979.296,105.6296
"28838","85099","2021",21,21,0,224065.7,2115.905,106.8095
"28839","85100","2021",42,42,0,279250.7,3135.143,91.64286
"28840","85101","2021",7,7,0,205662.1,1472.286,134
"28841","85102","2021",12,12,0,151416.7,1712.417,90.16667
"28842","85103","2021",51,50,1,219544.2,2228.647,99.84314
"28843","85104","2021",51,51,0,164199.5,1973.608,87.90196
"28844","85105","2021",9,9,0,149516.2,1368.444,111.4444
"28845","85106","2021",49,48,1,318673.9,4437.204,80.34694
"28846","85108","2021",43,42,1,205173.7,1989.256,104.9302
"28847","85109","2021",208,186,22,191545.6,2159.019,90.61058
"28848","85110","2021",16,16,0,140602,1172.812,135.75
"28849","85111","2021",42,42,0,144480.5,1564.81,96.2381
"28850","85112","2021",40,40,0,256398.4,2645.175,99.05
"28851","85113","2021",101,96,5,447040.8,5289.149,86.0297
"28852","85114","2021",157,112,45,233735.8,3220.357,75.32484
"28853","85115","2021",14,14,0,113949.2,1139.786,95.71429
"28854","85116","2021",18,18,0,188162.6,1863.889,104.7222
"28855","85117","2021",12,12,0,202537.5,2238.083,89.75
"28856","85118","2021",40,40,0,212202.6,1986.05,107.75
"28857","85119","2021",22,22,0,204681.3,1997.364,102.5909
"28858","85120","2021",30,30,0,218074.8,2425.633,90.56667
"28859","85121","2021",21,21,0,183848.8,1367.143,136.7143
"28860","85123","2021",9,9,0,139222.2,1080.444,132
"28861","85125","2021",9,9,0,87686.22,807.3333,103
"28862","85126","2021",18,18,0,147088.9,1390.222,112.7222
"28863","85127","2021",134,114,20,211771.7,2782.806,80.07463
"28864","85128","2021",197,169,28,183266.7,1905.645,98.14721
"28865","85129","2021",51,51,0,194087.1,2004.196,98.64706
"28866","85130","2021",14,14,0,162921.1,1743.5,94.57143
"28867","85131","2021",29,28,1,170020.8,1563.724,105
"28868","85132","2021",12,11,1,133846.7,1321.5,111.75
"28869","85133","2021",19,19,0,188446.7,1440.211,138.7895
"28870","85134","2021",3,3,0,147666.7,1505,100.3333
"28871","85135","2021",63,62,1,137952.8,1553.048,89.20635
"28872","85136","2021",2,2,0,74250,707,105
"28873","85137","2021",11,11,0,105262.9,864.3636,123.0909
"28874","85138","2021",17,17,0,191858.8,2107.059,90.88235
"28875","85139","2021",14,14,0,189751.8,1591.143,121.1429
"28876","85140","2021",17,17,0,128873.5,1439.059,89.64706
"28877","85141","2021",17,17,0,129752.9,1215.765,110.8824
"28878","85142","2021",13,13,0,174438,1822.615,95.15385
"28879","85143","2021",16,16,0,171110,1707.062,101.375
"28880","85144","2021",17,17,0,160991.2,1763,91.35294
"28881","85145","2021",17,17,0,131067.6,1280.706,95.70588
"28882","85146","2021",221,203,18,215007.9,2226.602,98.44796
"28883","85147","2021",29,29,0,109008.6,1195.448,98
"28884","85148","2021",15,15,0,163301.9,1277.533,126.4
"28885","85149","2021",6,6,0,189200,1785.167,103.5
"28886","85151","2021",66,66,0,181192.5,1892.167,98.81818
"28887","85152","2021",94,94,0,219802.3,2311.234,97.06383
"28888","85153","2021",29,29,0,163890,1477.69,117.4483
"28889","85154","2021",36,36,0,138130.1,1343.417,102.7778
"28890","85155","2021",59,59,0,244168.4,2194.763,111.4068
"28891","85156","2021",44,43,1,184889.4,1998.182,93.13636
"28892","85157","2021",15,15,0,164240,1526.467,110.1333
"28893","85158","2021",21,21,0,129566.7,1252.714,105.9524
"28894","85159","2021",48,48,0,137504.6,1333.146,108.4167
"28895","85160","2021",44,41,3,186796.8,1779.068,106.7045
"28896","85161","2021",36,35,1,166886.1,1958.111,86.55556
"28897","85162","2021",29,29,0,138453.4,1252.793,119.1034
"28898","85163","2021",151,127,24,406262.6,4951,86.45695
"28899","85164","2021",94,55,39,182186,3130.043,62.12766
"28900","85167","2021",22,22,0,179844.5,1543.409,118.0455
"28901","85169","2021",27,27,0,172870.4,1708.148,105.4074
"28902","85171","2021",15,15,0,194362.2,1719,110.2667
"28903","85172","2021",46,46,0,205880.5,2284.522,91.5
"28904","85174","2021",10,10,0,144650,1325.1,107.2
"28905","85175","2021",6,6,0,136871.7,1472.5,90.16667
"28906","85176","2021",21,21,0,142858.1,1405.048,103.7143
"28907","85177","2021",26,26,0,132351.9,1219.731,110.2308
"28908","85178","2021",109,104,5,212751.7,2183.174,99.07339
"28909","85179","2021",32,32,0,195136.8,2145.375,94.40625
"28910","85181","2021",6,6,0,162083.3,1044.333,170.1667
"28911","85182","2021",93,73,20,131816.1,1308.753,98.39785
"28912","85184","2021",9,9,0,117655.6,1145.222,101.4444
"28913","85185","2021",17,17,0,157220.9,1669.529,93.17647
"28914","85186","2021",15,15,0,153152.9,1645.067,99.26667
"28915","85187","2021",11,11,0,118363.6,1190,116.4545
"28916","85188","2021",32,32,0,127837.9,1237.188,108.8438
"28917","85189","2021",35,35,0,216511.9,2346.543,96.28571
"28918","85190","2021",44,41,3,173138.5,2073.682,87.65909
"28919","85191","2021",1063,551,512,170026.9,2264.882,78.10442
"28920","85192","2021",11,11,0,135221.9,1339.364,99.09091
"28921","85193","2021",14,14,0,132190.4,1560.5,87.57143
"28922","85194","2021",1612,937,675,300164.1,4232.249,73.75372
"28923","85196","2021",23,23,0,149968,1543.391,98.69565
"28924","85197","2021",57,57,0,180527.6,1822.035,99.68421
"28925","85198","2021",21,21,0,199323.8,1837.143,105.7619
"28926","85199","2021",6,6,0,164942.5,1237.667,139
"28927","85200","2021",23,23,0,216434.8,2275.565,93.6087
"28928","85201","2021",23,23,0,186545.9,1952.913,100.6957
"28929","85202","2021",27,27,0,151243.6,1469.333,103.8889
"28930","85204","2021",57,57,0,186597.3,2060.421,93.47368
"28931","85205","2021",10,10,0,166729,1039.5,154.2
"28932","85206","2021",19,19,0,131877.6,1521.316,85.84211
"28933","85207","2021",12,12,0,172014.2,1854.083,96.41667
"28934","85208","2021",25,25,0,178483.6,1902.32,96.08
"28935","85209","2021",14,14,0,147957.1,1249.286,128
"28936","85210","2021",38,38,0,165911.8,1758.447,99.92105
"28937","85211","2021",45,45,0,212670,2001.289,107.0444
"28938","85213","2021",72,72,0,188995.8,1754.819,108.5556
"28939","85214","2021",51,51,0,302189.5,2801.922,108.8824
"28940","85215","2021",25,25,0,173034.2,1672.64,105.48
"28941","85216","2021",25,25,0,159800,1544,105.44
"28942","85218","2021",27,27,0,219703.7,2273.815,96.33333
"28943","85220","2021",26,26,0,146188.5,1377.423,109.8462
"28944","85221","2021",57,56,1,206870.8,2237.211,95.94737
"28945","85222","2021",321,192,129,279772.4,4054.271,72.73209
"28946","85223","2021",61,61,0,139855.1,1227.672,117.5574
"28947","85226","2021",749,323,426,175274.2,3073.575,57.69826
"28948","85227","2021",31,31,0,138213.9,1136.194,119.5484
"28949","85229","2021",16,16,0,103198.8,877.375,123.875
"28950","85231","2021",24,24,0,199434.6,2223.875,92.625
"28951","85232","2021",23,23,0,143548.9,1424.043,103.2174
"28952","85233","2021",17,17,0,208176.5,1603.882,142.2353
"28953","85234","2021",632,327,305,184879.7,2980.922,64.68987
"28954","85235","2021",12,12,0,121083.3,1221.583,100
"28955","85236","2021",31,31,0,201005.5,2205.516,93.93548
"28956","85237","2021",6,6,0,122783.3,1060.167,109.8333
"28957","85238","2021",45,43,2,166126.4,1782,93.4
"28958","85239","2021",20,20,0,222538.8,2229.65,103.5
"28959","85240","2021",9,9,0,169625.7,1530.556,107.6667
"28960","85242","2021",10,10,0,197475,1613.9,115.7
"28961","85243","2021",76,75,1,231069.1,2929.132,82.93421
"28962","85244","2021",11,11,0,161922.7,1419.636,114.7273
"28963","85245","2021",7,7,0,133028.6,1040.714,132.5714
"28964","85246","2021",33,33,0,170569.7,1661.576,108.7576
"28965","85247","2021",12,12,0,169416.7,1467.583,111.8333
"28966","85248","2021",11,11,0,113513.2,1112.909,105.1818
"28967","85250","2021",42,42,0,262599.2,2590.048,101.9048
"28968","85251","2021",20,20,0,102133.4,1045.4,100.15
"28969","85252","2021",11,11,0,110318.2,1117.182,97.54545
"28970","85254","2021",23,23,0,126378.3,1315.739,96.47826
"28971","85255","2021",88,88,0,168851.4,1778.432,98.625
"28972","85256","2021",12,12,0,184913.9,1547.083,123
"28973","85259","2021",13,13,0,211704.6,1938.231,112.7692
"28974","85260","2021",14,14,0,186357.1,1940.286,94.5
"28975","85261","2021",3,3,0,56666.67,1044.667,60.66667
"28976","85262","2021",49,42,7,174432.9,2070.571,87.46939
"28977","85264","2021",25,25,0,127406,1194.72,110.88
"28978","85265","2021",18,18,0,123283.3,1015.778,122.7778
"28979","85266","2021",20,20,0,126054.7,1419.15,90
"28980","85267","2021",23,23,0,174830.2,1678.783,116.0435
"28981","85268","2021",32,32,0,212762.7,2304.688,92.9375
"28982","85269","2021",11,11,0,113318.2,1400,96.36364
"28983","85271","2021",9,9,0,134945.6,1561.778,110.8889
"28984","85273","2021",30,30,0,220363.2,2177.233,104.7667
"28985","85274","2021",12,12,0,188394.8,1346,135.5833
"28986","85276","2021",17,17,0,120600,1148,107.3529
"28987","85277","2021",30,30,0,164219.2,1579.467,104.7667
"28988","85278","2021",87,78,9,222235.2,3315.138,74.12644
"28989","85280","2021",61,61,0,216840.3,2116.525,104.459
"28990","85281","2021",18,18,0,141240,1240.111,115.7222
"28991","85282","2021",22,21,1,145022,1361.545,105.5455
"28992","85284","2021",79,79,0,227536.3,2256.861,103.7342
"28993","85285","2021",11,11,0,166611,1457.091,106
"28994","85286","2021",10,10,0,139169.5,1483.5,92.3
"28995","85287","2021",5,5,0,124200,1032.6,113.8
"28996","85288","2021",351,233,118,227201.8,3051.521,74.50427
"28997","85289","2021",16,16,0,130112.5,1654.75,92.25
"28998","85290","2021",15,15,0,158665.9,1402.667,119.0667
"28999","85291","2021",29,27,2,146337,1534.724,94.75862
"29000","85292","2021",17,17,0,118976.5,1243.353,96.58824
"29001","85293","2021",17,17,0,184964.7,1844.765,101.5882
"29002","85294","2021",239,206,33,211225.3,3418.858,66.51883
"29003","85295","2021",33,33,0,167051.7,1805.879,92.57576
"29004","85296","2021",7,7,0,156357.1,1758.857,90.14286
"29005","85297","2021",37,36,1,138099.2,1466.838,99.05405
"29006","85298","2021",33,33,0,245369.8,2508.667,103.6364
"29007","85300","2021",55,55,0,224446.2,2204.273,107.2545
"29008","85301","2021",16,16,0,144022.4,1434.375,105
"29009","85302","2021",73,73,0,167448.5,1763.178,95.58904
"29010","85303","2021",36,36,0,155182.4,1572.083,103.6389
"29011","85304","2021",19,19,0,141357.9,1541.105,101.5263
"29012","85305","2021",21,21,0,146198.1,1361.095,110.9524
"29013","85306","2021",5,5,0,247741,1630,152.6
"29014","86001","2021",18,18,0,84313.89,948.5556,88.22222
"29015","86002","2021",9,9,0,148433.3,1378.667,124.3333
"29016","86003","2021",2,2,0,174400,1441.5,127
"29017","86004","2021",10,10,0,76350,1054.8,81.6
"29018","86005","2021",8,8,0,134637.5,1077.375,116.375
"29019","86006","2021",13,13,0,86795.85,856.8462,98.46154
"29020","86007","2021",11,11,0,109253.2,1233.727,88.09091
"29021","86008","2021",12,12,0,110725,1003.333,110.0833
"29022","86009","2021",13,13,0,111551.1,1105.923,99.53846
"29023","86010","2021",17,17,0,157754.2,1356.765,113.1176
"29024","86011","2021",6,6,0,164728.7,1576.667,115
"29025","86012","2021",1,1,0,77000,1283,60
"29026","86013","2021",3,3,0,64566.67,659.3333,115.3333
"29027","86014","2021",13,12,1,207211.2,1563.615,135.3846
"29028","86015","2021",36,36,0,96110.31,995.5278,100.5833
"29029","86016","2021",19,19,0,252744.7,2557.211,106.5789
"29030","86017","2021",24,24,0,121942.9,1176.417,106.2083
"29031","86018","2021",4,4,0,94250,1038.5,97.5
"29032","86019","2021",45,45,0,155554.3,1445.178,108.0889
"29033","86020","2021",3,3,0,87966.67,1051.667,102.6667
"29034","86022","2021",11,11,0,151090.9,1331.091,132.8182
"29035","86023","2021",7,7,0,127285.7,831.2857,153.5714
"29036","86024","2021",19,19,0,215115.8,1937.053,118.4211
"29037","86025","2021",11,11,0,75815.18,904.0909,84.36364
"29038","86026","2021",13,13,0,140307.7,1052,133.9231
"29039","86027","2021",19,19,0,178926.3,1912.474,96.36842
"29040","86028","2021",19,19,0,184764.7,1848.632,98.15789
"29041","86029","2021",21,21,0,96238.1,957.5238,104.5714
"29042","86031","2021",20,20,0,135556.4,1393,95.2
"29043","86032","2021",29,29,0,184558.6,1405.759,132.7241
"29044","86034","2021",10,10,0,116979.6,1053.9,103
"29045","86035","2021",5,5,0,61200,654.4,91
"29046","86036","2021",13,13,0,146846.2,1428,107.6154
"29047","86037","2021",12,12,0,85473.17,991.5,77.5
"29048","86038","2021",3,3,0,127000,1167.667,110.6667
"29049","86039","2021",18,18,0,126318.3,1299.278,111.5
"29050","86040","2021",7,7,0,104852.9,978,98.28571
"29051","86041","2021",180,108,72,158290.2,1973.339,81.89444
"29052","86042","2021",16,16,0,118915.1,1302,93.375
"29053","86044","2021",14,14,0,105087.2,886.0714,126
"29054","86045","2021",19,19,0,140479.5,1245.737,116.6842
"29055","86046","2021",29,29,0,160141.4,1450.828,110.931
"29056","86047","2021",12,12,0,117051.1,1210.083,103.75
"29057","86048","2021",15,15,0,206834.4,1725.2,119.0667
"29058","86049","2021",10,10,0,126900,1053.6,126.3
"29059","86050","2021",15,15,0,92153.33,1015.467,96.26667
"29060","86051","2021",4,4,0,71000,617.25,110.75
"29061","86052","2021",18,18,0,123003.3,1237.722,108.6111
"29062","86053","2021",27,27,0,170197.8,1471.815,124.7407
"29063","86054","2021",4,4,0,97750,988,104.25
"29064","86055","2021",8,7,1,104775,1204.875,85.5
"29065","86058","2021",12,12,0,123298.3,1515.083,84.33333
"29066","86059","2021",8,8,0,131162.5,1162.625,111.75
"29067","86061","2021",32,32,0,117763.1,1108.188,110.5625
"29068","86062","2021",66,57,9,172711.1,1995.409,88.5303
"29069","86063","2021",9,9,0,78455.56,734.6667,100.4444
"29070","86064","2021",7,7,0,97142.86,1085.857,92.85714
"29071","86065","2021",14,14,0,129075.8,1281.5,98.64286
"29072","86066","2021",517,413,104,115257.7,1291.82,89.99226
"29073","86068","2021",31,31,0,100411.2,913.0323,112.3871
"29074","86069","2021",2,2,0,133500,998.5,144
"29075","86070","2021",111,104,7,124410.5,1448.991,92.04505
"29076","86072","2021",12,12,0,89541.67,1081.083,79.58333
"29077","86073","2021",12,12,0,119662.2,1410.25,100.5
"29078","86074","2021",13,13,0,132757.7,1497.538,88
"29079","86075","2021",12,12,0,109469.8,1263.333,85.91667
"29080","86076","2021",36,36,0,184651.9,1812.222,108.5
"29081","86077","2021",21,21,0,119369.4,1835.952,78.90476
"29082","86078","2021",55,52,3,104400,1197,98.67273
"29083","86079","2021",12,12,0,106033.3,1181.75,90.58333
"29084","86080","2021",11,11,0,140912.7,1506.818,101.3636
"29085","86081","2021",11,11,0,115818.2,1192.364,96.27273
"29086","86082","2021",67,66,1,112719.1,1114.731,104.6866
"29087","86083","2021",20,20,0,148915,1514.3,98.35
"29088","86084","2021",9,9,0,76157.22,819.3333,95.33333
"29089","86085","2021",7,7,0,98000,915.8571,107.4286
"29090","86086","2021",18,18,0,95500,1026.944,93.27778
"29091","86087","2021",5,5,0,109300,1054.8,101.8
"29092","86088","2021",17,16,1,197039.4,1794.824,111.3529
"29093","86089","2021",7,7,0,93128.57,1006.143,101.1429
"29094","86090","2021",1,1,0,95500,1151,83
"29095","86091","2021",7,7,0,70928.57,730.5714,102.5714
"29096","86092","2021",52,51,1,124530.8,1270.019,101.1346
"29097","86093","2021",2,2,0,29500,394.5,75
"29098","86094","2021",7,7,0,178089.3,1472.143,116.7143
"29099","86095","2021",49,48,1,170202.9,1627.571,105.9592
"29100","86096","2021",9,9,0,99331.56,1085.444,95
"29101","86097","2021",3,3,0,85000,1185.667,68.66667
"29102","86098","2021",5,5,0,74200,910,76.2
"29103","86099","2021",9,9,0,212841.7,1975.778,98.22222
"29104","86100","2021",51,49,2,215738.7,1978.412,111.1373
"29105","86102","2021",6,6,0,178250,1444.833,136.1667
"29106","86103","2021",35,34,1,120569.7,1213.171,98.88571
"29107","86104","2021",16,16,0,106834.4,1088.938,102.5625
"29108","86105","2021",4,4,0,194125,1615.5,123.5
"29109","86106","2021",1,1,0,83000,1025,81
"29110","86107","2021",20,20,0,117235,1220.35,106.8
"29111","86108","2021",6,6,0,83225,817.6667,96.5
"29112","86109","2021",6,6,0,99533.33,1220.167,81.66667
"29113","86110","2021",6,6,0,112587.2,1083.833,103.8333
"29114","86111","2021",17,17,0,113076.2,1039.647,107.8235
"29115","86112","2021",28,28,0,80715.36,804.5357,101.1071
"29116","86113","2021",45,45,0,180384.9,1712.711,105.8222
"29117","86114","2021",13,13,0,174105.7,1496.462,123.5385
"29118","86115","2021",87,83,4,155710.2,1683.529,95.71264
"29119","86116","2021",12,12,0,163161.7,1293,127.5
"29120","86117","2021",6,6,0,66916.67,980.5,76.83333
"29121","86118","2021",7,7,0,100214.4,831,119.7143
"29122","86119","2021",5,5,0,116081.6,817.8,136.2
"29123","86120","2021",18,17,1,62003.33,658.2222,95.38889
"29124","86121","2021",27,27,0,114823.3,1136.889,96.74074
"29125","86122","2021",2,2,0,150521,1212.5,123
"29126","86123","2021",50,50,0,136715.9,1275.1,109.26
"29127","86124","2021",18,18,0,175713.9,1666.333,112.6667
"29128","86125","2021",9,9,0,106333.3,1060.667,103.2222
"29129","86126","2021",5,5,0,105785.4,1239.2,87.4
"29130","86127","2021",10,10,0,109700,1021.5,104.1
"29131","86128","2021",38,38,0,122440.2,1270.026,98.13158
"29132","86129","2021",11,11,0,86704.55,1102.091,76.63636
"29133","86130","2021",8,8,0,97065,1134.75,82
"29134","86131","2021",14,14,0,115484.3,1096.929,100
"29135","86132","2021",11,11,0,88306.55,979.6364,98.90909
"29136","86133","2021",53,49,4,162305.8,1783.264,90.81132
"29137","86134","2021",2,2,0,85385,971.5,92
"29138","86135","2021",6,6,0,207946.3,1739.167,119.1667
"29139","86136","2021",7,7,0,164246.6,1243.429,128.4286
"29140","86137","2021",126,112,14,108773.7,1117.103,97.04762
"29141","86138","2021",8,8,0,86313.75,883.75,103.75
"29142","86139","2021",45,44,1,97846.98,1077.022,93.11111
"29143","86140","2021",36,35,1,101008.6,1107.417,91.61111
"29144","86141","2021",7,7,0,128650,1184.286,110
"29145","86142","2021",5,5,0,162500,1269.6,128.6
"29146","86143","2021",3,3,0,56333.33,1087,72
"29147","86144","2021",10,10,0,116090,1215.6,98.6
"29148","86145","2021",14,14,0,204828.6,1666.857,117.9286
"29149","86147","2021",11,11,0,140818.2,1437.455,95.54545
"29150","86148","2021",12,12,0,189252.5,1347.25,139.0833
"29151","86149","2021",8,8,0,69375,747.75,90.125
"29152","86150","2021",9,9,0,97166.67,886.1111,109.1111
"29153","86151","2021",4,4,0,113875,844.75,137.75
"29154","86152","2021",17,17,0,97973.76,854.7059,117.3529
"29155","86153","2021",17,17,0,88931.41,922.2353,100.7647
"29156","86154","2021",4,4,0,98750,1351.25,74
"29157","86156","2021",3,3,0,119666.7,1203,95.33333
"29158","86157","2021",61,53,8,209138.3,2094.164,104
"29159","86158","2021",72,72,0,191000.9,1875.097,103.1389
"29160","86159","2021",9,9,0,77944.44,883.8889,90.44444
"29161","86160","2021",40,39,1,91795,1046.875,84.45
"29162","86161","2021",24,24,0,99412.5,1075.708,92.79167
"29163","86162","2021",1,1,0,130000,722,180
"29164","86163","2021",38,38,0,237203.4,2040.947,117.8421
"29165","86164","2021",10,10,0,102380,1088.6,92.6
"29166","86165","2021",105,92,13,96305.38,1200.39,94.08571
"29167","86167","2021",10,10,0,93220,944.8,107.4
"29168","86169","2021",6,6,0,126821.7,1198.833,89.33333
"29169","86170","2021",4,4,0,78125,652.5,110.75
"29170","86171","2021",11,11,0,87500,912,96
"29171","86172","2021",2,2,0,229208.5,2176,113.5
"29172","86173","2021",13,13,0,107600,1026.077,110.2308
"29173","86174","2021",70,70,0,148470.1,1487.743,99.45714
"29174","86175","2021",6,6,0,81166.67,1269.333,71.5
"29175","86176","2021",1,1,0,166000,1129,147
"29176","86177","2021",82,72,10,173221.8,1726.537,103.5
"29177","86178","2021",38,37,1,165780.8,1692.526,94.23684
"29178","86180","2021",34,34,0,214889.7,1879.324,115.2059
"29179","86181","2021",6,6,0,87441.67,784.6667,104.1667
"29180","86182","2021",10,10,0,77124.8,954.7,85.3
"29181","86183","2021",35,35,0,122956.3,1162.429,108.3429
"29182","86184","2021",12,12,0,117783.3,1136.25,102.0833
"29183","86186","2021",10,10,0,121489,1218.8,101.6
"29184","86187","2021",11,11,0,129749.4,1263.727,99.27273
"29185","86189","2021",12,12,0,103224.2,900.5,112.75
"29186","86190","2021",18,18,0,80103.11,822.1667,102.7778
"29187","86191","2021",4,4,0,105238.8,1008.25,118.25
"29188","86192","2021",5,5,0,40200,653,63.8
"29189","86193","2021",24,23,1,103791.7,994.7083,103.75
"29190","86194","2021",1655,632,1023,145712.5,2177.413,70.40181
"29191","86195","2021",5,5,0,77100,1035,75
"29192","86196","2021",6,6,0,142666.7,1002.5,143.1667
"29193","86197","2021",9,9,0,120544.7,1282,98.66667
"29194","86198","2021",9,9,0,148000,1291,113.5556
"29195","86200","2021",11,11,0,111718.9,1151.091,97
"29196","86201","2021",1,1,0,245000,1361,180
"29197","86202","2021",9,9,0,90123.89,959.1111,93.33333
"29198","86203","2021",18,18,0,111267.6,1011.444,118.6111
"29199","86204","2021",38,23,15,173675.5,2488.289,87.05263
"29200","86205","2021",4,4,0,180812.5,1147.25,154
"29201","86207","2021",37,26,11,117222,1497.973,81.40541
"29202","86209","2021",34,33,1,163301.6,1656.971,99
"29203","86210","2021",2,2,0,122500,1571.5,84.5
"29204","86211","2021",14,14,0,87712.5,933.1429,94.57143
"29205","86213","2021",40,40,0,106022.5,1010.15,106.325
"29206","86214","2021",110,83,27,197476.5,2112.891,95.43636
"29207","86217","2021",5,5,0,134508.4,1128.4,137.4
"29208","86218","2021",2,2,0,66500,721,92
"29209","86220","2021",4,4,0,70625,728.5,101.25
"29210","86221","2021",14,14,0,114177.9,1214.214,105.9286
"29211","86222","2021",57,55,2,179615.3,1923.123,94.07018
"29212","86223","2021",19,19,0,95700,1008.211,94.42105
"29213","86224","2021",19,17,2,156550.3,1069.474,146.2105
"29214","86225","2021",21,21,0,87680.95,1027.143,84.2381
"29215","86226","2021",30,30,0,207959,1801.633,116.7667
"29216","86227","2021",2,2,0,90000,878,97.5
"29217","86228","2021",2,2,0,97750,633,153.5
"29218","86229","2021",6,6,0,86833.33,1165.333,79.5
"29219","86230","2021",4,4,0,62000,734.25,80.5
"29220","86231","2021",9,9,0,99388.89,1189.778,95.66667
"29221","86233","2021",51,51,0,125298.5,1325.784,95.90196
"29222","86234","2021",11,11,0,97709.09,827.4545,118.3636
"29223","86235","2021",16,16,0,122398,1366.625,92
"29224","86236","2021",17,17,0,90733.82,1109.882,77.41176
"29225","86237","2021",9,9,0,100054.4,1017.778,98.22222
"29226","86239","2021",3,3,0,124166.7,951.6667,118.6667
"29227","86241","2021",11,11,0,76990.91,946.2727,82.18182
"29228","86242","2021",9,9,0,106955.6,1184.222,97.88889
"29229","86244","2021",32,32,0,110129.7,1145.219,103.9688
"29230","86245","2021",18,18,0,136144.8,1445.333,94.16667
"29231","86246","2021",9,8,1,60792.22,889.5556,79.77778
"29232","86247","2021",9,9,0,108272.2,997.2222,99.77778
"29233","86248","2021",11,11,0,89895.73,1731.636,76.63636
"29234","86249","2021",4,4,0,63000,764.5,77.5
"29235","86250","2021",3,3,0,174083.3,1093,153
"29236","86252","2021",4,4,0,144296.8,1068.25,151.25
"29237","86253","2021",11,11,0,109181.8,958.0909,112
"29238","86254","2021",13,13,0,77624.15,903.9231,87.84615
"29239","86255","2021",26,26,0,95951.92,1181.654,107.5
"29240","86256","2021",11,11,0,275509.1,1813,153.3636
"29241","86257","2021",6,6,0,157083.3,1663.667,115.5
"29242","86258","2021",38,38,0,123145.9,1234.421,100.1842
"29243","86260","2021",6,6,0,147416.7,1079,137.3333
"29244","86261","2021",24,23,1,187634.3,1822.208,103.0417
"29245","86262","2021",7,7,0,121428.6,1387.143,95.57143
"29246","86263","2021",29,25,4,177847.3,1761.483,101.4138
"29247","86264","2021",10,10,0,100894,914.3,108.4
"29248","86265","2021",4,4,0,132875,973.75,156
"29249","86266","2021",7,7,0,91611.43,1103,82.71429
"29250","86268","2021",16,16,0,188957.8,1803.188,112.375
"29251","86269","2021",2,2,0,57500,880.5,66.5
"29252","86270","2021",3,3,0,66666.67,591.3333,115.3333
"29253","86271","2021",14,14,0,147176.4,1264.857,108.9286
"29254","86272","2021",27,26,1,142733.7,1447.852,99.14815
"29255","86273","2021",19,19,0,72617.37,783.3158,92.73684
"29256","86274","2021",13,13,0,145537.7,1542.231,114.7692
"29257","86275","2021",9,9,0,158977.8,1146.111,134.7778
"29258","86276","2021",20,20,0,92247.2,1109.1,84.25
"29259","86279","2021",6,6,0,175721.8,1372.5,126
"29260","86280","2021",11,11,0,100765,1149.182,105.0909
"29261","86281","2021",83,81,2,158499.4,1457.795,106.8434
"29262","86284","2021",9,9,0,147797.8,1437.778,95.22222
"29263","86285","2021",14,14,0,119321.4,1312,96.5
"29264","86286","2021",7,7,0,99057.14,940.1429,109.1429
"29265","86287","2021",4,4,0,122150,1071.75,115
"29266","86288","2021",5,5,0,70760,696.8,105.6
"29267","86289","2021",22,22,0,121716.8,1189.545,105.5909
"29268","86290","2021",19,19,0,130714.2,1488.105,88.89474
"29269","86291","2021",1,1,0,160000,1301,123
"29270","86292","2021",12,12,0,181216.3,1509.583,119.9167
"29271","86293","2021",56,55,1,142640,1683.232,92.73214
"29272","86294","2021",45,44,1,183096.7,1624.311,113.8667
"29273","86295","2021",8,8,0,125416.9,1072.5,115.5
"29274","86296","2021",5,5,0,141180,1497.4,93.8
"29275","86297","2021",81,80,1,188119,1926.16,98.07407
"29276","86298","2021",31,31,0,136553.2,1300.742,105.3871
"29277","86299","2021",7,7,0,148514.3,1462.429,105.4286
"29278","86300","2021",11,11,0,185619.8,1819.818,103.0909
"29279","87001","2021",75,65,10,140590.7,1504.44,92.69333
"29280","87002","2021",63,60,3,144615.6,1500.937,94.73016
"29281","87003","2021",18,18,0,74818.72,823,91.16667
"29282","87004","2021",3,2,1,59333.33,1613.333,37.66667
"29283","87005","2021",9,9,0,151622.2,1659.111,89.11111
"29284","87006","2021",3,3,0,201666.7,1885.333,95.33333
"29285","87007","2021",7,7,0,91253.86,931.5714,102.1429
"29286","87008","2021",5,5,0,57349.2,610,94.8
"29287","87009","2021",9,9,0,117558.2,1336.222,94.55556
"29288","87011","2021",45,44,1,81669.13,868.2889,95.55556
"29289","87012","2021",4,4,0,62750,600,111.75
"29290","87013","2021",18,18,0,104062.3,1077.778,100.2778
"29291","87014","2021",34,32,2,108101.5,1119.618,100.5
"29292","87015","2021",7,7,0,145470,1425.857,100.1429
"29293","87016","2021",9,9,0,105961.7,1658.556,83.88889
"29294","87017","2021",11,11,0,60179.36,678.7273,86.81818
"29295","87018","2021",11,11,0,66881.64,824,81.72727
"29296","87019","2021",27,27,0,215729.9,2048.556,106.5926
"29297","87020","2021",20,20,0,152552.5,1568.05,97.65
"29298","87021","2021",27,27,0,168371.7,1843.222,94.74074
"29299","87022","2021",6,6,0,79003.33,882.3333,86.66667
"29300","87023","2021",2,2,0,126387.5,1012.5,128
"29301","87024","2021",19,19,0,104256.8,1056.895,100.0526
"29302","87025","2021",10,10,0,161795,1758.6,97.9
"29303","87027","2021",23,23,0,87571.17,1015.522,89.43478
"29304","87028","2021",46,46,0,97094.24,956.3261,103.9783
"29305","87029","2021",12,12,0,116375,1131.333,107.5833
"29306","87030","2021",11,11,0,110077.3,1186.636,86.36364
"29307","87031","2021",3,3,0,74066.67,1420.333,45.33333
"29308","87032","2021",34,33,1,104125,1237.206,89.79412
"29309","87033","2021",13,13,0,151575.8,1296.385,121.4615
"29310","87034","2021",16,16,0,71528.06,968.5,79.375
"29311","87035","2021",6,6,0,98093.33,1175,83.5
"29312","87036","2021",16,16,0,147053.9,1420.938,104.0625
"29313","87037","2021",9,9,0,120803.9,1086.556,114.8889
"29314","87038","2021",23,23,0,182707.6,1793.957,104.3913
"29315","87039","2021",12,12,0,129363.2,1386.25,90.41667
"29316","87040","2021",35,35,0,85939.71,1263.086,84.11429
"29317","87041","2021",38,38,0,98972.37,1107.842,93
"29318","87042","2021",5,5,0,71970,1023.8,69.8
"29319","87043","2021",9,8,1,89433.33,1038.667,82.55556
"29320","87044","2021",11,11,0,116590.9,1291.182,110.7273
"29321","87045","2021",15,15,0,139190,1067,130.9333
"29322","87046","2021",24,24,0,129187.5,1252.042,107.5417
"29323","87047","2021",28,28,0,174523.7,1492.929,117.25
"29324","87048","2021",48,44,4,178584.3,1804.708,99.875
"29325","87049","2021",21,21,0,82595.24,1191,83
"29326","87050","2021",137,115,22,199931.1,2022,103.1533
"29327","87051","2021",25,25,0,108215.9,1176.2,106.12
"29328","87052","2021",1,1,0,57000,740,77
"29329","87053","2021",5,5,0,130849.4,1561.2,89.2
"29330","87054","2021",19,19,0,99977.37,1138.895,90.42105
"29331","87056","2021",6,5,1,76608,809.8333,93.66667
"29332","87057","2021",5,5,0,90760,1092.4,80.6
"29333","87058","2021",6,6,0,105333.3,1076.167,91.16667
"29334","87059","2021",22,20,2,79497.27,958.2273,86.04545
"29335","87060","2021",17,16,1,84718.88,1233,69.58824
"29336","87061","2021",11,11,0,77555.45,728,102.7273
"29337","87062","2021",3,3,0,167700,1477.667,113.6667
"29338","87063","2021",9,9,0,132955.6,1180.778,114.2222
"29339","87064","2021",38,35,3,98647.26,1079.105,93.89474
"29340","87065","2021",46,46,0,216512.9,1906.304,113.413
"29341","87066","2021",16,16,0,113759.4,1111.188,108.0625
"29342","87067","2021",10,10,0,102109,1084.3,100.1
"29343","87068","2021",12,12,0,130845.8,1207.917,110.0833
"29344","87069","2021",7,7,0,79999.86,1001.857,96.42857
"29345","87070","2021",21,21,0,151576.9,1356.762,113.2381
"29346","87071","2021",9,9,0,159335.7,1765.444,90.33333
"29347","87072","2021",4,4,0,82000,961,88
"29348","87073","2021",7,7,0,131363.6,1556.714,82
"29349","87074","2021",9,9,0,65080,901.1111,80
"29350","87075","2021",96,78,18,179049.2,1980.906,94.125
"29351","87076","2021",10,10,0,83376.8,812,92.7
"29352","87077","2021",5,5,0,131260,1406.6,93.4
"29353","87078","2021",6,6,0,127316.7,1388.5,88.16667
"29354","87079","2021",15,15,0,87790.47,988.9333,94.53333
"29355","87080","2021",5,5,0,89040,1028.8,90.6
"29356","87081","2021",10,10,0,172641.5,1737,98.5
"29357","87082","2021",16,16,0,99279.31,1183.688,92.125
"29358","87083","2021",15,15,0,87540.33,1163.8,75.6
"29359","87084","2021",3,3,0,91066.67,865,108
"29360","87085","2021",2373,755,1618,125956.9,1758.875,72.23557
"29361","87086","2021",21,21,0,108254.8,1233.286,89.71429
"29362","87087","2021",18,18,0,75891.39,854.3333,95.61111
"29363","87088","2021",25,25,0,134855.8,1351.48,99.4
"29364","87089","2021",35,35,0,112940.8,1238.714,102.5429
"29365","87090","2021",3,3,0,119000,914.6667,135.6667
"29366","87091","2021",8,8,0,120170,1172.125,100
"29367","87092","2021",25,25,0,120960.6,1205.96,104.44
"29368","87093","2021",10,10,0,93520,920,106.2
"29369","87094","2021",9,9,0,177153.3,1573.444,112.1111
"29370","87095","2021",16,16,0,120003.8,1651.875,81.6875
"29371","87096","2021",11,11,0,94647.27,1205.818,79
"29372","87097","2021",20,20,0,91769.8,1012.4,97
"29373","87099","2021",2,2,0,54405.5,762,87
"29374","87100","2021",2,2,0,297500,2381,108
"29375","87101","2021",5,5,0,168420,874,175.2
"29376","87103","2021",18,18,0,131958.3,1379.778,98.72222
"29377","87104","2021",20,19,1,93481.5,1099.9,80.6
"29378","87105","2021",13,13,0,120965.4,1464.692,86.53846
"29379","87106","2021",32,32,0,138558.1,1345.156,105.5
"29380","87107","2021",26,26,0,192340.5,1682.885,114.5
"29381","87108","2021",9,9,0,98023,1100.222,85.88889
"29382","87109","2021",7,7,0,61945.71,929.8571,83.14286
"29383","87110","2021",29,29,0,136871.6,1449.793,100.4138
"29384","87111","2021",38,37,1,114958.7,1120.737,103.8947
"29385","87112","2021",15,15,0,117559.3,1482.067,85
"29386","87113","2021",64,63,1,165919.1,1793.453,99.25
"29387","87114","2021",140,120,20,183878.2,1867.6,97.72143
"29388","87115","2021",1,1,0,60001,750,80
"29389","87116","2021",26,26,0,127311.3,1165.115,109.8462
"29390","87117","2021",24,24,0,68433.33,916.4167,81.29167
"29391","87118","2021",23,23,0,116408.7,1296.652,88.13043
"29392","87119","2021",19,18,1,107709.5,1333.053,84.15789
"29393","87120","2021",17,17,0,87391.18,1115.882,90.17647
"29394","87121","2021",14,14,0,73238.93,717.4286,102.7143
"29395","87122","2021",24,24,0,127919.6,1243.75,102.75
"29396","87123","2021",5,5,0,53164,694.6,73.8
"29397","87124","2021",7,7,0,112667.9,1314.429,82.57143
"29398","87125","2021",53,53,0,197880.9,1806.887,109.3774
"29399","87126","2021",58,57,1,109063.2,1128.586,97.98276
"29400","87127","2021",6,6,0,109661.8,1252.167,87.5
"29401","87128","2021",29,29,0,113379.7,1186.759,100.7586
"29402","87129","2021",16,16,0,169569,1672.062,114.8125
"29403","87130","2021",1,1,0,205800,1942,106
"29404","87131","2021",18,18,0,85111.61,945.5,86
"29405","87132","2021",2,2,0,120000,1337,97
"29406","87133","2021",16,16,0,71605.94,913.3125,87
"29407","87134","2021",5,5,0,99242,1411.2,66
"29408","87135","2021",20,20,0,107102.5,1170.1,91.25
"29409","87137","2021",4,4,0,96737.5,1265.75,79.25
"29410","87138","2021",6,6,0,90742.67,1229.833,81.83333
"29411","87139","2021",16,16,0,92150.06,1179.562,96.875
"29412","87140","2021",29,28,1,128660.4,1189.379,108.8621
"29413","87141","2021",11,11,0,109057,1215.909,88.81818
"29414","87142","2021",11,11,0,122284.5,1131.818,114.4545
"29415","87143","2021",22,22,0,165114.7,1794.364,92.95455
"29416","87144","2021",9,9,0,112333.3,1106.556,103.7778
"29417","87145","2021",2,2,0,57725,526,109.5
"29418","87146","2021",16,16,0,100649.6,1182.312,86.375
"29419","87147","2021",4,4,0,56500,1024.75,50.5
"29420","87148","2021",8,8,0,152076.2,1261.625,123.625
"29421","87149","2021",6,6,0,117442.5,1040.833,119.1667
"29422","87150","2021",13,13,0,134859.2,1633,95.07692
"29423","87151","2021",9,9,0,116285.6,1224.444,96.33333
"29424","87152","2021",27,27,0,151327.8,1521.481,100.6296
"29425","87153","2021",9,9,0,91352.89,989.4444,87.55556
"29426","87154","2021",166,157,9,149750,1533.145,98.5241
"29427","87155","2021",2,2,0,45500,745,61
"29428","87156","2021",32,30,2,194591.8,1773.656,108.625
"29429","87157","2021",17,17,0,115052.9,1234.706,93.05882
"29430","87158","2021",24,23,1,119559.2,1204.125,111
"29431","87159","2021",13,13,0,93623.54,1000.846,99
"29432","87160","2021",11,11,0,129618.5,1007.727,120.0909
"29433","87161","2021",62,54,8,127212.1,1358.5,96.87097
"29434","87162","2021",4,4,0,89250,1028.25,86.25
"29435","87163","2021",6,6,0,128000,1463.333,81.66667
"29436","87164","2021",5,5,0,120143,1286.4,99.2
"29437","87165","2021",2,2,0,35000,491,71
"29438","87166","2021",10,10,0,178815,1464.7,134.3
"29439","87167","2021",7,7,0,108551.3,985.2857,106.8571
"29440","87168","2021",31,30,1,113253.5,1072.677,102.5161
"29441","87169","2021",12,12,0,174406.2,1699,103.75
"29442","87170","2021",6,6,0,87833.33,1047.833,78.33333
"29443","87172","2021",3,3,0,98016.67,1033.667,85.33333
"29444","87174","2021",15,14,1,122093.3,1292.2,93.13333
"29445","87176","2021",9,9,0,96588.89,1257.889,77.22222
"29446","87177","2021",26,26,0,127389.6,1418.962,90.61538
"29447","87178","2021",38,37,1,158268.3,1465.895,106.4474
"29448","87179","2021",7,7,0,123357.1,1113.429,105.8571
"29449","87180","2021",15,15,0,84926.67,1022.2,87.6
"29450","87181","2021",20,19,1,88747,977.9,87.35
"29451","87182","2021",27,27,0,92853.15,1042,90.37037
"29452","87183","2021",15,15,0,129253.3,1258.933,97.4
"29453","87185","2021",39,39,0,136359.4,1380.282,100.2308
"29454","87186","2021",6,6,0,84000,1179.667,72.5
"29455","87187","2021",126,111,15,123396.1,1269.833,99.70635
"29456","87188","2021",8,8,0,186766.2,1625.5,111.625
"29457","87189","2021",10,10,0,135694.1,1105.7,131.5
"29458","87190","2021",13,13,0,134592.3,1243.846,106.3077
"29459","87191","2021",32,32,0,141471.6,1389.062,108.0938
"29460","87192","2021",12,12,0,160225,1497.583,105.5833
"29461","87193","2021",3,3,0,81666.67,1255.667,64
"29462","87194","2021",12,12,0,77381.67,858.5,93.41667
"29463","87195","2021",1,1,0,54500,1090,50
"29464","87197","2021",7,7,0,78007.14,1231.143,67.14286
"29465","87198","2021",8,8,0,117431.2,1231.375,94.25
"29466","87199","2021",21,21,0,98726.33,1214.619,89.52381
"29467","87201","2021",60,60,0,201851.1,1966.9,105.4167
"29468","87202","2021",21,21,0,155033.3,1481.952,104.1429
"29469","87203","2021",19,18,1,124850.1,1379.158,89.94737
"29470","87204","2021",6,6,0,104741.7,1014.5,101.1667
"29471","87205","2021",28,28,0,191786.8,1642.536,119.7143
"29472","87206","2021",3,3,0,64666.67,838.3333,98.66667
"29473","88001","2021",1,1,0,48000,475,101
"29474","88002","2021",2,2,0,129850,776.5,188
"29475","88004","2021",3,3,0,80803.33,678.3333,117.3333
"29476","88005","2021",4,4,0,110932.5,1072.5,93.5
"29477","88006","2021",5,5,0,183320,1215.2,155.2
"29478","88007","2021",3,3,0,118333.3,1042.333,116
"29479","88009","2021",42,37,5,153025.6,1526.238,101.2619
"29480","88010","2021",3,3,0,83400,799.3333,93.66667
"29481","88011","2021",23,19,4,130663,1213.087,108.913
"29482","88012","2021",13,13,0,112958.5,1394.769,84.84615
"29483","88014","2021",5,4,1,191400,1985,98.6
"29484","88015","2021",2,2,0,72500,583,115.5
"29485","88016","2021",3,3,0,120166.7,1198.333,97.66667
"29486","88017","2021",3,3,0,71666.67,669,108
"29487","88019","2021",3,3,0,136483.3,1167,102.6667
"29488","88020","2021",4,4,0,150937.5,1116,126.75
"29489","88021","2021",1,1,0,108878,1223,89
"29490","88022","2021",3,3,0,106666.7,811.6667,131.6667
"29491","88025","2021",1,1,0,56000,560,100
"29492","88026","2021",9,9,0,161823.3,1322.667,123.8889
"29493","88028","2021",3,3,0,121500,1019,126.6667
"29494","88029","2021",22,22,0,74004.55,816.0909,89.31818
"29495","88030","2021",4,3,1,114390,944.25,121
"29496","88031","2021",1,1,0,103500,1380,75
"29497","88032","2021",14,13,1,164735.7,1476.214,113.8571
"29498","88033","2021",3,3,0,124000,890.6667,132.3333
"29499","88036","2021",1,1,0,150000,1200,125
"29500","88037","2021",8,7,1,196000,2042.375,108.25
"29501","88039","2021",2,2,0,72000,735,107
"29502","88040","2021",3,3,0,106166.7,957.6667,118
"29503","88044","2021",12,12,0,130693.8,1131.833,123.5833
"29504","88046","2021",2,2,0,122700,1078,107.5
"29505","88047","2021",1,1,0,181250,2060,88
"29506","88048","2021",9,9,0,178861.1,1468,127.8889
"29507","88050","2021",4,4,0,195225,1369,145.75
"29508","88051","2021",5,5,0,98100,818.4,115.2
"29509","88052","2021",3,3,0,80000,787.3333,109.3333
"29510","88053","2021",2,2,0,107500,994,115
"29511","88054","2021",2,2,0,211250,1235,191
"29512","88055","2021",1,1,0,219000,1752,125
"29513","88056","2021",1,1,0,18000,360,50
"29514","88059","2021",5,5,0,144320,1392,108.8
"29515","88061","2021",2,2,0,110000,1100,100
"29516","88063","2021",1,1,0,40000,2500,16
"29517","88064","2021",1,1,0,123600,1200,103
"29518","88065","2021",3,3,0,135203.3,888,145.6667
"29519","88068","2021",12,12,0,144282.5,1760,87.5
"29520","88069","2021",1,1,0,55000,1196,46
"29521","88070","2021",1,1,0,40000,870,46
"29522","88071","2021",1,1,0,178000,1548,115
"29523","88073","2021",2,2,0,214500,1418.5,142
"29524","88075","2021",140,60,80,152270.4,2146.764,75.45714
"29525","88076","2021",7,7,0,88500,945.5714,98.42857
"29526","88077","2021",11,11,0,132298.2,1095.909,120.1818
"29527","88078","2021",34,25,9,89489.41,1102.324,88.70588
"29528","88079","2021",20,20,0,120613.5,1113.95,110.55
"29529","88080","2021",7,7,0,130431.4,1232,112.5714
"29530","88081","2021",21,20,1,128049.2,1355,99.66667
"29531","88082","2021",13,10,3,105769.2,1224.769,97.38462
"29532","88084","2021",6,6,0,167526.7,1494.5,123.1667
"29533","88085","2021",8,8,0,141106.2,1726.25,101.875
"29534","88086","2021",8,8,0,111375,1008.375,107.25
"29535","88087","2021",67,42,25,151542.5,1599.582,90.25373
"29536","88088","2021",12,12,0,133845.8,1082.167,126.6667
"29537","88089","2021",8,8,0,152360,1268.25,119.75
"29538","88090","2021",80,56,24,120060.4,1231.287,99.7125
"29539","88091","2021",5,5,0,178260,1669.6,108
"29540","88092","2021",10,10,0,105973.4,1044,100
"29541","88094","2021",10,9,1,116487,1263.2,90.4
"29542","88095","2021",19,18,1,125913.2,1059.421,117
"29543","88096","2021",5,4,1,129650,1207,122
"29544","88098","2021",22,19,3,153222.8,1596.273,101.1364
"29545","88099","2021",23,20,3,142440,1416.435,102.2174
"29546","88100","2021",2,2,0,93500,923,102
"29547","88101","2021",11,10,1,117209.1,1221.727,99.27273
"29548","88105","2021",6,6,0,74660,992.5,73
"29549","88106","2021",24,23,1,183284.3,1784.042,106.875
"29550","88107","2021",1,1,0,116500,1214,96
"29551","88108","2021",13,13,0,135696.9,1138.615,137.4615
"29552","88109","2021",4,3,1,117000,1369.75,84
"29553","88110","2021",2,2,0,84000,985.5,91
"29554","88111","2021",2,2,0,175058.5,1562.5,112.5
"29555","88114","2021",34,22,12,79257.79,855.7353,91.41176
"29556","88115","2021",26,23,3,138928.1,1613.538,95.80769
"29557","88116","2021",58,36,22,121042.9,1264.793,98.55172
"29558","88117","2021",1,1,0,70000,667,105
"29559","88118","2021",9,9,0,132136.7,1351.444,95.66667
"29560","88119","2021",2,2,0,142800,564.5,222.5
"29561","88120","2021",3,3,0,162666.7,1517.333,111
"29562","88121","2021",6,6,0,88750,873,101.1667
"29563","88122","2021",3,3,0,85551.67,656.3333,128.3333
"29564","88123","2021",1,1,0,50000,568,88
"29565","88124","2021",12,11,1,96250,768.3333,123.0833
"29566","88126","2021",18,11,7,161878.9,1373.5,117.0556
"29567","88127","2021",2,1,1,100500,1447.5,75.5
"29568","88128","2021",2,1,1,152261,1554.5,100
"29569","88131","2021",2,2,0,230500,1330,180
"29570","88132","2021",21,20,1,182259.3,1573.667,122.0476
"29571","88134","2021",6,6,0,121204.7,1429.167,83.83333
"29572","88135","2021",9,7,2,141177.8,1156.222,119.7778
"29573","88136","2021",15,12,3,177979,1860.933,91.8
"29574","88140","2021",4,4,0,126387.5,1311.75,100.5
"29575","88141","2021",2,2,0,110100,1117.5,99.5
"29576","88142","2021",5,5,0,185095.2,1499.6,119.8
"29577","88143","2021",7,7,0,102550,1019.857,107.5714
"29578","88145","2021",3,3,0,112533.3,1089.667,112
"29579","88146","2021",3,3,0,61666.67,697,90.66667
"29580","88147","2021",6,6,0,142946.7,1105.333,130.1667
"29581","88148","2021",25,17,8,153343.8,1495.12,100.88
"29582","88150","2021",1,1,0,44000,415,106
"29583","88151","2021",13,13,0,94503.08,868.8462,107.7692
"29584","88152","2021",2,2,0,112000,789,142
"29585","88153","2021",3,3,0,137300,1731.667,114.3333
"29586","88154","2021",1,0,1,125000,1078,116
"29587","88156","2021",2,2,0,166500,1467,121.5
"29588","88157","2021",11,11,0,139272.7,1439.818,101
"29589","88158","2021",35,23,12,135943.1,1430.371,94.91429
"29590","88159","2021",6,6,0,216433.3,1467.167,149.8333
"29591","88160","2021",592,204,388,112021.3,1383.402,80.75845
"29592","88161","2021",7,6,1,110868.6,947.4286,117
"29593","88162","2021",1,1,0,185000,925,200
"29594","88163","2021",9,9,0,151888.9,1328.444,114.6667
"29595","88164","2021",2,2,0,87250,572,137.5
"29596","88165","2021",20,19,1,136451.8,1351.6,101.6
"29597","88166","2021",6,6,0,185825,1828.5,100.5
"29598","88169","2021",2,2,0,183600,1095,183
"29599","88170","2021",7,7,0,115921.4,1210.857,92.71429
"29600","88171","2021",1,1,0,40000,571,70
"29601","88172","2021",2,2,0,167100,1510.5,111.5
"29602","88173","2021",3,3,0,179133.3,1755.667,112
"29603","88175","2021",6,6,0,119891.7,1075.667,113.6667
"29604","88176","2021",10,10,0,65946,687.5,96.1
"29605","88177","2021",6,5,1,160083.3,1809,91.33333
"29606","88178","2021",16,14,2,154784.4,1603.688,100.375
"29607","88181","2021",53,49,4,112806.5,1363.83,93
"29608","88182","2021",1,1,0,158400,1427,111
"29609","88183","2021",4,4,0,110900,837,137
"29610","88184","2021",5,5,0,81400,759.6,108.2
"29611","88185","2021",3,2,1,108333.3,1030.667,114
"29612","88188","2021",26,24,2,125584,1250.923,101.6154
"29613","88189","2021",4,4,0,44737.5,559,77.25
"29614","88190","2021",4,4,0,143750,948.25,148
"29615","88193","2021",2,2,0,208500,1688.5,122
"29616","88195","2021",4,4,0,77936.5,632.5,114.75
"29617","88196","2021",225,84,141,191052.4,2650.671,74.56444
"29618","88197","2021",2,2,0,248000,2194,114.5
"29619","88198","2021",8,8,0,159828.8,1712.375,94.875
"29620","88201","2021",12,11,1,146523.2,1414.583,101.1667
"29621","88203","2021",3,3,0,97833.33,983.3333,105.6667
"29622","88205","2021",5,5,0,120400,1414,84.2
"29623","88206","2021",13,10,3,104915.4,1393.538,105.3846
"29624","88208","2021",1,1,0,75600,1080,70
"29625","88209","2021",118,75,43,134207.4,1392.153,94.52542
"29626","88210","2021",2,2,0,64225,778.5,77
"29627","88212","2021",2,2,0,150250,1648,100
"29628","88213","2021",4,4,0,110692.5,1179.25,98.75
"29629","88215","2021",2,2,0,167500,1849.5,99
"29630","88216","2021",6,5,1,123916.7,1222.167,116.5
"29631","88218","2021",25,22,3,140613,1388.16,110.68
"29632","88219","2021",1,1,0,80000,571,140
"29633","88221","2021",4,4,0,34500,570.5,61
"29634","88222","2021",2,2,0,85000,808.5,110.5
"29635","88223","2021",1,1,0,60000,600,100
"29636","88224","2021",4,4,0,198225,1862.75,106.5
"29637","88225","2021",24,24,0,128738.8,1383.25,94.875
"29638","88226","2021",3,3,0,136666.7,1321,106.6667
"29639","88227","2021",1,1,0,50000,417,120
"29640","88228","2021",2,2,0,73030,704.5,105
"29641","88229","2021",1,1,0,68000,958,71
"29642","88231","2021",3,3,0,125016.7,1068.667,125.6667
"29643","88232","2021",4,4,0,80000,719.75,112
"29644","88233","2021",10,10,0,127945,1206.7,124.7
"29645","88236","2021",1,1,0,55894,486,115
"29646","88237","2021",2,2,0,92500,989,105
"29647","88238","2021",6,6,0,76366.67,715.3333,115
"29648","88240","2021",3,3,0,155833.3,1097.333,144.6667
"29649","88241","2021",4,3,1,110100,821,133.75
"29650","88242","2021",2,2,0,85425,492.5,169
"29651","88243","2021",2,2,0,209085,1155.5,180.5
"29652","88244","2021",5,4,1,117880,1443.2,82.2
"29653","88245","2021",3,3,0,185000,1577,122.3333
"29654","88246","2021",6,6,0,108578.3,949.3333,111.1667
"29655","88247","2021",6,6,0,126650,1415,88.66667
"29656","88248","2021",5,5,0,74600,919.6,102.6
"29657","88249","2021",4,4,0,97237.5,681,129.75
"29658","88250","2021",7,6,1,129980,1164.857,109.2857
"29659","88251","2021",10,9,1,149268,1235.8,119.4
"29660","88252","2021",3,3,0,139750.7,1268.333,104.3333
"29661","88253","2021",4,3,1,160267.5,1147.25,138
"29662","88255","2021",1,1,0,35680,525,68
"29663","88256","2021",2,2,0,124050,1145.5,112.5
"29664","88257","2021",2,2,0,132300,1005,132.5
"29665","88258","2021",9,9,0,63914.44,618.8889,105.6667
"29666","88260","2021",1,1,0,67934,1045,65
"29667","88261","2021",5,5,0,141640,1244.2,126.6
"29668","88262","2021",7,6,1,108178.6,1207.286,97.85714
"29669","88263","2021",5,5,0,131289,1756.2,76.4
"29670","88264","2021",3,3,0,126666.7,1082.667,129.6667
"29671","88266","2021",15,7,8,71266.67,965.2667,90
"29672","88267","2021",4,4,0,104437.5,843,125.75
"29673","88269","2021",7,7,0,280016.1,2677.429,99.42857
"29674","88270","2021",27,27,0,86824,917.0741,96.88889
"29675","88271","2021",5,5,0,55260,606.8,97
"29676","88272","2021",1,1,0,85000,759,112
"29677","88273","2021",7,7,0,199658.6,1871.286,138.8571
"29678","88274","2021",1,1,0,92500,661,140
"29679","88275","2021",4,4,0,128315.5,793,162.5
"29680","88276","2021",4,4,0,179375,1102.25,158
"29681","88277","2021",4,4,0,121250,1092,102
"29682","88278","2021",2,2,0,91610,907.5,91.5
"29683","88279","2021",2,2,0,124000,985,123.5
"29684","88280","2021",2,2,0,263000,1492.5,172
"29685","88281","2021",7,7,0,140428.6,1094.429,136.5714
"29686","88283","2021",4,4,0,65250,820,83.75
"29687","88284","2021",8,5,3,138696.9,1236.125,103.75
"29688","88285","2021",3,3,0,98500,874.6667,113.3333
"29689","88286","2021",1,1,0,86000,439,196
"29690","88288","2021",1,1,0,75000,893,84
"29691","88289","2021",11,11,0,70477.27,809.9091,97.81818
"29692","88290","2021",3,3,0,79750,502,152.6667
"29693","88291","2021",3,3,0,144758.3,756.3333,205.6667
"29694","88292","2021",5,5,0,106536.8,1173.8,92.6
"29695","88293","2021",3,3,0,51333.33,939.6667,72.66667
"29696","88294","2021",3,3,0,91666.67,909.3333,109
"29697","88295","2021",4,4,0,102625,994.25,105.75
"29698","88296","2021",2,2,0,52345,559,91
"29699","88299","2021",1,1,0,50000,625,80
"29700","88300","2021",3,3,0,153474.3,1121.333,131.6667
"29701","88301","2021",3,3,0,40333.33,709.6667,58
"29702","88302","2021",14,14,0,161575,1647,103.8571
"29703","88303","2021",2,2,0,61500,595,98.5
"29704","88304","2021",56,39,17,101820.6,968.8393,104.1607
"29705","88306","2021",1,1,0,70000,1014,69
"29706","88308","2021",4,3,1,108492.5,1021,110.5
"29707","88310","2021",10,9,1,109450,938.6,112.2
"29708","88311","2021",1,1,0,66000,541,122
"29709","88312","2021",7,7,0,116351,1086.143,114.5714
"29710","88313","2021",6,6,0,164058.3,1309.5,125.3333
"29711","88315","2021",3,3,0,155166.7,1058.667,167
"29712","88316","2021",1,1,0,81500,1045,78
"29713","88317","2021",10,10,0,110680,974.2,117.7
"29714","88318","2021",3,3,0,142863.3,1113,142.6667
"29715","88319","2021",41,35,6,109313.5,987.2927,107.9268
"29716","88320","2021",8,8,0,129912.5,1424.75,97.625
"29717","88321","2021",88,71,17,127846.7,1181.341,109.3182
"29718","88322","2021",6,6,0,123498.2,1669.5,75
"29719","88324","2021",5,4,1,81985,700.4,115.2
"29720","88325","2021",1,1,0,95000,1056,90
"29721","88326","2021",3,3,0,186566.7,1528.333,119
"29722","88327","2021",22,19,3,94475,1170.227,86.40909
"29723","88328","2021",4,4,0,188912.2,1428.25,132
"29724","88330","2021",5,5,0,104284,733.2,132.6
"29725","88332","2021",3,3,0,87533.33,819.6667,103
"29726","88333","2021",3,3,0,68666.67,593,123
"29727","88334","2021",3,3,0,65466.67,839.6667,81
"29728","88340","2021",6,6,0,165436.7,1222,137.6667
"29729","88341","2021",12,8,4,147393.8,1600.417,88.75
"29730","88342","2021",2,2,0,226500,2012.5,114
"29731","88343","2021",1,1,0,65000,625,104
"29732","88344","2021",2,2,0,152180,923,168.5
"29733","88345","2021",1,1,0,55000,500,110
"29734","88346","2021",13,13,0,77588.46,832.3846,92.61538
"29735","88347","2021",2,2,0,117250,1040.5,121
"29736","88348","2021",2,2,0,81500,702.5,116
"29737","88349","2021",38,26,12,107381,1339.605,82.81579
"29738","88351","2021",23,15,8,101883.7,1244.87,87.17391
"29739","88354","2021",3,3,0,128200,1083.333,115.6667
"29740","88355","2021",7,7,0,109214.3,878.4286,118.8571
"29741","88356","2021",7,7,0,162647.1,1535.429,108.2857
"29742","88357","2021",11,11,0,105872.7,977.3636,103.0909
"29743","88358","2021",23,19,4,152293.5,1450.565,104.8261
"29744","88360","2021",2,2,0,148592,1420.5,105.5
"29745","88361","2021",27,26,1,124116.6,1411.852,96.07407
"29746","88362","2021",2,2,0,237500,1736.5,148
"29747","88363","2021",4,4,0,113500,1018.75,118.5
"29748","88365","2021",2,2,0,102000,794.5,124
"29749","88366","2021",5,5,0,61949,565.8,111.2
"29750","88367","2021",47,41,6,98331.91,985.8723,97.74468
"29751","88368","2021",5,5,0,72930,862.6,82.6
"29752","88369","2021",20,18,2,155903.2,1704.85,101.9
"29753","88370","2021",2,2,0,66000,777.5,85.5
"29754","88371","2021",20,20,0,167639.5,1625.1,115.35
"29755","88372","2021",92,75,17,126614.9,1225.283,99.95652
"29756","88373","2021",8,8,0,85660,830.125,99.5
"29757","88375","2021",4,4,0,181497.5,1425.75,121
"29758","88377","2021",1,1,0,149170,1147,130
"29759","88378","2021",2,2,0,147500,1201.5,119
"29760","88380","2021",3,3,0,210000,2260,94.66667
"29761","88382","2021",1,1,0,80200,881,91
"29762","88383","2021",184,44,140,107241.9,1277.56,86.17391
"29763","88385","2021",9,9,0,97535.22,626.6667,151.6667
"29764","88386","2021",7,7,0,160915.7,1741.429,98.28571
"29765","88387","2021",2,0,2,90000,745.5,120
"29766","88388","2021",1,1,0,118000,2145,55
"29767","88389","2021",2,2,0,67500,481.5,131.5
"29768","88390","2021",1,1,0,71500,596,120
"29769","88391","2021",10,9,1,147728,2004,75.1
"29770","88393","2021",6,6,0,179925,1378.833,125.1667
"29771","88395","2021",4,4,0,78075,762,97.25
"29772","88398","2021",1,1,0,140000,1167,120
"29773","88400","2021",3,3,0,96666.67,1139.333,84.33333
"29774","88401","2021",6,6,0,100887,862.6667,116
"29775","88402","2021",1,1,0,189000,1027,184
"29776","88403","2021",3,3,0,106333.3,936,117
"29777","88406","2021",1,1,0,81000,786,103
"29778","88407","2021",1,1,0,155000,1183,131
"29779","88408","2021",52,39,13,132565.4,1280.462,106.0769
"29780","88409","2021",39,31,8,160780.3,1676.846,111.5897
"29781","88410","2021",4,4,0,80175,1074,77.5
"29782","88411","2021",2,2,0,64850,750.5,109
"29783","88412","2021",11,11,0,129189.1,1127.455,122.2727
"29784","88413","2021",296,127,169,112164.2,1224.963,90.50338
"29785","88415","2021",29,20,9,147832.4,1547.207,97.03448
"29786","88416","2021",2,2,0,147500,1022.5,139
"29787","88417","2021",6,6,0,134683.3,1128.167,113.1667
"29788","88418","2021",3,3,0,96500,1048.667,92.66667
"29789","88419","2021",4,4,0,73612.5,784.5,93.75
"29790","88423","2021",17,13,4,149627.4,1464.412,97.41176
"29791","88424","2021",27,22,5,133117.2,1442.667,95.07407
"29792","88425","2021",1,1,0,74000,638,116
"29793","88426","2021",21,16,5,127498.1,1444.81,94
"29794","88428","2021",31,30,1,185606.5,1786.968,104.0645
"29795","88429","2021",44,37,7,170038.4,1659,102.8864
"29796","88430","2021",5,5,0,99800,852.4,98.4
"29797","88431","2021",4,4,0,95850,1012.25,92.25
"29798","88432","2021",2,2,0,112000,503.5,227
"29799","88434","2021",4,4,0,119675,1086.75,108.75
"29800","88435","2021",2,2,0,311250,1404.5,229
"29801","88436","2021",2,2,0,58820,462,122
"29802","88437","2021",1,1,0,80000,920,87
"29803","88438","2021",2,2,0,64095,664.5,105.5
"29804","88439","2021",9,9,0,198784.4,1742.111,117.7778
"29805","88440","2021",1,1,0,107000,915,117
"29806","88442","2021",11,9,2,127510,1385.818,106.3636
"29807","88444","2021",10,10,0,108014,1163.5,87.3
"29808","88445","2021",37,26,11,134868.8,1375.568,94.59459
"29809","88447","2021",42,37,5,135382.5,1394.095,102.0952
"29810","88448","2021",1,1,0,105000,1780,59
"29811","88449","2021",3,3,0,108333.3,906,120.6667
"29812","88450","2021",4,4,0,92281.25,732.5,126.25
"29813","88451","2021",34,27,7,78140.44,908.7353,94.82353
"29814","88453","2021",4,4,0,88450,586,144
"29815","88454","2021",3,3,0,78000,659.6667,119
"29816","88455","2021",2,2,0,91000,1035.5,85
"29817","88456","2021",2,2,0,79712,634.5,114.5
"29818","88457","2021",3,3,0,156666.7,883.3333,186.3333
"29819","88458","2021",3,3,0,110000,794.3333,133.6667
"29820","88459","2021",1,1,0,171000,1710,100
"29821","88460","2021",4,4,0,106775,814.25,130.75
"29822","88461","2021",4,4,0,80500,991.5,89.5
"29823","88462","2021",16,13,3,154678.2,1636.25,95.0625
"29824","88463","2021",10,10,0,175654.7,1581.8,112.1
"29825","88464","2021",6,6,0,150000,1663,85.33333
"29826","88465","2021",127,90,37,133988.2,1301.197,101.9606
"29827","88466","2021",2,2,0,104500,1215.5,88
"29828","88467","2021",6,6,0,137475,1558,93
"29829","88468","2021",33,25,8,98456.52,1041.697,99.72727
"29830","88470","2021",33,23,10,146527.3,1957.212,80.12121
"29831","88471","2021",3,3,0,61000,411,142
"29832","88472","2021",1,1,0,65000,565,115
"29833","88473","2021",1,1,0,26000,342,76
"29834","88475","2021",1,1,0,110000,733,150
"29835","88477","2021",3,3,0,80000,783,103.3333
"29836","88478","2021",2,2,0,132000,990,132
"29837","88479","2021",10,10,0,60850,777.5,78.5
"29838","88480","2021",1,1,0,86000,688,125
"29839","88481","2021",19,17,2,148960,1257.158,130.0526
"29840","88483","2021",22,20,2,189925,1861.955,102.7727
"29841","88484","2021",14,14,0,147245,1421.071,114.8571
"29842","88485","2021",2,2,0,88725,638.5,149
"29843","88486","2021",40,28,12,169579,1795.725,96.925
"29844","88487","2021",59,56,3,115764.8,1177.729,100.2373
"29845","88488","2021",3,3,0,122540,1168.333,107.6667
"29846","88489","2021",6,6,0,141646.7,1134.333,121.5
"29847","88490","2021",1,1,0,90000,978,92
"29848","88491","2021",2,2,0,46250,559,85
"29849","88494","2021",1,1,0,55000,753,73
"29850","88495","2021",1,1,0,95000,1080,88
"29851","88496","2021",4,4,0,165200,1025,161.5
"29852","88497","2021",8,6,2,150437.5,1344,106.625
"29853","88498","2021",1,1,0,205000,2330,88
"29854","88499","2021",1,1,0,44000,733,60
"29855","88500","2021",23,14,9,174740.3,2313.087,85.82609
"29856","88501","2021",1,1,0,44250,395,112
"29857","88503","2021",2,2,0,173275,2505,78
"29858","88504","2021",1,1,0,76000,633,120
"29859","88505","2021",1,1,0,153200,1459,105
"29860","88506","2021",9,9,0,100327.8,1095,90.33333
"29861","88507","2021",2,2,0,148850,1008,142.5
"29862","88508","2021",6,5,1,92166.67,1037,77.33333
"29863","88509","2021",3,3,0,116951,817,137.6667
"29864","88510","2021",4,4,0,78808.75,726.5,109
"29865","88511","2021",1,1,0,44900,449,100
"29866","88512","2021",3,3,0,121966.7,865.6667,117.6667
"29867","88513","2021",31,31,0,136711.3,1360.968,103.0323
"29868","88514","2021",1,1,0,46000,341,135
"29869","88515","2021",3,3,0,73333.33,790.3333,93
"29870","88516","2021",116,52,64,98154.49,1253.233,77.91379
"29871","88517","2021",1,1,0,60400,549,110
"29872","88519","2021",10,10,0,126071,1312.5,98.6
"29873","88520","2021",8,8,0,136148.4,1272.375,109.625
"29874","88521","2021",6,6,0,128571.5,1269.333,105.5
"29875","88523","2021",2,2,0,84150,654.5,128.5
"29876","88524","2021",1,1,0,94900,999,95
"29877","88526","2021",12,12,0,109733.3,1491.417,81.25
"29878","88527","2021",4,4,0,120030,1099,100.25
"29879","88528","2021",1,0,1,179000,1790,100
"29880","88529","2021",1,1,0,123000,1108,111
"29881","88530","2021",29,28,1,109792.1,1057.621,112.931
"29882","88531","2021",60,39,21,212486.3,2753.733,79.73333
"29883","89003","2021",62,60,2,126125.5,1359.403,100.9839
"29884","89004","2021",9,9,0,106333.3,1064.889,93.66667
"29885","89005","2021",16,16,0,72500,717.375,95.25
"29886","89006","2021",2,2,0,52500,654,72.5
"29887","89007","2021",2,2,0,33500,598,58
"29888","89008","2021",1,1,0,30000,1200,25
"29889","89009","2021",4,4,0,115421.2,1278.75,83.75
"29890","89010","2021",2,2,0,77875,874,91
"29891","89013","2021",42,42,0,154439.2,1611.452,99.21429
"29892","89014","2021",28,28,0,89421.43,968.3571,94.85714
"29893","89015","2021",18,18,0,71661.11,854.6111,82.16667
"29894","89016","2021",1,1,0,40000,597,67
"29895","89017","2021",4,4,0,39500,819.75,55.5
"29896","89018","2021",24,24,0,117220.8,1288.25,96.08333
"29897","89019","2021",3,3,0,58266.67,591.6667,102
"29898","89020","2021",8,8,0,64875,883.375,73.875
"29899","89021","2021",8,7,1,69653.75,1075.875,75.125
"29900","89022","2021",2,2,0,127700,1408,93.5
"29901","89023","2021",10,10,0,127450,1456,86.4
"29902","89024","2021",639,245,394,121755.3,1650.768,75.35368
"29903","89025","2021",105,75,30,121252.2,1411.781,87.55238
"29904","89027","2021",10,10,0,140790,1399.9,109.2
"29905","89028","2021",3,3,0,53900,624,97.33333
"29906","89029","2021",14,14,0,111070,1245.214,90.78571
"29907","89030","2021",2,2,0,83800,831,100
"29908","89031","2021",12,12,0,136504.2,1446.667,101.75
"29909","89032","2021",2,2,0,142000,1499.5,96.5
"29910","89033","2021",9,9,0,160777.8,1451.667,111.4444
"29911","89034","2021",3,3,0,115176.7,1131,98.33333
"29912","89035","2021",8,8,0,106808.8,1183.25,89.875
"29913","89036","2021",4,4,0,185625,1545.25,124.5
"29914","89037","2021",10,10,0,138700,1445.5,100.9
"29915","89039","2021",2,2,0,88750,597,143.5
"29916","89040","2021",6,6,0,111645.7,1000.333,111
"29917","89041","2021",5,5,0,148040,1116,129.4
"29918","89042","2021",4,4,0,99625,1148.75,90.25
"29919","89043","2021",5,5,0,181775,1371.2,141.8
"29920","89044","2021",1,1,0,97000,808,120
"29921","89045","2021",1,1,0,185000,1555,119
"29922","89046","2021",32,31,1,87733.44,1029.906,86.1875
"29923","89048","2021",11,11,0,151928.2,1258,125.7273
"29924","89050","2021",21,20,1,113401.2,1501,81.57143
"29925","89051","2021",14,14,0,176085.7,1423.857,136.8571
"29926","89053","2021",12,12,0,146875,1625.75,92
"29927","89054","2021",18,18,0,163708.3,1791.278,93.94444
"29928","89055","2021",33,32,1,103569.5,1176.636,88.27273
"29929","89056","2021",7,7,0,150742.9,1443.714,105.1429
"29930","89057","2021",8,8,0,85413.75,774.625,112.375
"29931","89058","2021",4,4,0,131750,1087.5,138.25
"29932","89059","2021",17,17,0,105617.6,1236.941,91.52941
"29933","89060","2021",6,6,0,110466.7,1558,78.83333
"29934","89061","2021",2,2,0,114500,1072.5,110
"29935","89062","2021",3,3,0,102000,1053.667,109
"29936","89063","2021",19,19,0,118806.4,1280.105,94.26316
"29937","89064","2021",2,2,0,128033,1093.5,132.5
"29938","89065","2021",4,4,0,113447.5,1022.5,116.5
"29939","89066","2021",18,18,0,144677.8,1395.278,107.8333
"29940","89067","2021",22,22,0,127322.7,1424.318,89.72727
"29941","89068","2021",37,37,0,156901.2,1450.973,108.6216
"29942","89069","2021",13,13,0,108846.2,966.6154,113.3077
"29943","89071","2021",4,4,0,58250,654.25,84.25
"29944","89072","2021",11,11,0,100369.8,1153.364,79.63636
"29945","89073","2021",26,26,0,120733.5,1234.115,89.34615
"29946","89074","2021",59,57,2,162172.1,1757.729,101.1525
"29947","89075","2021",16,16,0,191112.5,1499,129.9375
"29948","89076","2021",15,15,0,110926.7,1031.067,98.6
"29949","89077","2021",18,16,2,174696.7,1647.444,102.3889
"29950","89079","2021",16,14,2,137012.5,1344.812,98.125
"29951","89080","2021",5,5,0,159800,1358.6,114
"29952","89081","2021",2,2,0,142500,1821.5,85
"29953","89083","2021",27,27,0,207503.8,1739.926,122.1852
"29954","89084","2021",3,3,0,116166.7,1569.333,75
"29955","89085","2021",21,21,0,92809.48,1186,79.95238
"29956","89086","2021",139,139,0,108153.4,1222.029,91.17986
"29957","89087","2021",8,8,0,83687.5,981.25,79
"29958","89088","2021",5,5,0,176200,1731.8,101.2
"29959","89089","2021",1,1,0,16875,412,41
"29960","89091","2021",14,13,1,106350,1037.571,107.7857
"29961","89092","2021",5,5,0,81720,1057.8,76.4
"29962","89093","2021",13,13,0,122466.2,1658.769,75.69231
"29963","89094","2021",19,19,0,150364.7,1319.316,116.7895
"29964","89095","2021",2,2,0,31750,488.5,65
"29965","89096","2021",10,10,0,122986.2,1278.1,93.7
"29966","89098","2021",2,2,0,220000,1346.5,161.5
"29967","89099","2021",31,29,2,110060.4,1358.097,83.51613
"29968","89100","2021",39,37,2,140413.7,1600.692,93.66667
"29969","89101","2021",8,8,0,81778.75,823,105.375
"29970","89102","2021",33,33,0,167298.5,1531.485,112.5455
"29971","89104","2021",1,1,0,25000,446,56
"29972","89105","2021",3,3,0,138000,1485.333,94
"29973","89108","2021",7,7,0,134057.1,1310.429,109.1429
"29974","89111","2021",7,7,0,132678.6,1192.571,126
"29975","89112","2021",3,3,0,94533.33,913.6667,100
"29976","89113","2021",7,7,0,145214.3,1348.286,116.8571
"29977","89115","2021",3,3,0,156500,1456.333,134.3333
"29978","89116","2021",6,6,0,210633.3,1551,145.8333
"29979","89117","2021",3,3,0,104251.7,1008.333,103
"29980","89118","2021",9,9,0,127100,854.5556,160.2222
"29981","89119","2021",5,5,0,132249.6,1339.2,103
"29982","89120","2021",7,7,0,141828.6,1547.143,100.2857
"29983","89122","2021",15,15,0,88333.33,1160,82.13333
"29984","89123","2021",3,3,0,41666.67,969.6667,42.66667
"29985","89124","2021",24,24,0,183330.8,1690.25,109.9583
"29986","89125","2021",16,15,1,99493.75,1268.812,81.375
"29987","89126","2021",2,2,0,141212.5,1792.5,78
"29988","89127","2021",10,10,0,158240,1724.4,98.5
"29989","89128","2021",5,5,0,92700,1005,84.6
"29990","89129","2021",8,8,0,67625,810.625,82.25
"29991","89130","2021",27,27,0,95137.04,1145.074,87.07407
"29992","89131","2021",5,5,0,64000,832,85
"29993","89132","2021",3,3,0,158000,1106.667,144
"29994","89133","2021",6,6,0,116500,1035.667,124.5
"29995","89134","2021",2,2,0,117000,1286,88
"29996","89136","2021",17,17,0,179205.9,1643.412,118.8235
"29997","89137","2021",4,4,0,64750,1025,69.5
"29998","89139","2021",25,25,0,141652.5,1501.96,95.88
"29999","89141","2021",2,2,0,118500,804,124.5
"30000","89142","2021",22,22,0,118027.3,1421,92.5
"30001","89143","2021",6,6,0,215000,1197,184.8333
"30002","89144","2021",11,11,0,149863.6,1737.091,93.63636
"30003","89145","2021",7,7,0,75607.14,1114.857,71.71429
"30004","89146","2021",4,4,0,81875,789.75,103
"30005","89147","2021",8,8,0,156424.2,1409,117.375
"30006","89148","2021",5,5,0,68100,561.8,121.6
"30007","89149","2021",4,4,0,86250,1007.75,81.5
"30008","89150","2021",6,6,0,175357.8,1274.5,133
"30009","89151","2021",37,37,0,91670.27,1563.973,61
"30010","89152","2021",16,16,0,108718.8,1256.188,92.9375
"30011","89153","2021",14,14,0,113785.7,918.9286,125.5714
"30012","89154","2021",20,19,1,141798.5,1453.25,107.75
"30013","89155","2021",12,12,0,151014.2,1526.917,93.58333
"30014","89156","2021",5,5,0,101180,1339.8,81.8
"30015","89158","2021",20,20,0,82838,1004,85.75
"30016","89159","2021",2,2,0,158500,2032,84
"30017","89160","2021",17,15,2,124250.1,1533,88.88235
"30018","89161","2021",3,3,0,90000,1167.667,80.33333
"30019","89162","2021",6,6,0,131708.3,1312.333,99
"30020","89163","2021",15,15,0,117058.4,1078.667,107.5333
"30021","89164","2021",1,1,0,70000,1000,70
"30022","89165","2021",4,4,0,128862.5,1510.25,88.25
"30023","89167","2021",13,13,0,148430.8,1442.615,106.0769
"30024","89168","2021",2,2,0,92000,911,106
"30025","89169","2021",12,12,0,109306.7,1150.5,97.58333
"30026","89170","2021",1,1,0,60000,706,85
"30027","89171","2021",7,7,0,88142.86,1184.714,77
"30028","89172","2021",6,6,0,186350,1599,116
"30029","89173","2021",9,9,0,125598.9,1566.222,101
"30030","89176","2021",5,5,0,89400,841,106.6
"30031","89177","2021",5,5,0,51348,852.2,63.4
"30032","89179","2021",7,7,0,165571.4,1417.143,108.7143
"30033","89180","2021",8,8,0,168812.5,1308.25,128.75
"30034","89181","2021",9,9,0,100451.1,1202.111,84.33333
"30035","89182","2021",4,4,0,110500,984,110.5
"30036","89184","2021",2,2,0,303025,1339.5,171
"30037","89186","2021",7,7,0,103308.9,1462.571,72.28571
"30038","89187","2021",1,1,0,125000,658,190
"30039","89188","2021",2,2,0,164250,1009.5,162
"30040","89189","2021",9,8,1,142355.6,1510,94.55556
"30041","89190","2021",3,3,0,309966.7,1489.333,174.3333
"30042","89191","2021",1,1,0,73000,608,120
"30043","89194","2021",2,2,0,106000,1332,80
"30044","89195","2021",10,10,0,191207.6,1526.9,122.5
"30045","89196","2021",40,39,1,150663,1374.175,111.725
"30046","89197","2021",8,8,0,93361.25,1053.5,91.5
"30047","89198","2021",18,18,0,141615.2,1670.611,84.72222
"30048","89199","2021",8,8,0,115743.8,1161.75,98.75
"30049","89200","2021",6,6,0,133583.3,1364.333,103.3333
"30050","89201","2021",33,32,1,156250,1537.667,104.5758
"30051","89202","2021",9,9,0,96853.33,1284,78
"30052","89203","2021",3,3,0,47964.67,749,77.33333
"30053","89204","2021",15,15,0,79372.67,1041.2,74.93333
"30054","89205","2021",3,3,0,68166.67,746,93.33333
"30055","89206","2021",138,109,29,130792.7,1553.812,83.15942
"30056","89208","2021",8,8,0,87186.25,968.125,91.125
"30057","89209","2021",15,15,0,169766.7,1367.667,131.4667
"30058","89210","2021",3,3,0,93166.67,1125,84.66667
"30059","89212","2021",5,5,0,160000,1451.4,124
"30060","89214","2021",4,4,0,173433,1026.75,177.25
"30061","89215","2021",4,4,0,139000,1147.75,125.75
"30062","89216","2021",7,7,0,122157.1,1085.143,111.2857
"30063","89217","2021",3,3,0,172193.3,1583.333,132.3333
"30064","89218","2021",28,27,1,101821.4,1265.286,80.28571
"30065","89220","2021",10,10,0,59083.5,879.1,67.7
"30066","89221","2021",7,7,0,107585.7,1157.571,91.28571
"30067","89222","2021",3,3,0,85266.67,1030.667,79
"30068","89223","2021",10,10,0,126013,971.2,120.3
"30069","89224","2021",2,2,0,83350,632.5,128
"30070","89225","2021",1,1,0,57000,570,100
"30071","89226","2021",3,3,0,94433.33,954,98.33333
"30072","89227","2021",16,16,0,117845.5,1195.188,99.875
"30073","89228","2021",10,10,0,187853.6,2151.8,90.2
"30074","89229","2021",9,9,0,150111.1,1634.111,92.22222
"30075","89230","2021",6,6,0,145833.3,1566.167,94.16667
"30076","89232","2021",3,3,0,154966.7,1388.667,113.3333
"30077","89233","2021",4,4,0,89837.5,1027,95.5
"30078","89234","2021",4,4,0,55250,705.5,85.5
"30079","89235","2021",8,7,1,141062.5,1602.25,85.5
"30080","89236","2021",17,17,0,254164.1,2024.176,125.3529
"30081","89237","2021",13,13,0,99269.23,1024.231,95.84615
"30082","89238","2021",9,9,0,73305.56,860.7778,79.55556
"30083","89239","2021",24,23,1,234007.3,2365.083,103.0833
"30084","89240","2021",4,4,0,123675,1102.25,127.75
"30085","89242","2021",8,7,1,93175,1315,70.875
"30086","89245","2021",18,18,0,150688.6,1348.333,119.6111
"30087","89246","2021",10,10,0,114948.1,1168.7,99.2
"30088","89247","2021",6,6,0,82316.67,931.3333,89
"30089","89248","2021",3,3,0,67666.67,790,79
"30090","89249","2021",1,1,0,81500,637,128
"30091","89251","2021",10,10,0,121958.7,1444.9,87.2
"30092","89253","2021",8,8,0,72750,816.625,85.625
"30093","89254","2021",13,13,0,175314.5,1376.077,121.9231
"30094","89255","2021",34,34,0,159627.7,1728.412,96.08824
"30095","89256","2021",7,7,0,106500,1227.571,86.57143
"30096","89257","2021",106,86,20,92170.97,1242.396,76.83962
"30097","89259","2021",4,4,0,119875,1235.5,100.5
"30098","89261","2021",4,4,0,170077.5,1318,120
"30099","89262","2021",5,5,0,62600,803.8,82.8
"30100","89263","2021",45,42,3,163464.4,2038.4,90.48889
"30101","89264","2021",14,14,0,157734.3,1494.357,109.6429
"30102","89265","2021",11,11,0,158409.1,1394.455,116.0909
"30103","89266","2021",8,8,0,76812.5,1146.375,71.875
"30104","89267","2021",2,1,1,130000,1375,91
"30105","89268","2021",14,14,0,142171.4,1185.786,126.7857
"30106","89270","2021",5,5,0,79900,867,89.6
"30107","89271","2021",1,1,0,272000,2641,103
"30108","89272","2021",2,2,0,132500,1003.5,138
"30109","89273","2021",18,18,0,103785.6,1326.167,85.83333
"30110","89274","2021",16,16,0,181712.8,1536.312,123.375
"30111","89276","2021",12,12,0,113628.8,1032.167,121.25
"30112","89277","2021",4,4,0,140000,1544.25,97.5
"30113","89278","2021",8,8,0,157887.5,1603,108.125
"30114","89279","2021",10,9,1,171890,1955.1,93
"30115","89280","2021",4,4,0,96391.25,950,92
"30116","89281","2021",11,11,0,134290.9,1522.273,95.63636
"30117","89282","2021",17,17,0,137188.2,1160.941,124.4118
"30118","89283","2021",17,17,0,135999.1,1359.471,101.0588
"30119","89284","2021",1,1,0,49000,681,72
"30120","89285","2021",2,2,0,160000,1578,101.5
"30121","89286","2021",13,13,0,135330.8,1316.154,103.6923
"30122","89287","2021",64,46,18,158513.9,1927.594,89.92188
"30123","89288","2021",6,6,0,93500,1094,92.83333
"30124","89289","2021",10,10,0,91850,1066.4,89.9
"30125","89290","2021",1,1,0,110000,1294,85
"30126","89291","2021",8,7,1,144875,1256.875,115.375
"30127","89292","2021",7,7,0,88892.86,1141.429,84
"30128","89295","2021",9,9,0,202442.2,1854.778,110.8889
"30129","89296","2021",1,1,0,140300,2505,56
"30130","89298","2021",13,13,0,138538.5,1777.308,84.23077
"30131","89300","2021",2,2,0,125495,792.5,157
"30132","89302","2021",4,4,0,162250,1936.5,84.25
"30133","89303","2021",5,5,0,75591.8,821.4,95.6
"30134","89304","2021",18,18,0,130047.2,1276.389,108.8333
"30135","89306","2021",7,7,0,165964.3,1138,131.5714
"30136","89307","2021",7,7,0,115320,1487.429,81.14286
"30137","89308","2021",4,4,0,135500,2072.5,66.75
"30138","89309","2021",68,60,8,123730.2,1535.309,82.66176
"30139","89310","2021",5,5,0,134220,1362,95.2
"30140","89311","2021",20,20,0,151897,1502.05,108.55
"30141","89312","2021",4,4,0,68497.5,863.5,79
"30142","89313","2021",14,14,0,118750,1282.357,98.5
"30143","89314","2021",7,7,0,84300,1062.286,84.57143
"30144","89315","2021",2,2,0,129500,1257,106.5
"30145","89318","2021",11,11,0,122907.7,1350.273,87.90909
"30146","89319","2021",9,9,0,133333.3,1295.333,100.5556
"30147","89320","2021",2,2,0,67500,1096,62
"30148","89321","2021",13,13,0,74845.08,953.7692,81.53846
"30149","89323","2021",7,7,0,109695.7,962.4286,101.8571
"30150","89324","2021",30,30,0,111169.7,1201.167,94.5
"30151","89325","2021",3,3,0,309700.3,1873,154
"30152","89326","2021",16,16,0,181121.2,1710.812,109.125
"30153","89327","2021",8,8,0,116375,1348.5,91.375
"30154","89328","2021",3,3,0,196300,1390.667,148
"30155","89329","2021",4,4,0,94800,1120.5,74.5
"30156","89331","2021",13,13,0,116846.2,1365.308,86.92308
"30157","89332","2021",16,16,0,177628.1,1724.562,104.1875
"30158","89333","2021",4,4,0,108000,1010,97
"30159","89334","2021",13,13,0,131830.5,1227.769,105
"30160","89335","2021",5,5,0,109500,1366.2,84.2
"30161","89336","2021",5,5,0,119682,873.6,131.8
"30162","89337","2021",17,17,0,107914.7,1257.588,91.05882
"30163","89338","2021",33,28,5,139253,1684.212,80.87879
"30164","89339","2021",4,4,0,80350,813.25,95
"30165","89341","2021",8,8,0,97300,1010,96.625
"30166","89342","2021",10,10,0,172700,1861.9,98.5
"30167","89344","2021",34,33,1,116355.7,1371.706,81.47059
"30168","89345","2021",61,52,9,108859.5,1031.623,107.9016
"30169","89346","2021",77,60,17,180115.5,1825.766,101.6753
"30170","89347","2021",7,7,0,163107.1,1455.143,116.1429
"30171","89348","2021",46,45,1,102271.5,1372.957,77.67391
"30172","89349","2021",9,9,0,125430.6,1076.556,113.1111
"30173","89350","2021",6,6,0,165050,1667.667,98.5
"30174","89351","2021",9,9,0,129863.1,1214.556,106.3333
"30175","89352","2021",8,8,0,136000,1194,99.875
"30176","89353","2021",10,10,0,134180,1258.2,109.8
"30177","89354","2021",23,23,0,165382.9,1743.652,104.7391
"30178","89355","2021",3,3,0,100333.3,1263,76
"30179","89359","2021",8,8,0,126675,1608.75,84.375
"30180","89360","2021",6,6,0,179000,1345.833,141.1667
"30181","89361","2021",10,10,0,148298.5,1299.6,115.9
"30182","89362","2021",1,1,0,139000,1463,95
"30183","89363","2021",3,3,0,82000,908.6667,97.33333
"30184","89364","2021",9,9,0,63952.56,957.4444,71.44444
"30185","89365","2021",11,11,0,98500,1243.455,74.36364
"30186","89367","2021",12,12,0,140813.5,1409.333,95.91667
"30187","89368","2021",19,19,0,79539.47,1072.263,90.73684
"30188","89369","2021",9,9,0,130722.2,1368.889,101
"30189","89370","2021",21,19,2,147902.2,1617.238,98.85714
"30190","89371","2021",4,4,0,78750,881.25,86
"30191","89373","2021",6,6,0,190341.7,1794,105.5
"30192","89374","2021",2,2,0,170625,910,154.5
"30193","89375","2021",2,2,0,42750,727,58.5
"30194","89376","2021",4,4,0,94500,989.75,89.75
"30195","89377","2021",1,1,0,38000,950,40
"30196","89378","2021",12,12,0,130623,1341.417,99.91667
"30197","89379","2021",1,1,0,95000,1188,80
"30198","89380","2021",17,14,3,498108.8,5035.941,100.9412
"30199","89382","2021",24,24,0,123722.1,1438.167,85.5
"30200","89383","2021",1,1,0,120000,1875,64
"30201","89384","2021",11,11,0,154018.2,1408.636,112.2727
"30202","89385","2021",1,1,0,70000,875,80
"30203","89386","2021",1,1,0,47500,505,94
"30204","89387","2021",456,191,265,127135.8,1647.362,77.22368
"30205","89388","2021",16,16,0,122456.2,1450.312,91.3125
"30206","89390","2021",9,9,0,181613.4,1423.111,123.1111
"30207","89391","2021",16,16,0,126206.2,1283.625,100.5625
"30208","89392","2021",8,8,0,104489.8,1035.75,111.5
"30209","89393","2021",5,5,0,119184,1015,112.6
"30210","89394","2021",3,3,0,54500,742,70.33333
"30211","89395","2021",16,16,0,70862.5,792.4375,91.625
"30212","89397","2021",17,17,0,142254.2,1302.882,109.8235
"30213","89398","2021",4,4,0,99200,1316,88.75
"30214","89399","2021",19,19,0,190444.7,1966.158,97.57895
"30215","89400","2021",14,14,0,100824.8,967.7857,105.2143
"30216","89402","2021",1,1,0,244585,2446,100
"30217","89403","2021",1,1,0,72000,600,120
"30218","89404","2021",10,10,0,156260,1565.4,90.9
"30219","89405","2021",9,9,0,150398.9,919.8889,153.1111
"30220","89406","2021",2,2,0,107000,1455.5,89
"30221","89407","2021",24,24,0,77520.83,1036.375,78.95833
"30222","89408","2021",9,8,1,114062.8,1289.444,93.55556
"30223","89409","2021",1,1,0,17000,405,42
"30224","89410","2021",2,2,0,76700,710,107
"30225","89411","2021",18,18,0,158361.1,1734.667,99.77778
"30226","89413","2021",2,2,0,159675,1208,118.5
"30227","89414","2021",44,35,9,123008,1387.386,90.77273
"30228","89415","2021",2,2,0,101000,1362.5,81
"30229","89416","2021",15,15,0,93366.67,1040.133,98.2
"30230","89418","2021",62,54,8,94481.35,1010.177,93.37097
"30231","89419","2021",36,35,1,117256.1,1429.056,87.33333
"30232","89420","2021",37,37,0,109501.6,1154.459,97.48649
"30233","89423","2021",1,1,0,515400,2577,200
"30234","89424","2021",4,4,0,147750,1055.75,139.5
"30235","89425","2021",10,10,0,137445.9,1063.1,131
"30236","89426","2021",8,8,0,113175,1106.75,101.5
"30237","89427","2021",17,17,0,135429.4,1344.176,100.1176
"30238","89428","2021",11,11,0,151339.1,1751.636,95.63636
"30239","89430","2021",2,2,0,97500,984.5,99
"30240","89431","2021",1,1,0,207800,2187,95
"30241","89432","2021",11,11,0,131009.1,1315.364,106.7273
"30242","89433","2021",3,3,0,118333.3,1664,75
"30243","89434","2021",4,4,0,172250,1421.25,122.75
"30244","89436","2021",10,10,0,84349,957.5,93.4
"30245","89437","2021",4,4,0,164712.5,1386.5,125
"30246","89438","2021",37,37,0,147639.8,1557.459,97.75676
"30247","89439","2021",24,23,1,145636.2,1248.5,120.375
"30248","89440","2021",14,14,0,165483.6,1426.071,119.5714
"30249","89441","2021",32,32,0,74605.31,887.4688,83.03125
"30250","89442","2021",4,4,0,130050,999.25,126
"30251","89443","2021",35,35,0,157691.4,1561.457,103.0571
"30252","89445","2021",1,1,0,91000,958,95
"30253","89446","2021",13,12,1,156284.6,1779.615,92.46154
"30254","89447","2021",4,4,0,82750,963.5,82.5
"30255","89449","2021",38,37,1,172728.9,1814.132,102.1842
"30256","89450","2021",14,14,0,172878.6,1525.214,119.6429
"30257","89451","2021",9,9,0,140577.8,1329,113.3333
"30258","89452","2021",7,7,0,102571.4,1106.571,100.4286
"30259","89453","2021",14,14,0,205214.2,2312.714,109.5
"30260","89456","2021",16,16,0,145681.2,1697.625,91.125
"30261","89458","2021",5,5,0,143000,1644,82.2
"30262","89459","2021",7,6,1,133000,1833.857,83.14286
"30263","89460","2021",51,48,3,165124.9,1804.608,94.94118
"30264","89461","2021",18,18,0,79675,783.6667,107.8889
"30265","89462","2021",5,5,0,112220,1116,106.6
"30266","89463","2021",2,2,0,227800,1385.5,169
"30267","89464","2021",119,94,25,120578.7,1404.538,86.41176
"30268","89465","2021",3,3,0,123000,1590.667,93.33333
"30269","89466","2021",4,4,0,222125,2030,112.5
"30270","89467","2021",16,16,0,149453.1,1361.062,121.3125
"30271","89468","2021",7,7,0,88057.14,1010.143,91.85714
"30272","89469","2021",21,21,0,158807.1,1262.238,131.9048
"30273","89470","2021",2,2,0,77086,1037.5,76.5
"30274","89471","2021",10,10,0,123800,1230.9,111.8
"30275","89472","2021",10,10,0,129324,1136.5,117.7
"30276","89474","2021",2,2,0,157500,1049,137.5
"30277","89475","2021",2,2,0,190000,1688.5,149
"30278","89477","2021",2,2,0,156300,1603,97
"30279","89478","2021",23,21,2,122408.7,1384.304,91.30435
"30280","89479","2021",7,7,0,85491.43,1088.143,80.42857
"30281","89480","2021",25,25,0,194798,2224.52,98.64
"30282","89481","2021",3,3,0,65666.67,887.6667,68.33333
"30283","89482","2021",2,2,0,36750,1169,32
"30284","89483","2021",11,11,0,166310,1585.091,108.6364
"30285","89485","2021",4,4,0,161010,2159.75,110.25
"30286","89486","2021",1,1,0,39000,476,82
"30287","90001","2021",10,9,1,171505,1959.5,89.4
"30288","90002","2021",5,4,1,215318,3142.6,86.2
"30289","90003","2021",13,13,0,220653.8,2009.462,117.4615
"30290","90004","2021",4,3,1,243250,2148.25,115.75
"30291","90005","2021",10,10,0,147950,1694.8,93.5
"30292","90006","2021",5,5,0,122060,1330.6,92
"30293","90008","2021",58,31,27,146577.3,1574.845,91.06897
"30294","90009","2021",58,38,20,134933.3,1436.793,94.10345
"30295","90010","2021",724,121,603,107035,1389.544,75.3232
"30296","90011","2021",1,1,0,223740,2307,97
"30297","90012","2021",15,9,6,223749.3,2045.333,111.3333
"30298","90013","2021",1,1,0,165000,1375,120
"30299","90014","2021",8,8,0,215162.5,1881.125,115.625
"30300","90015","2021",3,3,0,161071.7,1430,113
"30301","90017","2021",15,6,9,160796.7,1503.933,105.8667
"30302","90018","2021",4,4,0,242025,1761.25,140.25
"30303","90019","2021",1,1,0,115000,719,160
"30304","90020","2021",3,1,2,118666.7,958.3333,110.6667
"30305","90021","2021",1,1,0,261400,1922,136
"30306","90022","2021",42,30,12,141356.2,1628.262,87.90476
"30307","90023","2021",15,14,1,159981.3,1547.933,99.66667
"30308","90024","2021",1,1,0,253500,1527,166
"30309","90025","2021",6,5,1,173050,1819.333,101
"30310","90026","2021",15,10,5,232912.3,2025.067,114.1333
"30311","90027","2021",1,1,0,175000,1346,130
"30312","90028","2021",2,1,1,153500,1307.5,119.5
"30313","90029","2021",19,11,8,154743.2,1756.263,95.47368
"30314","90030","2021",2,2,0,169255.5,1555.5,102.5
"30315","90031","2021",4,4,0,204612.5,1510.25,143
"30316","90032","2021",45,26,19,142070.1,1465.911,97.31111
"30317","90033","2021",56,26,30,130094.7,1537.25,85.46429
"30318","90034","2021",4,4,0,228487.5,1914.25,119.75
"30319","90035","2021",4,3,1,251115,1580,140
"30320","90036","2021",4,1,3,97500,1229.5,79.5
"30321","90037","2021",12,11,1,191449.2,1749.25,111
"30322","90039","2021",36,23,13,180905.2,1720.139,102.9167
"30323","90041","2021",15,11,4,171895.9,1557.8,114.6667
"30324","90042","2021",17,15,2,178048.2,1754.353,103.5294
"30325","90043","2021",9,8,1,196040.8,1973.222,112.4444
"30326","90044","2021",2,2,0,291025,1438.5,203
"30327","90045","2021",11,11,0,207045.5,1996.909,104.3636
"30328","90046","2021",4,4,0,224275,1708,128.75
"30329","90047","2021",4,4,0,171639.2,2007,93.5
"30330","90049","2021",9,8,1,131577.8,1616.111,88.55556
"30331","90050","2021",4,4,0,204862.5,2010,101.25
"30332","90051","2021",2,2,0,170450,1885.5,89.5
"30333","90052","2021",25,20,5,136461.6,1379.16,102.72
"30334","90053","2021",34,24,10,142739.7,1522.265,94.67647
"30335","90054","2021",7,6,1,148531.7,1431.286,110.8571
"30336","90055","2021",4,4,0,227825,1801.25,127
"30337","90056","2021",16,14,2,170202,1722.688,99.5
"30338","90057","2021",7,7,0,218132.7,1520.143,141.7143
"30339","90058","2021",7,5,2,169700,1403.714,134.2857
"30340","90059","2021",2,2,0,204820,2360.5,85.5
"30341","90060","2021",1,1,0,243301,2616,93
"30342","90062","2021",3,3,0,220433.3,1852.333,129
"30343","90063","2021",3,3,0,138490,1984.333,69.33333
"30344","90064","2021",2,2,0,222450,1779.5,126.5
"30345","90065","2021",10,9,1,135572.5,1131.6,116.8
"30346","90066","2021",4,4,0,125125,1618.75,101.75
"30347","90067","2021",5,5,0,198600,1547.2,121.6
"30348","90068","2021",14,12,2,182255,1768.286,102.0714
"30349","90069","2021",13,11,2,163736.9,1454.077,114.2308
"30350","90070","2021",3,3,0,207666.7,1546.333,130
"30351","90071","2021",15,12,3,166740,1679.467,105.8667
"30352","90072","2021",15,9,6,172258.9,1777.667,96.6
"30353","90074","2021",3,2,1,217466.7,1605,143.3333
"30354","90075","2021",50,36,14,203678.7,1927.74,106.2
"30355","90076","2021",13,9,4,195576.9,1926.692,102.3846
"30356","90077","2021",6,6,0,147133.3,1690.833,84.66667
"30357","90078","2021",1,1,0,210000,2100,100
"30358","90079","2021",4,4,0,157625,1888,85
"30359","90080","2021",5,5,0,191570,1743,110
"30360","90081","2021",6,5,1,152500,1436.5,117
"30361","90082","2021",4,4,0,286875,1707.25,177
"30362","90084","2021",3,2,1,223555,1727,135.6667
"30363","90086","2021",6,6,0,223133.3,1788.167,132.3333
"30364","90087","2021",9,8,1,201927.8,1755.111,122.4444
"30365","90088","2021",15,14,1,154180,1447.133,112.6
"30366","90089","2021",28,10,18,111746,1280.821,87.64286
"30367","90090","2021",2,2,0,259475,2142.5,129.5
"30368","90091","2021",7,7,0,179550,1433,124.1429
"30369","90093","2021",10,7,3,119841,1429,81.8
"30370","90094","2021",8,6,2,157820,2438.75,71.375
"30371","90095","2021",5,5,0,200960,1939,104.8
"30372","90096","2021",7,7,0,239187.1,1685.714,140.7143
"30373","90097","2021",16,12,4,180135.9,1781,103.1875
"30374","90098","2021",4,3,1,180700,1568,112.25
"30375","90099","2021",95,33,62,126520.7,1469.105,85.58947
"30376","90102","2021",12,12,0,157825.8,1646.5,115.3333
"30377","90103","2021",5,3,2,216794,2052.4,103.4
"30378","90104","2021",7,2,5,130200,1734.429,75.14286
"30379","90105","2021",1,1,0,320000,1290,248
"30380","91001","2021",11,11,0,288726.1,2303.818,134.2727
"30381","91016","2021",94,83,11,201465.9,2224.777,92.06383
"30382","91017","2021",24,19,5,281200,3264,91.54167
"30383","91021","2021",195,55,140,217286.1,3322.267,68.28718
"30384","91022","2021",1,1,0,260000,1857,140
"30385","91027","2021",415,142,273,250945.7,3723.275,68.18072
"30386","91035","2021",8,8,0,262156.2,2210.625,118.75
"30387","91037","2021",9,8,1,351050,3261,114.8889
"30388","91038","2021",16,15,1,319847.8,3342.125,100.75
"30389","91041","2021",11,11,0,430651.8,3947.182,113.6364
"30390","91044","2021",83,56,27,345507.6,3940.735,90.74699
"30391","91045","2021",97,78,19,271797.6,3215.093,86.27835
"30392","91047","2021",54,32,22,232397.4,3163.833,80.68519
"30393","91064","2021",77,42,35,502248.5,4935.675,104.8571
"30394","91067","2021",3,3,0,153333.3,2079,79.66667
"30395","91069","2021",4,3,1,238625,2464.25,100.5
"30396","91075","2021",2,2,0,295250,3481,102
"30397","91079","2021",11,10,1,272661.9,2485.455,126.0909
"30398","91080","2021",18,16,2,287263.9,2834.833,110.2222
"30399","91081","2021",7,7,0,341717.4,2628.286,140.5714
"30400","91085","2021",63,56,7,297224.4,3404.175,90.4127
"30401","91086","2021",161,112,49,276212.2,3159.379,89.46584
"30402","91093","2021",7,7,0,535091.7,3682.571,151.8571
"30403","91095","2021",28,24,4,258686.1,3356.643,82.25
"30404","91097","2021",155,59,96,210914.9,2866.961,76.52258
"30405","91098","2021",6,5,1,248541.7,3370.5,80.5
"30406","91099","2021",68,55,13,264273.4,2990.015,94.26471
"30407","91100","2021",11,11,0,314460,2917.636,115.5455
"30408","91103","2021",324,150,174,251242.4,3315.324,79.01852
"30409","91105","2021",91,86,5,299103.2,3049.835,101.4615
"30410","91106","2021",22,19,3,287841.4,3277.636,94.09091
"30411","91109","2021",18,17,1,260618.9,2703.222,102.5
"30412","91111","2021",35,30,5,341564.9,3706.686,96
"30413","91112","2021",1,1,0,250000,2381,105
"30414","91114","2021",359,176,183,290851.3,3666.326,81.05571
"30415","91115","2021",47,30,17,252605.2,3175.617,83.48936
"30416","91121","2021",8,8,0,257937.5,3884.25,85.75
"30417","91122","2021",111,68,43,385560.5,4616.153,90.71171
"30418","91129","2021",67,59,8,277231.8,3013.328,98.28358
"30419","91130","2021",28,24,4,226736.8,2504.536,95.96429
"30420","91131","2021",6,6,0,185500,2807.833,81.5
"30421","91132","2021",21,14,7,260160.6,3327.952,81.14286
"30422","91135","2021",35,34,1,286089.7,3180.086,100.3429
"30423","91136","2021",30,25,5,359440.8,3962.333,91.83333
"30424","91137","2021",3,3,0,275423.7,2141,126.6667
"30425","91145","2021",3,3,0,261666.7,1980.333,154.6667
"30426","91148","2021",2,2,0,407500,2717.5,160.5
"30427","91156","2021",36,23,13,277873.4,3057.889,94.13889
"30428","91159","2021",25,23,2,316451.6,3311.76,102.24
"30429","91161","2021",370,66,304,204083.3,2992.424,71.00541
"30430","91174","2021",950,249,701,164613.9,2810.483,60.36316
"30431","91175","2021",24,18,6,245110.8,2871.708,96.875
"30432","91179","2021",78,40,38,258679.6,2869.141,91.83333
"30433","91180","2021",7,7,0,392428.6,3079.571,149.1429
"30434","91184","2021",7,7,0,216600,2535.143,101.5714
"30435","91186","2021",7,6,1,300983.3,3218.143,104.8571
"30436","91191","2021",153,67,86,261452.9,3464.752,77.43137
"30437","91195","2021",17,16,1,313247.6,2794.059,113.9412
"30438","91198","2021",18,16,2,250938.9,2722.167,93.27778
"30439","91200","2021",165,80,85,229882.7,3060.376,78.30303
"30440","91201","2021",356,228,128,298452.2,3741.23,83.3427
"30441","91204","2021",7,5,2,267214.9,3290.571,86
"30442","91207","2021",56,39,17,272223.3,3415.679,83.83929
"30443","91215","2021",124,34,90,159298,2258.919,71.77419
"30444","91216","2021",196,123,73,310981.2,4148.071,77.07653
"30445","91223","2021",421,151,270,173257.6,2592.214,70.27553
"30446","91225","2021",34,26,8,352326.2,3314.824,114.8824
"30447","91226","2021",138,93,45,250828.2,3592.478,79.75362
"30448","91228","2021",795,151,644,169257.5,2443.897,71.44277
"30449","91232","2021",73,49,24,274829.5,3255.438,89.54795
"30450","91235","2021",110,26,84,192284.2,3153.918,62.28182
"30451","91240","2021",4,3,1,226640.5,2099,112.75
"30452","91243","2021",25,20,5,274931.2,3056.88,95.96
"30453","91244","2021",22,16,6,260318.2,3440.227,78.40909
"30454","91247","2021",8,7,1,210156.2,2219.375,104.875
"30455","91248","2021",1,1,0,290000,2397,121
"30456","91249","2021",78,61,17,346072.2,3298.923,110.3462
"30457","91272","2021",247,125,122,405680.9,4174.065,102.0283
"30458","91273","2021",19,19,0,285326.3,2956.526,101.7895
"30459","91274","2021",19,15,4,370798.3,4159.895,106.2105
"30460","91275","2021",31,28,3,433071,3935.032,112.0323
"30461","91284","2021",18,18,0,300553.9,2919.611,110.2778
"30462","91286","2021",44,30,14,245940.2,3303.5,78
"30463","91292","2021",11,10,1,321284.5,3738.091,91.27273
"30464","91293","2021",20,18,2,241640.5,2481.25,101.75
"30465","91294","2021",11,10,1,231559.1,2219.273,104.4545
"30466","91312","2021",126,93,33,437649.4,4886.556,94.39683
"30467","91315","2021",112,100,12,287909.5,3317.33,90.16964
"30468","91318","2021",29,29,0,365712.1,3582.655,105.7241
"30469","91319","2021",7,7,0,422714.3,3702.286,118
"30470","91326","2021",306,82,224,242746.1,3845.605,63.98366
"30471","91330","2021",87,69,18,263096.2,3262.471,85.95402
"30472","91332","2021",21,14,7,287821.4,3338.952,91.33333
"30473","91333","2021",66,54,12,285317.9,3335.894,88.40909
"30474","91338","2021",97,75,22,328523.7,3537.309,98.60825
"30475","91339","2021",93,57,36,273451.6,3385.043,85.13978
"30476","91340","2021",91,72,19,281351.7,3114.78,91.93407
"30477","91345","2021",376,130,246,226662.5,3245.138,71.26862
"30478","91347","2021",116,83,33,298917.4,3380.138,92.62069
"30479","91359","2021",45,36,9,223459.1,2856.822,84.73333
"30480","91363","2021",124,79,45,290336.2,3372.952,89.08065
"30481","91374","2021",3,3,0,170666.7,1826.333,95.33333
"30482","91376","2021",61,42,19,266478.5,3302.148,84.16393
"30483","91377","2021",666,85,581,271203,4147.341,68.02853
"30484","91378","2021",4,3,1,311025,2817.75,117.25
"30485","91386","2021",243,165,78,289352.8,3192.086,93.61728
"30486","91390","2021",75,67,8,210827.3,2347.827,95.70667
"30487","91393","2021",9,9,0,235496.7,2134.111,117.4444
"30488","91399","2021",5,5,0,241800,2109,123
"30489","91405","2021",77,64,13,296228.4,3421.039,90.67532
"30490","91408","2021",19,19,0,347276.3,3352.316,105.1579
"30491","91411","2021",33,33,0,478513.6,4055.091,125.8182
"30492","91412","2021",13,12,1,266683.8,2592.769,111.2308
"30493","91414","2021",5,5,0,200600,2447.8,80.8
"30494","91421","2021",307,185,122,315595.2,4177.775,79.75244
"30495","91425","2021",132,56,76,245142.4,3627.523,70.84848
"30496","91432","2021",194,133,61,308683.3,4043.789,79.83505
"30497","91433","2021",79,58,21,249112.9,2802.772,92.35443
"30498","91434","2021",291,162,129,262764.2,3505.165,77.00687
"30499","91435","2021",12,11,1,565920.2,3387.5,179.6667
"30500","91441","2021",3,3,0,282200,3225.333,94.33333
"30501","91457","2021",63,58,5,332921.5,3439.413,101.5079
"30502","91458","2021",65,44,21,337632.2,3810.077,93.73846
"30503","91461","2021",56,48,8,318380.1,3719.893,87.375
"30504","91463","2021",19,19,0,316920,2712.947,126.3684
"30505","91468","2021",25,23,2,325854.4,3417.24,95.84
"30506","91469","2021",12,10,2,254333.3,3071.25,87.08333
"30507","91471","2021",218,128,90,389207.7,4728.39,86.3945
"30508","91473","2021",1,1,0,207000,3136,66
"30509","91477","2021",449,144,305,320447.3,4396.559,74.66592
"30510","91479","2021",87,69,18,329955.6,4100.954,85.02299
"30511","91482","2021",9,7,2,337395.1,2805.556,126.5556
"30512","91494","2021",59,41,18,280812.9,3387.983,85.45763
"30513","91495","2021",3,3,0,213000,2235.667,93.33333
"30514","91507","2021",6,6,0,263658.3,2508.833,104.3333
"30515","91508","2021",4,4,0,274762.5,2647.5,105
"30516","91511","2021",48,36,12,159782.6,1982.458,81.125
"30517","91514","2021",106,66,40,252878.3,3526.358,75.86792
"30518","91519","2021",4,4,0,248500,2507.25,104.25
"30519","91521","2021",464,155,309,190365.8,2577.323,74.05388
"30520","91525","2021",30,26,4,266820.7,3068.067,99.4
"30521","91526","2021",1,1,0,273700,2765,99
"30522","91533","2021",44,37,7,248867.5,2675.568,97.47727
"30523","91534","2021",54,42,12,483810.9,4962.519,104.0926
"30524","91538","2021",9,9,0,552362.7,4981.556,116.8889
"30525","91540","2021",90,63,27,264934.6,3201.367,87.68889
"30526","91544","2021",8,7,1,315433.8,2394.125,135.875
"30527","91546","2021",17,16,1,328227.1,2755.235,129.1176
"30528","91547","2021",13,13,0,210861.5,2259.308,98.84615
"30529","91549","2021",484,285,199,282852.3,3604.324,81.40909
"30530","91552","2021",125,89,36,260316.2,3193.248,83.12
"30531","91553","2021",117,89,28,323795.8,3380.026,98.05128
"30532","91556","2021",6,6,0,303539.2,2822.667,113.6667
"30533","91560","2021",2,2,0,361975,4065,92
"30534","91568","2021",27,25,2,356438.5,3048.481,120.2963
"30535","91570","2021",251,117,134,234373.2,3027.757,80.01992
"30536","91573","2021",184,112,72,277332.4,3490.071,80.96196
"30537","91577","2021",97,83,14,308501.4,3223.856,99.92784
"30538","91578","2021",3,3,0,308000,3769.333,82.33333
"30539","91579","2021",57,35,22,277419.5,3524.351,80.49123
"30540","91581","2021",18,18,0,319555.6,3019.167,110.4444
"30541","91587","2021",89,52,37,325775,3687.573,89.1573
"30542","91589","2021",618,355,263,267129.4,3698.172,74.35113
"30543","91593","2021",39,36,3,305928.5,2912.231,110
"30544","91599","2021",25,25,0,333813.6,3559.92,97.28
"30545","91600","2021",138,83,55,346987.8,3491.065,102.3841
"30546","91602","2021",4,3,1,322625,4562.25,70.25
"30547","91613","2021",3,3,0,171000,2108,81
"30548","91617","2021",78,51,27,295547.7,3483.103,86.75641
"30549","91619","2021",3,2,1,290100,2905.333,100.6667
"30550","91629","2021",9,9,0,340278.9,2740.444,127.3333
"30551","91630","2021",28,23,5,308900.6,2844.821,114.0714
"30552","91631","2021",32,32,0,443146.6,3531.969,131.3438
"30553","91634","2021",24,20,4,291197.1,2948.083,101.4167
"30554","91635","2021",25,23,2,520761.4,5279.24,104.72
"30555","91639","2021",17,17,0,246946.5,3210.294,80.70588
"30556","91645","2021",213,118,95,547151.5,5170.164,106.9531
"30557","91648","2021",28,20,8,295051.5,3149.036,96.10714
"30558","91649","2021",39,27,12,248485.4,2957.487,83.4359
"30559","91654","2021",8,8,0,408137.5,3124.25,163.125
"30560","91657","2021",351,204,147,249211.1,3599.527,72.21083
"30561","91659","2021",66,48,18,257896.4,3137.061,85.37879
"30562","91661","2021",160,71,89,314593.6,3809.056,84.28125
"30563","91662","2021",7,7,0,266328.6,2336.857,120.8571
"30564","91665","2021",96,83,13,330874.2,3786.198,90.91667
"30565","91666","2021",28,27,1,401474.9,3804.143,108.3929
"30566","91667","2021",110,89,21,371771.8,3985.5,97.48182
"30567","91671","2021",10,10,0,298878,2808.2,117.8
"30568","91679","2021",19,11,8,339424.9,4546.474,79.73684
"30569","91685","2021",59,37,22,273412.4,3440.424,80.52542
"30570","91687","2021",385,164,221,235814.4,3363.647,73.01039
"30571","91689","2021",96,33,63,314217.6,4634.854,71.29167
"30572","91691","2021",478,233,245,295386.6,3669.207,81.9477
"30573","91692","2021",237,15,222,173899.1,2479.654,71.59494
"30574","92002","2021",813,290,523,456293.3,5848.416,79.2829
"30575","92004","2021",1479,113,1366,436621.7,7026.947,61.23597
"30576","92007","2021",297,73,224,354676,5625.185,63.70034
"30577","92009","2021",512,92,420,462653,7117.729,63.55078
"30578","92012","2021",1870,34,1836,568101,9261.094,60.70535
"30579","92014","2021",260,50,210,458651.6,6259.981,73.22308
"30580","92019","2021",407,57,350,393917.6,5177.17,75.14251
"30581","92020","2021",505,72,433,415415.1,6327.172,65.81584
"30582","92022","2021",280,63,217,455983.8,6400.711,70.54643
"30583","92023","2021",683,216,467,501779.2,6795.25,72.43192
"30584","92024","2021",784,10,774,345176.3,7491.938,45.97832
"30585","92025","2021",1164,339,825,435938.9,6273.021,67.39777
"30586","92026","2021",1173,31,1142,436372,7494.405,58.42285
"30587","92032","2021",220,50,170,413248.4,5333.645,76.35455
"30588","92033","2021",282,59,223,622867.7,6721.383,89.2766
"30589","92035","2021",510,36,474,464337.3,7296.641,61.95294
"30590","92036","2021",241,44,197,293933.4,4851.104,61.84232
"30591","92040","2021",858,55,803,513625.4,8457.614,59.9697
"30592","92044","2021",1068,6,1062,544681.2,9729.219,55.43071
"30593","92046","2021",311,57,254,430219.3,7483.084,57.96785
"30594","92047","2021",12,9,3,846333.8,7173,124.25
"30595","92048","2021",624,89,535,502161.8,6353.893,75.35737
"30596","92049","2021",691,20,671,447978.8,8031.216,55.35022
"30597","92050","2021",639,152,487,400579.7,5948.889,67.55086
"30598","92051","2021",922,8,914,924191.9,10884.75,84.10629
"30599","92060","2021",393,24,369,391804.7,5746.094,68.71247
"30600","92062","2021",652,19,633,451985.5,7760.673,58.33129
"30601","92063","2021",1162,303,859,544032.4,6588.09,79.11188
"30602","92064","2021",410,63,347,713280,7683.344,88.07317
"30603","92071","2021",242,55,187,600756.3,6980.095,83.66942
"30604","92072","2021",317,60,257,539494.6,6609.836,78.42271
"30605","92073","2021",647,88,559,520670.5,7488.909,69.16229
"30606","92075","2021",359,30,329,425864.2,7258.05,58.1922
"30607","92076","2021",140,25,115,587702.2,5968.657,91.91429
"30608","92077","2021",127,24,103,626764.6,6399.433,94.91339
"30609","92078","2021",183,19,164,202473.3,3738.885,56.18579
"30610","93001","2021",553,54,499,222928.3,4461.79,50.66546
"30611","93005","2021",750,445,305,256491.1,3802.88,70.99867
"30612","93006","2021",332,68,264,370165.8,6232.093,60.31325
"30613","93007","2021",366,226,140,286039.2,4029.475,73.71038
"30614","93008","2021",248,90,158,231108.2,3779.75,63.37097
"30615","93010","2021",467,201,266,222697.2,3513.878,65.88009
"30616","93013","2021",148,22,126,195203.6,3519.622,58.17568
"30617","93014","2021",182,61,121,165684.9,2440.423,68.73626
"30618","93015","2021",107,75,32,283674.1,3284.879,89.47664
"30619","93027","2021",168,39,129,199308.2,3407.833,60.52976
"30620","93029","2021",662,337,325,234548.2,3817.449,63.7432
"30621","93030","2021",50,6,44,171473.9,2861.52,60.44
"30622","93031","2021",538,114,424,191395.7,2995.595,66.35874
"30623","93032","2021",552,297,255,284344.6,3812.221,75.60688
"30624","93033","2021",146,81,65,336440.9,4609.336,77.22603
"30625","93039","2021",71,8,63,222649.8,3839.592,60.21127
"30626","93045","2021",270,32,238,394603.6,7481.033,53.48889
"30627","93046","2021",709,288,421,233373.3,3486.291,69.40621
"30628","93047","2021",280,216,64,281300.4,3759.429,80.46071
"30629","93048","2021",1314,249,1065,402386.7,6735.26,61.10122
"30630","93049","2021",282,121,161,307473,4590.362,68.83688
"30631","93050","2021",374,89,285,228683.4,3565.262,67.20053
"30632","93051","2021",936,233,703,275805.6,4367.702,65.65598
"30633","93053","2021",376,125,251,273973.1,4378.71,64.06915
"30634","93055","2021",646,47,599,343950.9,6564.508,51.6904
"30635","93057","2021",383,159,224,242905.4,3715.178,66.46214
"30636","93059","2021",238,97,141,181790.9,2946.945,64.82773
"30637","93061","2021",199,17,182,384845.4,6946.719,55.47739
"30638","93062","2021",280,91,189,357504.5,4532.964,79.3
"30639","93063","2021",330,89,241,369119.3,6005.791,63.10606
"30640","93064","2021",577,147,430,281747.6,4365.116,66.2721
"30641","93066","2021",920,93,827,229697.6,4273.476,54.87391
"30642","93070","2021",604,39,565,361928.9,6711.349,53.29636
"30643","93071","2021",410,219,191,212762.2,3031.429,72.20488
"30644","93072","2021",226,113,113,201473.9,3274.739,64.57522
"30645","93073","2021",408,278,130,250163.3,3311.311,79.54902
"30646","93074","2021",126,52,74,229336.6,3173.23,75.29365
"30647","93077","2021",449,207,242,295930,4180.947,71.83964
"30648","93078","2021",377,190,187,212696.7,3136.692,71.50133
"30649","93079","2021",51,25,26,204708.8,3290.843,64.4902
"30650","94001","2021",107,26,81,219728.4,3277.421,68.49533
"30651","94002","2021",569,79,490,310681.6,5511.796,57.11775
"30652","94003","2021",200,59,141,357481.8,6296.8,58.02
"30653","94004","2021",210,59,151,256674.2,3514.467,75.67143
"30654","94011","2021",105,33,72,297508.9,4122.429,74.04762
"30655","94015","2021",290,107,183,459435.3,5614.828,82.32759
"30656","94016","2021",343,76,267,352665.9,5711.735,61.98834
"30657","94017","2021",856,335,521,302159,4294.626,72.3785
"30658","94018","2021",425,8,417,495409.1,8242.927,60.84941
"30659","94019","2021",358,120,238,307892.5,4035.953,76.18156
"30660","94021","2021",241,31,210,244529.5,3731.979,67.56017
"30661","94022","2021",571,102,469,234533.8,4076.273,60.32224
"30662","94028","2021",816,95,721,269580.2,4102.993,67.52574
"30663","94033","2021",671,205,466,453136.4,6770.124,66.94933
"30664","94034","2021",359,65,294,268100.3,3770.599,71.40669
"30665","94037","2021",143,23,120,339888.5,6356.483,55.53147
"30666","94038","2021",338,114,224,359288.7,4794.524,75.62722
"30667","94041","2021",606,44,562,283453.6,5466.683,52.69967
"30668","94042","2021",258,60,198,452334.6,6331.256,70.02326
"30669","94043","2021",223,8,215,314670.8,5964.578,54.08072
"30670","94044","2021",396,104,292,232298.5,3577.634,67.02525
"30671","94046","2021",775,142,633,382127.3,6086.604,63.18194
"30672","94047","2021",60,47,13,318603.8,3366.65,98.06667
"30673","94048","2021",72,63,9,419581.8,3638.569,120.5972
"30674","94052","2021",590,72,518,474454.9,6850.132,67.84237
"30675","94053","2021",73,52,21,357327,4102.466,89.80822
"30676","94054","2021",194,67,127,235960.6,3765.144,64.70103
"30677","94055","2021",132,129,3,444894.5,4458.5,105.3561
"30678","94056","2021",53,45,8,325898,3736.943,95.69811
"30679","94058","2021",657,177,480,433477.8,6103.744,70.01826
"30680","94059","2021",306,74,232,295148.6,3819.621,77.68627
"30681","94060","2021",139,112,27,312644.8,3582.439,89.14388
"30682","94065","2021",69,23,46,351104,4545.623,77.5942
"30683","94067","2021",348,8,340,619387.4,9324.417,65.70402
"30684","94068","2021",1443,493,950,498292.8,6576.705,75.22869
"30685","94069","2021",176,7,169,382844.8,6474.869,58.51136
"30686","94070","2021",48,34,14,446784.2,3713.146,128.125
"30687","94071","2021",315,166,149,343005.6,4131.952,84.09524
"30688","94073","2021",469,112,357,282402.6,3989.91,71.21322
"30689","94074","2021",45,19,26,238242.2,3568,71
"30690","94075","2021",165,117,48,344848.9,3903.315,95.14545
"30691","94076","2021",500,94,406,306612.2,5589.75,56.528
"30692","94077","2021",283,166,117,270695.8,3964.311,70.26855
"30693","94078","2021",284,111,173,178027.1,3158.908,59.49296
"30694","94079","2021",382,136,246,305651,4310.901,72.63874
"30695","94080","2021",867,31,836,508438,9391.663,53.19723
"30696","94081","2021",724,203,521,283439,4572.032,64.25967
"30697","95002","2021",19,18,1,323791.1,3114.684,104.8421
"30698","95008","2021",10,9,1,252055,2514.5,100.7
"30699","95011","2021",4,4,0,317987.5,3415.25,109
"30700","95012","2021",5,5,0,253980,2095.4,131.6
"30701","95014","2021",31,22,9,418463.9,4117.968,107.5484
"30702","95018","2021",1215,515,700,246349.2,3708.401,68.53663
"30703","95019","2021",150,93,57,233307.7,3349.027,73.16667
"30704","95023","2021",12,12,0,325841.7,2984.917,117.1667
"30705","95024","2021",6,6,0,227373,2368.833,107.5
"30706","95026","2021",41,34,7,311311.3,3379.854,93.56098
"30707","95028","2021",16,15,1,349761.2,3231.062,117.5625
"30708","95039","2021",127,103,24,327826.3,3925.37,88.00787
"30709","95040","2021",9,9,0,270445.8,2593.111,101.1111
"30710","95042","2021",22,15,7,257162,3230.773,82.31818
"30711","95046","2021",2,2,0,256975,2694.5,98
"30712","95051","2021",148,103,45,336067.2,4129.25,83.81081
"30713","95052","2021",193,77,116,195150.6,3087.829,65.01554
"30714","95054","2021",7,7,0,230469.1,3139.857,76.42857
"30715","95055","2021",10,6,4,250160,3378.8,79.5
"30716","95056","2021",47,42,5,281548.6,3395.574,85.80851
"30717","95058","2021",41,39,2,291221.5,3048.268,97.68293
"30718","95059","2021",7,7,0,276228.6,2716.571,103.4286
"30719","95060","2021",101,61,40,322678.8,4133.782,81.37624
"30720","95061","2021",3,3,0,429450,3970.667,111
"30721","95063","2021",369,156,213,288571.2,4471.469,66.04878
"30722","95074","2021",11,8,3,387339,3178.545,127.8182
"30723","95078","2021",28,19,9,306777.5,3297.893,95.96429
"30724","95088","2021",5,2,3,216000,3538.8,61.4
"30725","95091","2021",80,67,13,312533.7,3343.588,94.75
"30726","95094","2021",4,4,0,363337.5,3234.5,118
"30727","95101","2021",17,17,0,240958.8,2486.647,98.76471
"30728","95102","2021",5,5,0,394210,4351.4,111.2
"30729","95110","2021",10,2,8,200074,2776,77
"30730","95116","2021",43,40,3,273787.4,3174.581,89.62791
"30731","95119","2021",6,6,0,251531.5,3022.167,89.5
"30732","95120","2021",41,39,2,336707,4048.61,92.58537
"30733","95127","2021",830,162,668,203008.4,3290.196,65.89036
"30734","95134","2021",89,73,16,315216.4,3395.427,97
"30735","95139","2021",7,7,0,240621.4,2836,85.28571
"30736","95142","2021",26,23,3,218925.3,3087.5,80
"30737","95149","2021",50,44,6,310371.6,3533.16,93.2
"30738","95150","2021",10,8,2,232065,2463.5,98.2
"30739","95151","2021",3,3,0,428800,2983.667,144.6667
"30740","95154","2021",5,5,0,263578,2621.8,111
"30741","95157","2021",4,4,0,258350,2593.5,115.25
"30742","95166","2021",7,7,0,253328.6,2785,108.5714
"30743","95169","2021",8,8,0,297546.2,2958.75,108.75
"30744","95170","2021",5,2,3,161000,2534.6,76.4
"30745","95176","2021",398,216,182,351165.3,4457.422,79.64824
"30746","95177","2021",22,20,2,332640.2,3412.636,106.4545
"30747","95181","2021",6,6,0,311333.3,3091.167,108.8333
"30748","95183","2021",80,40,40,254676.9,3476.45,76.7125
"30749","95197","2021",397,159,238,286387.9,3981.088,73.0932
"30750","95199","2021",248,122,126,273957.4,3510.435,79.99597
"30751","95203","2021",337,154,183,337901.5,4239.644,80.7181
"30752","95205","2021",107,52,55,253844.7,3152.159,81.79439
"30753","95210","2021",210,51,159,433270.3,5904.195,73.29048
"30754","95211","2021",44,39,5,353715.5,3525.955,108.1136
"30755","95212","2021",2,2,0,227750,2732.5,94
"30756","95213","2021",12,12,0,364975,3301.917,119.9167
"30757","95214","2021",1,1,0,247000,4491,55
"30758","95218","2021",320,134,186,256242.2,3318.125,78.74062
"30759","95219","2021",378,143,235,309592.4,4132.889,76.6455
"30760","95229","2021",163,68,95,255952,3459.595,76.5092
"30761","95241","2021",24,20,4,274779.2,3209.75,87.20833
"30762","95250","2021",163,148,15,251846.9,2997.718,87.64417
"30763","95252","2021",684,162,522,248135.7,3549.586,70.10819
"30764","95253","2021",6,5,1,276516.7,3508.833,78.83333
"30765","95254","2021",18,18,0,359051.1,2838,138.0556
"30766","95256","2021",53,40,13,319297.5,3891.453,86.24528
"30767","95257","2021",81,60,21,369055,4504.914,86.17284
"30768","95268","2021",216,61,155,169787.2,2599.236,66.11111
"30769","95270","2021",10,8,2,271956.7,2818.4,103.9
"30770","95271","2021",8,8,0,278643.8,3856.875,77.375
"30771","95277","2021",202,93,109,217978.4,3122.455,71.0198
"30772","95280","2021",253,210,43,247793.2,3478.937,75.93676
"30773","95282","2021",2,2,0,275000,2689,120
"30774","95287","2021",5,5,0,357400,3567.8,136.4
"30775","95288","2021",145,94,51,313534.1,3634.566,89.06897
"30776","95295","2021",1,1,0,345000,3450,100
"30777","95298","2021",10,10,0,380099,2732.1,138.6
"30778","95301","2021",6,6,0,259250,3071.333,81.5
"30779","95303","2021",5,3,2,277620,3216.4,83.8
"30780","95304","2021",8,8,0,441665,3105,157.125
"30781","95306","2021",424,241,183,325774.2,4103.425,81.35613
"30782","95308","2021",9,7,2,315658,3141.556,98
"30783","95309","2021",3,3,0,204096.7,2438,99.33333
"30784","95313","2021",207,94,113,374947.6,4393.995,85.82609
"30785","95316","2021",4,4,0,387275,2814.5,137
"30786","95323","2021",191,147,44,293633.4,3377.681,88.96859
"30787","95328","2021",12,10,2,285366.7,2979.583,99.75
"30788","95331","2021",5,4,1,388700,2705.2,154.2
"30789","95341","2021",4,2,2,222375,2525,97.75
"30790","95348","2021",8,7,1,384329,3353.75,126.625
"30791","95351","2021",150,90,60,236338,3352.427,72.64667
"30792","95352","2021",65,52,13,314954.4,3502.354,91.15385
"30793","95353","2021",45,30,15,315652.1,3528,94.24444
"30794","95355","2021",79,60,19,233758.3,3063.633,81.74684
"30795","95365","2021",14,12,2,290275.7,3159.429,105.2857
"30796","95369","2021",43,25,18,366504.4,4003.279,91.37209
"30797","95370","2021",57,48,9,285787.5,3279.561,93.14035
"30798","95371","2021",71,62,9,276332.8,3249.338,87.95775
"30799","95379","2021",5,5,0,248000,2736.6,90.2
"30800","95387","2021",1,1,0,470000,4352,108
"30801","95388","2021",90,77,13,278299.9,3350.722,83.76667
"30802","95392","2021",88,66,22,307643,3595.989,88.72727
"30803","95394","2021",160,99,61,294452.8,3535.4,85.80625
"30804","95395","2021",17,16,1,286981.8,2887.882,104.8824
"30805","95409","2021",24,11,13,254187.9,3290.042,81.16667
"30806","95422","2021",7,7,0,397050,3199.286,134.2857
"30807","95424","2021",248,129,119,263397.5,3419.935,77.33468
"30808","95426","2021",43,35,8,402276.7,4041.907,104.2558
"30809","95427","2021",177,73,104,241850,3330,74.45763
"30810","95428","2021",399,145,254,385900.1,4444.852,88.60652
"30811","95429","2021",10,10,0,269560,2864.1,98.5
"30812","95430","2021",53,42,11,322666.4,3201.585,105.0566
"30813","95436","2021",23,21,2,295117.4,3248.913,96.26087
"30814","95438","2021",6,4,2,238833.3,2645,95.83333
"30815","95445","2021",9,9,0,349968.8,2775.889,128.3333
"30816","95446","2021",36,34,2,382760.6,4430.333,100.3611
"30817","95447","2021",2,2,0,251580,3380.5,103
"30818","95450","2021",21,20,1,391070,3810.286,104.7143
"30819","95452","2021",28,13,15,270220.7,3445.321,81.03571
"30820","95456","2021",10,10,0,274170,2840.2,102.7
"30821","95459","2021",12,11,1,284289.2,2674.917,111.9167
"30822","95462","2021",4,4,0,356807.5,3704.75,125.5
"30823","95476","2021",177,128,49,326516.7,3604.74,95.57062
"30824","95480","2021",122,106,16,334676.8,3507.098,98.30328
"30825","95483","2021",8,8,0,388287.5,3455.125,120.25
"30826","95487","2021",163,72,91,192940,3017.718,65.66871
"30827","95488","2021",111,63,48,273706.3,3847.108,74.18018
"30828","95489","2021",9,8,1,441244.3,3889,124.7778
"30829","95491","2021",173,75,98,283207.9,3644.289,80.13873
"30830","95492","2021",1,1,0,5e+05,3401,147
"30831","95493","2021",2,2,0,225750,2898,77.5
"30832","95500","2021",460,141,319,231832.1,3308.196,73.07391
"30833","95504","2021",77,68,9,319159.5,3911.974,85.27273
"30834","95509","2021",62,54,8,269453.5,2850.613,98.06452
"30835","95510","2021",4,1,3,218052.2,4051,52.5
"30836","95523","2021",14,13,1,262589.3,2579.143,108.5714
"30837","95527","2021",40,17,23,229253.2,3664.625,64
"30838","95529","2021",15,13,2,371254.8,3093.8,124.8667
"30839","95535","2021",17,15,2,329992,3193.882,106.7647
"30840","95539","2021",190,95,95,282900.5,3560.611,80.79474
"30841","95541","2021",22,18,4,170140.9,2043.273,84.63636
"30842","95543","2021",6,6,0,287283.3,3057.167,99.66667
"30843","95554","2021",15,15,0,303093.3,2939.4,109.3333
"30844","95555","2021",260,76,184,298574.2,4220.912,71.03846
"30845","95563","2021",279,161,118,319166.6,4061.366,80.06452
"30846","95566","2021",46,43,3,266721.9,3025,91.21739
"30847","95572","2021",333,127,206,217949.9,3261.126,69.52252
"30848","95574","2021",113,94,19,419334.6,4413.584,99.53982
"30849","95580","2021",35,30,5,438280.5,3435.971,129.3143
"30850","95582","2021",393,121,272,274736.1,3930.952,70.40204
"30851","95584","2021",8,6,2,321136,3660.875,79.75
"30852","95585","2021",363,104,259,180739.3,2481.215,76.58127
"30853","95592","2021",14,14,0,312526.7,2877.857,110
"30854","95594","2021",15,11,4,271247.1,3649.2,88.73333
"30855","95598","2021",264,131,133,350813.9,4168.992,84.95076
"30856","95604","2021",88,32,56,192190,2774.875,73.27273
"30857","95607","2021",408,189,219,277983.3,3718.069,76.22794
"30858","95610","2021",5,5,0,470747,4219.8,143.6
"30859","95612","2021",58,40,18,291340.5,3583.534,82.53448
"30860","95625","2021",24,23,1,295757.6,3315.875,95.58333
"30861","95627","2021",16,12,4,313480.6,3388.188,99
"30862","95628","2021",26,22,4,372358.4,3674.115,109.1538
"30863","95637","2021",205,131,74,291215.4,3676.761,82.6878
"30864","95641","2021",43,28,15,279755.8,3360.302,89.32558
"30865","95651","2021",24,23,1,273449,3007.292,92.66667
"30866","95652","2021",72,67,5,301036.2,3595.056,90
"30867","95656","2021",11,11,0,271420.9,2280.909,118.0909
"30868","95658","2021",10,10,0,311315,3608.2,102.1
"30869","95660","2021",19,10,9,318566.8,3458.158,91.21053
"30870","95675","2021",27,14,13,306705.5,3530.963,91.81481
"30871","95676","2021",8,8,0,313999.9,2837.125,118.75
"30872","95678","2021",17,14,3,275319.4,3911.765,77.47059
"30873","95680","2021",186,67,119,174900.7,2575.919,69.45699
"30874","95682","2021",3,3,0,256666.7,2606,98.33333
"30875","95690","2021",2,2,0,338200,3532,98.5
"30876",NA,"2021",8557,NA,NA,209092.8,2796.279,75.89821
